Fips_State,Fips_Place,Fips_State_Place,City_Name,St_Name,NYU_500_Largest,Year,Pop_Total,Per_15to44_years(%),Per_18_years_and_over(%),Per_65_years_and_over(%),Pop_Male,Pop_Female,Pop_White,Pop_Black,Pop_Asian,Pop_AIAN,Pop_NHOPI,Pop_Nonhispanic,Pop_Hispanic
01,07000,0107000,Birmingham city,Alabama,1,1990,265968,46.58,74.71,14.84,121437,144531,95655,168277,1453,321,25,264930,1038
01,35896,0135896,Hoover city,Alabama,1,1990,39788,49.61,76.58,9.85,18823,20965,37886,1318,471,47,3,39422,366
01,37000,0137000,Huntsville city,Alabama,1,1990,159789,49.30,76.82,10.00,77676,82113,116065,39016,3342,816,90,157810,1979
01,50000,0150000,Mobile city,Alabama,1,1990,196278,45.96,73.47,13.71,91040,105238,117022,76407,1956,443,36,194276,2002
01,51000,0151000,Montgomery city,Alabama,1,1990,187106,47.90,72.34,11.70,87085,100021,105778,79217,1342,355,29,185602,1504
01,77256,0177256,Tuscaloosa city,Alabama,1,1990,77759,55.57,79.63,11.69,37134,40625,48871,27598,1034,106,9,77157,602
02,03000,0203000,Anchorage city,Alaska,1,1990,226338,55.24,70.54,3.65,116367,109971,182736,14544,9713,14569,1197,217080,9258
04,04720,0404720,Avondale city,Arizona,1,1990,16169,46.94,63.98,7.19,8156,8013,9528,747,185,217,18,7898,8271
04,12000,0412000,Chandler city,Arizona,1,1990,90533,54.47,68.19,5.01,44889,45644,77114,2321,2060,1105,93,74891,15642
04,27400,0427400,Gilbert town,Arizona,1,1990,29188,54.06,64.14,3.13,14561,14627,26362,464,476,141,24,25806,3382
04,27820,0427820,Glendale city,Arizona,1,1990,148134,50.66,70.81,7.88,72638,75496,125884,4455,3010,1402,140,125223,22911
04,46000,0446000,Mesa city,Arizona,1,1990,288091,48.02,71.45,12.40,141470,146621,259472,5342,3826,3018,529,256734,31357
04,54050,0454050,Peoria city,Arizona,1,1990,50618,44.11,70.92,14.88,24263,26355,44012,1107,686,300,47,42762,7856
04,55000,0455000,Phoenix city,Arizona,1,1990,983403,49.92,72.84,9.68,487589,495814,803332,51053,15340,18225,963,786300,197103
04,65000,0465000,Scottsdale city,Arizona,1,1990,130069,44.30,82.18,16.30,61321,68748,124895,992,1535,799,65,123866,6203
04,71510,0471510,Surprise town,Arizona,1,1990,7122,35.34,69.80,18.17,3542,3580,3896,113,8,37,1,3206,3916
04,73000,0473000,Tempe city,Arizona,1,1990,141865,60.16,78.41,6.56,72954,68911,123209,4542,5594,1877,154,126435,15430
04,77000,0477000,Tucson city,Arizona,1,1990,405390,50.68,75.48,12.63,197319,208071,305055,17366,8506,6464,395,286795,118595
04,85540,0485540,Yuma city,Arizona,1,1990,54923,46.20,69.22,12.00,27107,27816,40103,2088,840,603,89,35346,19577
05,23290,0523290,Fayetteville city,Arkansas,1,1990,42099,59.80,79.61,9.67,21029,21070,39206,1580,645,481,12,41496,603
05,24550,0524550,Fort Smith city,Arkansas,1,1990,72798,44.82,74.61,14.95,34774,38024,62790,5590,2960,1001,21,71766,1032
05,35710,0535710,Jonesboro city,Arkansas,1,1990,46535,50.91,76.27,11.20,22297,24238,42238,3701,375,156,6,46288,247
05,41000,0541000,Little Rock city,Arkansas,1,1990,175795,49.22,75.11,12.55,81587,94208,113707,59742,1512,449,17,174458,1337
05,66080,0566080,Springdale city,Arkansas,1,1990,29941,46.07,73.36,12.63,14353,15588,29095,33,275,338,17,29495,446
06,00562,0600562,Alameda city,California,1,1990,76459,54.04,80.21,11.81,40403,36056,53454,5140,14137,534,580,69509,6950
06,00884,0600884,Alhambra city,California,1,1990,82106,52.10,77.23,12.97,39104,43002,33543,1643,31236,351,77,52480,29626
06,02000,0602000,Anaheim city,California,1,1990,266406,52.52,74.10,8.37,134832,131574,190309,6780,23959,1425,1059,182651,83755
06,02252,0602252,Antioch city,California,1,1990,62195,50.23,69.15,7.62,30664,31531,53130,1626,2801,691,204,52476,9719
06,02364,0602364,Apple Valley town,California,1,1990,46079,45.27,68.18,9.89,22782,23297,39980,1778,1070,481,68,40266,5813
06,03526,0603526,Bakersfield city,California,1,1990,174820,49.03,69.19,9.15,84920,89900,127018,16509,6050,2005,197,138966,35854
06,03666,0603666,Baldwin Park city,California,1,1990,69330,51.80,64.83,5.57,34997,34333,38523,1687,8380,509,128,20279,49051
06,04982,0604982,Bellflower city,California,1,1990,61815,50.23,73.96,10.83,30358,31457,43129,3874,5900,560,335,47039,14776
06,06000,0606000,Berkeley city,California,1,1990,102724,60.68,85.71,10.95,51024,51700,63833,19281,14983,653,195,94135,8589
06,08786,0608786,Buena Park city,California,1,1990,68784,50.43,73.44,8.04,34439,34345,48760,1750,9528,497,411,51905,16879
06,08954,0608954,Burbank city,California,1,1990,93643,49.43,79.99,14.53,45510,48133,77342,1638,6179,501,156,72471,21172
06,11194,0611194,Carlsbad city,California,1,1990,63126,49.90,78.41,13.10,31939,31187,56664,745,1851,296,152,54426,8700
06,11530,0611530,Carson city,California,1,1990,83995,47.90,72.70,8.05,41273,42722,29160,21953,18007,496,2965,60582,23413
06,13014,0613014,Chico city,California,1,1990,40079,65.49,81.37,9.01,20112,19967,35858,731,1513,439,89,36595,3484
06,13210,0613210,Chino city,California,1,1990,59682,57.81,71.76,5.04,33909,25773,40171,5820,1970,277,86,38094,21588
06,13214,0613214,Chino Hills CDP,California,1,1990,27608,56.74,67.90,2.47,13972,13636,20482,1381,3696,156,59,23017,4591
06,13392,0613392,Chula Vista city,California,1,1990,135163,48.54,73.93,11.67,66354,68809,91563,6216,11161,863,914,84787,50376
06,13588,0613588,Citrus Heights CDP,California,1,1990,107439,49.77,73.34,9.61,52070,55369,97979,2473,3295,1181,250,100071,7368
06,14218,0614218,Clovis city,California,1,1990,50323,51.82,69.31,7.92,24318,26005,41855,865,2716,690,41,42117,8206
06,15044,0615044,Compton city,California,1,1990,90454,48.59,63.30,5.73,44365,46089,9571,49598,453,287,1295,50944,39510
06,16000,0616000,Concord city,California,1,1990,111348,50.80,75.39,9.47,54786,56562,93565,2624,9185,763,483,98583,12765
06,16350,0616350,Corona city,California,1,1990,76095,53.06,68.84,5.83,38561,37534,57744,2102,5214,634,185,52994,23101
06,16532,0616532,Costa Mesa city,California,1,1990,96357,58.63,80.47,8.19,49215,47142,81238,1282,5818,475,500,77038,19319
06,17918,0617918,Daly City city,California,1,1990,92311,49.99,76.02,10.49,44914,47397,36421,7106,39245,384,1221,71677,20634
06,19766,0619766,Downey city,California,1,1990,91444,47.15,75.61,13.41,44958,46486,66323,3068,7869,586,201,61875,29569
06,21712,0621712,El Cajon city,California,1,1990,88693,50.64,73.63,10.92,43156,45537,77483,2589,2128,865,371,76306,12387
06,22020,0622020,Elk Grove CDP,California,1,1990,17483,48.44,67.47,7.46,8543,8940,15798,369,697,159,38,15803,1680
06,22230,0622230,El Monte city,California,1,1990,106209,52.23,65.97,6.43,54564,51645,66096,1047,12336,600,153,29218,76991
06,22804,0622804,Escondido city,California,1,1990,108635,49.05,73.47,12.96,53362,55273,92504,1585,3803,902,237,83255,25380
06,23182,0623182,Fairfield city,California,1,1990,77211,51.77,69.81,6.36,38849,38362,52636,10656,7371,786,891,67003,10208
06,24638,0624638,Folsom city,California,1,1990,29802,57.72,78.87,8.69,17882,11920,25026,2949,989,195,42,26557,3245
06,24680,0624680,Fontana city,California,1,1990,87535,51.47,63.86,5.50,43227,44308,59304,7616,3642,800,321,55938,31597
06,26000,0626000,Fremont city,California,1,1990,173339,53.14,74.22,6.66,86808,86531,122376,6562,32707,1218,964,150248,23091
06,27000,0627000,Fresno city,California,1,1990,354202,47.92,68.26,10.11,172241,181961,209604,29409,43884,3729,474,248415,105787
06,28000,0628000,Fullerton city,California,1,1990,114144,51.89,77.40,10.22,57235,56909,85212,2479,13596,528,304,89840,24304
06,29000,0629000,Garden Grove city,California,1,1990,143050,51.26,73.71,8.75,72521,70529,96304,2144,28248,872,1089,109471,33579
06,30000,0630000,Glendale city,California,1,1990,180038,49.07,78.30,13.32,86606,93432,133270,2334,25222,629,231,142307,37731
06,32548,0632548,Hawthorne city,California,1,1990,71349,55.72,74.72,7.29,35318,36031,30166,20212,7265,326,554,49130,22219
06,33000,0633000,Hayward city,California,1,1990,111498,50.46,75.16,10.68,54883,56615,68911,10965,15710,1084,1625,84827,26671
06,33182,0633182,Hemet city,California,1,1990,36094,28.56,83.17,42.08,16323,19771,32802,244,405,319,20,30711,5383
06,33434,0633434,Hesperia city,California,1,1990,50418,44.58,66.93,11.34,25133,25285,43191,1249,579,464,133,40845,9573
06,36000,0636000,Huntington Beach city,California,1,1990,181519,54.01,79.03,8.31,91714,89805,156314,1687,14501,1157,547,161122,20397
06,36448,0636448,Indio city,California,1,1990,36793,49.15,66.09,8.08,18651,18142,20045,1482,569,281,19,11725,25068
06,36546,0636546,Inglewood city,California,1,1990,109602,52.55,69.89,6.84,53145,56457,19073,56861,2212,427,542,67353,42249
06,36770,0636770,Irvine city,California,1,1990,110330,56.69,75.62,5.76,53430,56900,85945,2002,19787,259,183,103428,6902
06,39892,0639892,Lakewood city,California,1,1990,73557,47.38,75.33,12.07,36245,37312,59690,2712,6524,487,360,62794,10763
06,40130,0640130,Lancaster city,California,1,1990,97291,50.76,70.08,7.88,48695,48596,77225,7207,3453,913,165,82475,14816
06,41992,0641992,Livermore city,California,1,1990,56741,50.93,72.77,7.11,28275,28466,50721,863,2428,414,182,51154,5587
06,43000,0643000,Long Beach city,California,1,1990,429433,52.51,74.51,10.82,216685,212748,250716,58761,53080,2781,5186,328014,101419
06,44000,0644000,Los Angeles city,California,1,1990,3485398,52.65,75.23,9.98,1750055,1735343,1841182,487674,334374,16379,7433,2093987,1391411
06,44574,0644574,Lynwood city,California,1,1990,61945,52.05,62.48,5.14,31272,30673,14844,14652,906,258,467,18380,43565
06,45484,0645484,Manteca city,California,1,1990,40773,49.19,67.62,8.17,20464,20309,36502,605,1275,477,137,33532,7241
06,46898,0646898,Merced city,California,1,1990,56216,47.13,65.43,9.00,27764,28452,34675,3860,8447,522,117,39430,16786
06,47766,0647766,Milpitas city,California,1,1990,50686,56.08,73.41,4.85,26867,23819,26413,2970,17082,479,490,41252,9434
06,48256,0648256,Mission Viejo city,California,1,1990,72820,50.31,72.33,7.90,36082,36738,65756,680,4453,228,99,67205,5615
06,48354,0648354,Modesto city,California,1,1990,164730,47.37,69.83,10.48,79924,84806,132701,4413,12172,1694,829,137810,26920
06,49270,0649270,Moreno Valley city,California,1,1990,118779,51.65,63.09,3.99,59157,59622,80116,16402,7261,856,634,91614,27165
06,49670,0649670,Mountain View city,California,1,1990,67460,58.16,82.25,9.80,34388,33072,49062,3390,9656,391,276,56639,10821
06,50076,0650076,Murrieta CDP,California,1,1990,1628,44.23,71.01,13.21,821,807,1482,13,9,27,0,1348,280
06,50258,0650258,Napa city,California,1,1990,61842,45.56,75.42,14.89,29993,31849,55846,237,1171,474,121,52417,9425
06,51182,0651182,Newport Beach city,California,1,1990,66643,48.45,86.69,15.48,32898,33745,63850,230,1861,170,66,63995,2648
06,52526,0652526,Norwalk city,California,1,1990,94279,49.81,70.18,8.60,47293,46986,52636,3061,11243,813,459,49161,45118
06,53000,0653000,Oakland city,California,1,1990,372242,50.33,75.13,12.05,178824,193418,120849,163335,53206,2371,1725,320531,51711
06,53322,0653322,Oceanside city,California,1,1990,128398,48.83,73.78,14.03,63693,64705,95935,10129,5911,910,1914,99416,28982
06,53896,0653896,Ontario city,California,1,1990,133179,52.33,67.11,6.37,67101,66078,86056,9724,4617,914,566,77637,55542
06,53980,0653980,Orange city,California,1,1990,110658,52.14,75.64,8.70,55809,54849,91838,1551,8524,596,216,85380,25278
06,54652,0654652,Oxnard city,California,1,1990,142216,50.40,69.29,7.74,72729,69487,83428,7464,11334,1092,864,64896,77320
06,55156,0655156,Palmdale city,California,1,1990,68842,51.93,64.74,4.76,34723,34119,52101,4398,2896,648,134,53688,15154
06,56000,0656000,Pasadena city,California,1,1990,131591,51.24,77.97,13.18,64227,67364,75342,24952,10510,591,168,95679,35912
06,56700,0656700,Perris city,California,1,1990,21460,47.67,65.83,9.62,10612,10848,15119,2788,618,218,95,13756,7704
06,57792,0657792,Pleasanton city,California,1,1990,50553,52.38,74.20,5.38,25068,25485,45835,694,2820,216,104,47170,3383
06,58072,0658072,Pomona city,California,1,1990,131723,52.05,67.20,6.98,67596,64127,75113,19013,8477,745,314,64190,67533
06,59451,0659451,Rancho Cucamonga city,California,1,1990,101409,53.43,68.37,5.05,50117,51292,79698,5952,5130,580,388,81111,20298
06,59920,0659920,Redding city,California,1,1990,66462,44.34,73.11,14.45,31964,34498,61545,699,2106,1433,67,63830,2632
06,59962,0659962,Redlands city,California,1,1990,60394,48.05,73.04,11.94,28905,31489,48067,2313,2539,441,129,48944,11450
06,60018,0660018,Redondo Beach city,California,1,1990,60167,61.24,83.78,7.21,30787,29380,52371,960,3876,311,235,53250,6917
06,60102,0660102,Redwood City city,California,1,1990,66072,52.08,77.95,11.51,33294,32778,54684,2406,3710,336,465,50137,15935
06,60466,0660466,Rialto city,California,1,1990,72388,48.40,64.38,6.62,35413,36975,41931,14734,2378,628,175,49601,22787
06,60620,0660620,Richmond city,California,1,1990,87425,48.21,73.57,11.34,41709,45716,31633,38260,10047,522,294,74735,12690
06,62000,0662000,Riverside city,California,1,1990,226505,51.43,71.01,8.95,112614,113891,160344,16740,10920,1910,901,167679,58826
06,62938,0662938,Roseville city,California,1,1990,44685,47.92,72.72,11.27,21576,23109,40899,407,1427,430,56,39860,4825
06,64000,0664000,Sacramento city,California,1,1990,369365,49.03,73.83,12.08,178737,190628,221963,56521,52973,4561,2453,309358,60007
06,64224,0664224,Salinas city,California,1,1990,108777,50.17,67.93,8.32,54424,54353,59343,3276,8387,1031,407,53693,55084
06,65000,0665000,San Bernardino city,California,1,1990,164164,48.54,68.41,9.99,81252,82912,99550,26281,5891,1596,671,107409,56755
06,65042,0665042,San Buenaventura (Ventura) city,California,1,1990,92575,49.72,76.49,12.47,45753,46822,79709,1551,2336,977,172,76324,16251
06,66000,0666000,San Diego city,California,1,1990,1110549,54.60,76.94,10.22,566464,544085,745406,104261,124793,6800,6152,881030,229519
06,67000,0667000,San Francisco city,California,1,1990,723959,52.88,83.86,14.56,362497,361462,387783,79039,207155,3456,3721,623242,100717
06,68000,0668000,San Jose city,California,1,1990,782248,53.17,73.29,7.20,397709,384539,491280,36790,148793,5416,4022,573860,208388
06,68084,0668084,San Leandro city,California,1,1990,68223,43.94,80.95,19.27,32450,35773,50582,3923,8774,508,618,57860,10363
06,68196,0668196,San Marcos city,California,1,1990,38974,48.39,72.89,14.66,19528,19446,33014,567,1034,297,108,28272,10702
06,68252,0668252,San Mateo city,California,1,1990,85486,47.86,81.19,16.26,41467,44019,67170,3060,9902,330,1475,72251,13235
06,68378,0668378,San Ramon city,California,1,1990,35303,54.55,73.22,4.31,17556,17747,30750,711,3100,123,75,33239,2064
06,69000,0669000,Santa Ana city,California,1,1990,293742,56.77,69.53,5.62,156394,137348,199727,7685,27205,1536,1380,102359,191383
06,69070,0669070,Santa Barbara city,California,1,1990,85571,52.37,81.71,16.21,41912,43659,66529,1920,1921,758,76,58651,26920
06,69084,0669084,Santa Clara city,California,1,1990,93613,56.03,81.22,9.98,47545,46068,68984,2404,16984,473,432,79353,14260
06,69088,0669088,Santa Clarita city,California,1,1990,110642,53.25,72.02,6.25,55282,55360,96555,1695,4471,624,136,95871,14771
06,69196,0669196,Santa Maria city,California,1,1990,61284,46.91,70.14,12.04,30397,30887,37722,1350,3629,582,87,33270,28014
06,70000,0670000,Santa Monica city,California,1,1990,86905,52.18,86.22,16.51,41007,45898,71961,3920,5421,384,129,74695,12210
06,70098,0670098,Santa Rosa city,California,1,1990,113313,46.88,76.16,16.30,54142,59171,101270,2031,3556,1382,255,102586,10727
06,72016,0672016,Simi Valley city,California,1,1990,100217,52.56,71.81,5.26,50368,49849,88345,1527,5269,615,205,87510,12707
06,73080,0673080,South Gate city,California,1,1990,86284,51.24,65.46,7.25,43042,43242,35936,1437,1205,382,189,14557,71727
06,75000,0675000,Stockton city,California,1,1990,210943,46.68,68.24,10.48,104522,106421,121372,20321,47364,2061,723,158290,52653
06,77000,0677000,Sunnyvale city,California,1,1990,117229,53.46,80.84,10.40,59323,57906,83972,4022,21966,608,689,101785,15444
06,78120,0678120,Temecula city,California,1,1990,27099,51.14,67.15,6.31,13786,13313,24583,414,710,170,48,23160,3939
06,78582,0678582,Thousand Oaks city,California,1,1990,104352,48.58,75.33,9.03,51759,52593,94332,1270,4823,414,167,94333,10019
06,80000,0680000,Torrance city,California,1,1990,133107,48.65,79.59,11.95,65374,67733,97144,1933,28603,539,494,119709,13398
06,80238,0680238,Tracy city,California,1,1990,33558,50.51,68.70,8.07,16835,16723,28944,855,1420,347,130,25413,8145
06,80812,0680812,Turlock city,California,1,1990,42198,47.41,70.68,12.49,20248,21950,34820,500,1770,393,75,33349,8849
06,80854,0680854,Tustin city,California,1,1990,50689,56.43,76.05,7.51,25535,25154,37127,2895,5061,274,199,40181,10508
06,81204,0681204,Union City city,California,1,1990,53762,51.39,70.35,7.14,26616,27146,23613,4612,17343,318,635,40278,13484
06,81344,0681344,Upland city,California,1,1990,63374,48.86,73.27,9.20,30953,32421,49972,3380,4365,286,92,52259,11115
06,81554,0681554,Vacaville city,California,1,1990,71479,55.11,73.29,6.83,39478,32001,56351,6370,2346,707,378,60113,11366
06,81666,0681666,Vallejo city,California,1,1990,109199,49.07,72.01,10.85,54444,54755,55100,23098,23605,810,1458,97422,11777
06,82590,0682590,Victorville city,California,1,1990,40674,46.41,68.99,11.57,20158,20516,29724,3899,1382,442,109,31321,9353
06,82954,0682954,Visalia city,California,1,1990,75636,46.08,68.89,11.10,36523,39113,56554,1114,4768,737,101,56631,19005
06,82996,0682996,Vista city,California,1,1990,71872,50.69,73.05,12.17,35886,35986,57972,3201,2328,593,525,54068,17804
06,84200,0684200,West Covina city,California,1,1990,96086,49.98,72.39,8.70,47137,48949,57436,8203,16329,485,193,62833,33253
06,84550,0684550,Westminster city,California,1,1990,78118,49.96,74.81,9.38,39584,38534,54396,868,17053,464,559,63222,14896
06,85292,0685292,Whittier city,California,1,1990,77671,47.78,74.32,13.89,37969,39702,57048,992,2428,462,153,47393,30278
08,03455,0803455,Arvada city,Colorado,1,1990,89235,48.60,72.37,7.62,43768,45467,84129,513,1718,475,50,82592,6643
08,04000,0804000,Aurora city,Colorado,1,1990,222103,53.97,72.64,6.77,108041,114062,183046,25394,8102,1426,274,207335,14768
08,07850,0807850,Boulder city,Colorado,1,1990,83312,65.56,84.85,7.84,42065,41247,77090,1048,3152,414,56,79290,4022
08,16000,0816000,Colorado Springs city,Colorado,1,1990,281140,51.23,73.19,9.17,137611,143529,241513,19746,6279,2335,566,255478,25662
08,20000,0820000,Denver city,Colorado,1,1990,467610,49.88,78.00,13.86,227517,240093,337198,60046,10652,5381,353,360228,107382
08,27425,0827425,Fort Collins city,Colorado,1,1990,87758,60.53,77.56,7.73,43512,44246,81877,856,2032,459,66,81561,6197
08,32155,0832155,Greeley city,Colorado,1,1990,60536,52.64,75.30,11.18,29356,31180,53936,408,556,366,51,48209,12327
08,43000,0843000,Lakewood city,Colorado,1,1990,126481,49.02,77.70,10.55,61352,65129,117819,1316,2369,872,66,114975,11506
08,45970,0845970,Longmont city,Colorado,1,1990,51555,48.94,71.47,9.91,25209,26346,47810,197,616,379,16,45840,5715
08,46465,0846465,Loveland city,Colorado,1,1990,37352,45.58,71.13,12.99,18038,19314,35436,111,252,179,14,34825,2527
08,62000,0862000,Pueblo city,Colorado,1,1990,98640,43.07,73.81,15.98,47332,51308,81824,2147,591,822,31,59671,38969
08,77290,0877290,Thornton city,Colorado,1,1990,55031,53.28,67.28,5.33,27029,28002,49357,699,883,501,28,45722,9309
08,83835,0883835,Westminster city,Colorado,1,1990,74625,55.22,70.46,4.75,36682,37943,67643,742,2722,468,33,66055,8570
09,08000,0908000,Bridgeport city,Connecticut,1,1990,141686,47.99,73.89,13.58,67270,74416,82945,37684,3257,405,31,104139,37547
09,18430,0918430,Danbury city,Connecticut,1,1990,65585,51.35,78.19,11.59,32242,33343,56897,4311,2562,132,20,60540,5045
09,37000,0937000,Hartford city,Connecticut,1,1990,139739,52.06,72.53,9.88,66639,73100,55869,54338,1994,450,30,95602,44137
09,50370,0950370,New Britain city,Connecticut,1,1990,75491,48.81,78.89,16.90,36053,39438,61605,5723,1323,130,25,63207,12284
09,52000,0952000,New Haven city,Connecticut,1,1990,130474,53.20,76.29,12.31,61366,69108,70263,47157,3113,402,28,113231,17243
09,55990,0955990,Norwalk city,Connecticut,1,1990,78331,49.54,79.88,12.63,37794,40537,62106,12123,1285,100,5,70992,7339
09,73000,0973000,Stamford city,Connecticut,1,1990,108056,48.45,79.85,13.26,51650,56406,82421,19217,2747,135,64,97494,10562
09,80000,0980000,Waterbury city,Connecticut,1,1990,108961,46.40,76.54,16.45,51508,57453,86681,14133,781,344,6,94383,14578
10,77580,1077580,Wilmington city,Delaware,1,1990,71529,47.26,75.08,14.79,33249,38280,30134,37446,309,156,6,66457,5072
11,50000,1150000,Washington city,District of Columbia,1,1990,606900,52.31,80.71,12.83,282970,323930,179667,399604,10923,1466,291,574190,32710
12,07300,1207300,Boca Raton city,Florida,1,1990,61492,41.75,82.83,21.48,29522,31970,58035,1784,1159,44,8,58054,3438
12,07875,1207875,Boynton Beach city,Florida,1,1990,46194,37.08,81.80,30.30,21575,24619,35912,9296,279,52,11,43070,3124
12,10275,1210275,Cape Coral city,Florida,1,1990,74991,38.45,78.57,22.00,36149,38842,73090,758,462,126,5,72242,2749
12,12875,1212875,Clearwater city,Florida,1,1990,98784,39.08,82.46,25.58,45523,53261,88046,8863,994,240,25,95898,2886
12,14400,1214400,Coral Springs city,Florida,1,1990,79443,51.48,69.04,6.97,38771,40672,73949,2764,1668,142,16,73785,5658
12,16475,1216475,Davie town,Florida,1,1990,47217,51.62,75.10,8.96,23097,24120,43829,1820,811,100,15,42504,4713
12,16725,1216725,Deerfield Beach city,Florida,1,1990,46325,35.25,86.43,36.35,21042,25283,37787,7728,382,49,9,44536,1789
12,17200,1217200,Deltona CDP,Florida,1,1990,50828,41.66,74.57,18.55,24603,26225,47683,1683,340,139,15,45689,5139
12,24000,1224000,Fort Lauderdale city,Florida,1,1990,149377,46.16,81.22,17.78,75312,74065,103980,41995,1256,321,41,138696,10681
12,25175,1225175,Gainesville city,Florida,1,1990,84770,60.89,80.42,9.41,41727,43043,62186,18177,3319,153,24,81038,3732
12,30000,1230000,Hialeah city,Florida,1,1990,188004,42.30,76.68,14.01,89791,98213,169072,3636,995,185,18,23352,164652
12,32000,1232000,Hollywood city,Florida,1,1990,121697,40.19,80.87,23.09,57655,64042,107396,10365,1558,256,53,107267,14430
12,38250,1238250,Lakeland city,Florida,1,1990,70576,40.52,78.73,22.86,32571,38005,55133,14255,618,123,18,68274,2302
12,39425,1239425,Largo city,Florida,1,1990,65674,36.27,85.90,32.39,30144,35530,64113,651,522,127,31,64394,1280
12,39550,1239550,Lauderhill city,Florida,1,1990,49708,44.65,77.79,21.31,23011,26697,29124,19158,734,71,9,46332,3376
12,43975,1243975,Melbourne city,Florida,1,1990,59646,46.58,79.56,16.97,29180,30466,52145,5666,1206,192,18,57571,2075
12,45000,1245000,Miami city,Florida,1,1990,358548,42.49,76.99,16.55,173223,185325,235358,98207,2214,545,58,134584,223964
12,45025,1245025,Miami Beach city,Florida,1,1990,92639,38.64,85.88,30.11,43190,49449,81800,4798,1100,142,24,49297,43342
12,45975,1245975,Miramar city,Florida,1,1990,40663,48.82,73.26,9.68,19608,21055,32243,6368,912,69,22,33615,7048
12,53000,1253000,Orlando city,Florida,1,1990,164693,55.71,79.12,11.39,82861,81832,113243,44303,2460,506,104,150292,14401
12,54000,1254000,Palm Bay city,Florida,1,1990,62632,48.28,72.78,11.39,31182,31450,55902,4689,1074,158,30,59317,3315
12,54200,1254200,Palm Coast CDP,Florida,1,1990,14287,28.24,83.41,31.42,6824,7463,13133,854,189,23,4,13408,879
12,55775,1255775,Pembroke Pines city,Florida,1,1990,65452,44.70,79.70,19.44,30605,34847,59746,3441,1295,103,9,57920,7532
12,57425,1257425,Plantation city,Florida,1,1990,66692,46.52,78.94,14.38,31967,34725,60491,4112,1205,80,14,61262,5430
12,58050,1258050,Pompano Beach city,Florida,1,1990,72411,39.75,82.89,25.24,34829,37582,50666,20625,393,104,22,68533,3878
12,63000,1263000,St. Petersburg city,Florida,1,1990,238629,42.04,80.16,22.19,110824,127805,186125,46726,3886,596,81,232374,6255
12,69700,1269700,Sunrise city,Florida,1,1990,64407,43.50,78.26,23.03,30288,34119,57517,4759,1212,58,35,58842,5565
12,70600,1270600,Tallahassee city,Florida,1,1990,124773,61.49,81.02,8.77,59400,65373,85140,36298,2149,283,40,121035,3738
12,71000,1271000,Tampa city,Florida,1,1990,280015,47.56,76.97,14.62,134380,145635,198542,70131,3670,834,124,238006,42009
12,76600,1276600,West Palm Beach city,Florida,1,1990,67643,46.22,79.14,18.17,32344,35299,42889,22063,589,94,37,58066,9577
13,01052,1301052,Albany city,Georgia,1,1990,78122,46.92,69.16,10.75,36218,41904,34544,42962,325,155,10,77475,647
13,04000,1304000,Atlanta city,Georgia,1,1990,394017,51.69,75.91,11.28,187877,206140,122327,264262,3434,563,64,386492,7525
13,49000,1349000,Macon city,Georgia,1,1990,106612,45.54,73.47,14.56,48282,58330,50265,55645,434,127,10,105955,657
13,67284,1367284,Roswell city,Georgia,1,1990,47923,52.30,74.85,6.87,23493,24430,44162,2327,846,64,5,46638,1285
13,68516,1368516,Sandy Springs CDP,Georgia,1,1990,67842,53.17,81.79,9.78,32016,35826,60797,5152,1093,74,13,65869,1973
13,69000,1369000,Savannah city,Georgia,1,1990,137560,46.34,73.21,13.78,64769,72791,64446,70580,1507,270,74,135604,1956
13,80508,1380508,Warner Robins city,Georgia,1,1990,43726,49.01,72.11,8.21,21141,22585,31779,10910,619,134,12,42939,787
16,08830,1608830,Boise City city,Idaho,1,1990,125738,49.74,74.39,11.91,60783,64955,121262,730,1810,808,164,122315,3423
16,52120,1652120,Meridian city,Idaho,1,1990,9596,47.87,67.64,10.28,4658,4938,9377,31,63,42,8,9361,235
16,56260,1656260,Nampa city,Idaho,1,1990,28365,44.47,71.49,16.43,13588,14777,25388,75,235,275,64,24747,3618
17,02154,1702154,Arlington Heights village,Illinois,1,1990,75460,45.96,77.34,12.24,36321,39139,71514,479,2788,52,9,73414,2046
17,03012,1703012,Aurora city,Illinois,1,1990,99581,50.77,68.86,8.60,49195,50386,73761,11814,1299,237,15,76717,22864
17,06613,1706613,Bloomington city,Illinois,1,1990,51972,51.60,75.88,11.99,24396,27576,47250,3480,750,89,12,51129,843
17,07133,1707133,Bolingbrook village,Illinois,1,1990,40843,54.20,65.53,3.47,20360,20483,31353,6384,2038,124,8,38452,2391
17,12385,1712385,Champaign city,Illinois,1,1990,63502,63.97,81.64,8.16,32871,30631,51254,9006,2589,113,19,62264,1238
17,14000,1714000,Chicago city,Illinois,1,1990,2783726,48.88,74.04,11.86,1334705,1449021,1263524,1087711,102938,7064,1180,2237874,545852
17,14351,1714351,Cicero town,Illinois,1,1990,67436,46.61,71.58,13.70,33574,33862,50692,141,1061,260,31,42505,24931
17,18823,1718823,Decatur city,Illinois,1,1990,83885,42.88,74.85,16.14,39257,44628,69164,13994,401,120,10,83438,447
17,23074,1723074,Elgin city,Illinois,1,1990,77010,50.17,71.69,10.53,38018,38992,59916,5630,2656,172,14,62434,14576
17,24582,1724582,Evanston city,Illinois,1,1990,73233,55.31,81.75,12.37,34374,38859,51684,16749,3501,131,34,70544,2689
17,38570,1738570,Joliet city,Illinois,1,1990,76836,46.10,72.47,14.49,37311,39525,53190,16600,737,148,5,67095,9741
17,51622,1751622,Naperville city,Illinois,1,1990,85351,51.63,69.57,5.57,42012,43339,78998,1795,4121,78,12,83824,1527
17,57225,1757225,Palatine village,Illinois,1,1990,39253,50.37,76.35,8.95,19161,20092,36995,370,1263,42,11,37843,1410
17,59000,1759000,Peoria city,Illinois,1,1990,113504,45.67,74.04,14.43,53586,59918,86852,23692,1883,206,23,111691,1813
17,65000,1765000,Rockford city,Illinois,1,1990,139426,45.59,74.01,14.73,66200,73226,113118,20868,2136,356,15,133585,5841
17,68003,1768003,Schaumburg village,Illinois,1,1990,68586,55.46,76.38,7.29,33457,35129,62140,1471,4441,80,13,66757,1829
17,72000,1772000,Springfield city,Illinois,1,1990,105227,46.39,75.70,14.86,48440,56787,90069,13687,1018,172,15,104357,870
17,79293,1779293,Waukegan city,Illinois,1,1990,69392,49.77,72.92,10.98,34196,35196,44633,13772,2092,274,31,52949,16443
18,05860,1805860,Bloomington city,Indiana,1,1990,60633,72.51,87.39,6.92,28785,31848,55271,2441,2426,122,23,59640,993
18,10342,1810342,Carmel city,Indiana,1,1990,25380,45.06,71.36,8.88,12214,13166,24609,132,574,23,2,25154,226
18,22000,1822000,Evansville city,Indiana,1,1990,126272,44.64,76.92,17.15,58620,67652,113090,12031,695,239,21,125540,732
18,23278,1823278,Fishers town,Indiana,1,1990,7508,57.14,68.50,3.52,3708,3800,7315,77,94,11,0,7430,78
18,25000,1825000,Fort Wayne city,Indiana,1,1990,173072,47.85,73.63,13.34,82311,90761,139244,28989,1688,560,56,168393,4679
18,27000,1827000,Gary city,Indiana,1,1990,116646,43.37,68.22,11.37,53602,63044,19020,93982,206,175,7,109956,6690
18,31000,1831000,Hammond city,Indiana,1,1990,84236,45.09,73.18,14.28,40793,43443,71465,7743,326,203,22,74295,9941
18,40788,1840788,Lafayette city,Indiana,1,1990,43764,48.54,75.77,13.21,21185,22579,41945,936,455,145,9,43031,733
18,51876,1851876,Muncie city,Indiana,1,1990,71035,53.73,80.41,13.30,33105,37930,63304,6774,481,186,20,70410,625
18,71000,1871000,South Bend city,Indiana,1,1990,105511,44.25,74.08,16.81,49812,55699,80221,22049,887,386,29,101965,3546
19,12000,1912000,Cedar Rapids city,Iowa,1,1990,108751,47.98,75.91,13.17,52235,56516,103884,3127,1046,260,21,107508,1243
19,19000,1919000,Davenport city,Iowa,1,1990,95333,46.82,72.78,12.74,45686,49647,84968,7521,969,388,31,92033,3300
19,21000,1921000,Des Moines city,Iowa,1,1990,193187,48.60,75.82,13.40,91074,102113,172417,13741,4543,699,59,188558,4629
19,38595,1938595,Iowa City city,Iowa,1,1990,59738,68.26,83.13,6.57,29560,30178,54410,1516,3322,116,19,58720,1018
19,73335,1973335,Sioux City city,Iowa,1,1990,80505,44.52,72.41,14.69,38539,41966,74525,1848,1185,1624,10,77881,2624
19,82425,1982425,Waterloo city,Iowa,1,1990,66467,42.91,73.64,15.65,31350,35117,57581,8068,447,118,2,65936,531
20,36000,2036000,Kansas City city,Kansas,1,1990,149767,45.11,71.52,13.01,71361,78406,97356,43834,1806,1025,48,139062,10705
20,38900,2038900,Lawrence city,Kansas,1,1990,65608,65.35,81.06,6.99,32657,32951,57149,3192,2502,1945,31,63667,1941
20,52575,2052575,Olathe city,Kansas,1,1990,63352,54.32,67.60,5.23,31088,32264,59731,1912,1046,279,20,62207,1145
20,53775,2053775,Overland Park city,Kansas,1,1990,111790,49.11,75.24,9.90,53286,58504,106648,2051,2109,341,36,109592,2198
20,71000,2071000,Topeka city,Kansas,1,1990,119883,45.90,75.43,14.75,57054,62829,101550,12761,909,1538,39,112953,6930
20,79000,2079000,Wichita city,Kansas,1,1990,304011,47.90,73.50,12.39,147659,156352,250176,34301,7671,3527,102,288761,15250
22,05000,2205000,Baton Rouge city,Louisiana,1,1990,219531,50.48,75.05,11.46,103776,115755,118429,96346,3652,318,21,216089,3442
22,39475,2239475,Kenner city,Louisiana,1,1990,72033,51.28,70.09,6.62,34687,37346,55765,13021,1198,199,19,64793,7240
22,40735,2240735,Lafayette city,Louisiana,1,1990,94440,50.76,73.66,9.51,45410,49030,66867,25679,1258,191,16,92826,1614
22,41155,2241155,Lake Charles city,Louisiana,1,1990,70580,44.85,72.72,13.23,33418,37162,40441,29387,370,151,7,69769,811
22,55000,2255000,New Orleans city,Louisiana,1,1990,496938,47.13,72.54,13.01,230883,266055,173554,307728,9559,759,119,479700,17238
22,70000,2270000,Shreveport city,Louisiana,1,1990,198525,44.25,71.57,13.70,91458,107067,107838,88860,995,389,22,196369,2156
23,60545,2360545,Portland city,Maine,1,1990,64358,52.24,80.17,15.00,29909,34449,62161,720,1062,262,9,63845,513
24,04000,2404000,Baltimore city,Maryland,1,1990,736014,47.73,75.56,13.71,343513,392501,287753,435768,7822,2555,120,728412,7602
25,07000,2507000,Boston city,Massachusetts,1,1990,574283,57.03,80.87,11.48,275972,298311,360875,146945,30181,1884,207,512328,61955
25,09000,2509000,Brockton city,Massachusetts,1,1990,92788,47.54,73.48,12.38,44590,48198,74449,12028,1562,269,27,86928,5860
25,11000,2511000,Cambridge city,Massachusetts,1,1990,95802,63.09,85.79,10.51,46554,49248,72122,12930,8052,288,29,89296,6506
25,23000,2523000,Fall River city,Massachusetts,1,1990,92703,44.05,75.68,18.07,42873,49830,90076,952,1220,94,10,91126,1577
25,34550,2534550,Lawrence city,Massachusetts,1,1990,70207,46.72,68.46,12.60,33543,36664,45624,4496,1334,367,24,40970,29237
25,37000,2537000,Lowell city,Massachusetts,1,1990,103439,50.52,73.90,12.09,50391,53048,83859,2474,11470,177,23,92940,10499
25,37490,2537490,Lynn city,Massachusetts,1,1990,81245,46.56,75.31,15.11,38838,42407,67482,6545,2993,227,10,73813,7432
25,45000,2545000,New Bedford city,Massachusetts,1,1990,99922,43.79,75.03,17.39,46831,53091,87486,4069,383,404,21,93269,6653
25,45560,2545560,Newton city,Massachusetts,1,1990,82585,49.87,81.46,14.88,38062,44523,76623,1717,3732,95,28,80947,1638
25,55745,2555745,Quincy city,Massachusetts,1,1990,84985,50.05,82.90,16.73,39482,45503,77915,928,5554,177,23,83788,1197
25,62535,2562535,Somerville city,Massachusetts,1,1990,76210,59.15,84.43,12.34,36447,39763,67624,4267,2800,112,24,71426,4784
25,67000,2567000,Springfield city,Massachusetts,1,1990,156983,47.69,73.18,13.74,74012,82971,107626,30064,1598,333,38,130455,26528
25,82000,2582000,Worcester city,Massachusetts,1,1990,169759,48.91,77.71,16.07,80867,88892,147827,7669,4731,540,39,153501,16258
26,03000,2603000,Ann Arbor city,Michigan,1,1990,109592,65.00,82.74,7.19,54204,55388,89841,9905,8395,386,29,106765,2827
26,21000,2621000,Dearborn city,Michigan,1,1990,89286,43.57,76.92,17.98,43172,46114,87099,494,828,297,9,86803,2483
26,22000,2622000,Detroit city,Michigan,1,1990,1027974,46.82,70.59,12.15,476814,551160,222316,777916,8325,3655,136,999501,28473
26,27440,2627440,Farmington Hills city,Michigan,1,1990,74652,47.94,77.36,11.75,36324,38328,70073,1429,2864,129,6,73765,887
26,29000,2629000,Flint city,Michigan,1,1990,140761,47.15,69.63,10.73,65837,74924,69788,67485,671,1045,19,136747,4014
26,34000,2634000,Grand Rapids city,Michigan,1,1990,189126,48.88,72.49,13.07,89855,99271,144464,35073,2110,1573,54,179732,9394
26,42160,2642160,Kalamazoo city,Michigan,1,1990,80277,57.35,77.98,10.85,37849,42428,62039,15053,1484,450,21,78124,2153
26,46000,2646000,Lansing city,Michigan,1,1990,127321,51.74,72.58,9.56,60351,66970,94135,23626,2211,1295,52,117209,10112
26,49000,2649000,Livonia city,Michigan,1,1990,100850,44.01,76.88,13.07,48997,51853,98870,265,1346,182,6,99495,1355
26,69035,2669035,Rochester Hills city,Michigan,1,1990,61766,48.95,73.59,8.66,30038,31728,58667,844,1954,132,5,60891,875
26,74900,2674900,Southfield city,Michigan,1,1990,75728,46.03,79.82,16.97,35466,40262,51409,22053,1790,190,11,74428,1300
26,76460,2676460,Sterling Heights city,Michigan,1,1990,117810,49.65,74.07,9.23,57478,60332,113452,475,3351,279,18,116496,1314
26,80700,2680700,Troy city,Michigan,1,1990,72884,47.82,73.44,8.42,35708,37176,66701,983,4932,115,11,71957,927
26,84000,2684000,Warren city,Michigan,1,1990,144864,43.93,79.07,14.88,70439,74425,140995,1047,1930,669,12,143281,1583
26,86000,2686000,Westland city,Michigan,1,1990,84724,50.51,76.41,10.77,40655,44069,80197,2829,817,467,14,83130,1594
26,88940,2688940,Wyoming city,Michigan,1,1990,63891,50.43,72.22,9.74,30990,32901,59752,1736,937,350,18,61657,2234
27,06616,2706616,Bloomington city,Minnesota,1,1990,86335,47.87,78.73,10.29,41777,44558,81766,1394,2643,248,26,85530,805
27,07966,2707966,Brooklyn Park city,Minnesota,1,1990,56381,55.90,69.85,3.32,27749,28632,51079,2785,1907,348,9,55731,650
27,17000,2717000,Duluth city,Minnesota,1,1990,85493,46.64,77.19,17.08,40302,45191,81980,747,749,1837,19,84983,510
27,43000,2743000,Minneapolis city,Minnesota,1,1990,368383,55.18,79.38,12.95,178671,189712,288967,47948,15550,12335,173,360483,7900
27,51730,2751730,Plymouth city,Minnesota,1,1990,50889,52.49,72.72,5.00,25279,25610,48682,821,1022,185,18,50371,518
27,54880,2754880,Rochester city,Minnesota,1,1990,70745,49.97,74.02,10.95,33754,36991,66650,728,2911,214,15,69923,822
27,58000,2758000,St. Paul city,Minnesota,1,1990,272235,50.25,75.42,13.74,128606,143629,223947,20083,19033,3697,164,260759,11476
28,29700,2829700,Gulfport city,Mississippi,1,1990,40775,45.99,74.92,14.44,19964,20811,28496,11656,353,114,23,40143,632
28,36000,2836000,Jackson city,Mississippi,1,1990,196637,48.57,72.45,11.62,91125,105512,85675,109620,971,191,13,195755,882
29,15670,2915670,Columbia city,Missouri,1,1990,69101,63.29,81.52,8.66,33148,35953,58830,6859,2828,231,19,68196,905
29,35000,2935000,Independence city,Missouri,1,1990,112301,44.51,75.91,14.38,53326,58975,108029,1627,658,684,439,110088,2213
29,38000,2938000,Kansas City city,Missouri,1,1990,435146,47.74,75.17,12.91,206965,228181,290572,128768,4994,2144,245,418129,17017
29,41348,2941348,Lee's Summit city,Missouri,1,1990,46418,48.19,71.78,10.93,21938,24480,44997,808,270,141,18,45959,459
29,54074,2954074,O'Fallon city,Missouri,1,1990,18698,50.88,68.73,6.50,9150,9548,18297,215,47,68,2,18391,307
29,64550,2964550,St. Joseph city,Missouri,1,1990,71852,43.09,74.30,17.07,33717,38135,68245,2616,236,236,16,70266,1586
29,65000,2965000,St. Louis city,Missouri,1,1990,396685,45.31,74.78,16.64,180680,216005,202085,188408,3670,950,63,391561,5124
29,70000,2970000,Springfield city,Missouri,1,1990,140494,50.43,79.42,15.18,66406,74088,134384,3527,1218,939,46,139155,1339
30,06550,3006550,Billings city,Montana,1,1990,81151,46.06,74.34,13.56,38718,42433,76738,439,443,2569,36,78670,2481
30,50200,3050200,Missoula city,Montana,1,1990,42918,53.92,77.72,12.33,20772,22146,40983,148,578,1045,44,42367,551
31,28000,3128000,Lincoln city,Nebraska,1,1990,191972,53.54,76.56,10.94,93327,98645,181320,4515,3212,1150,76,188208,3764
31,37000,3137000,Omaha city,Nebraska,1,1990,335795,47.40,74.56,12.89,160392,175403,281603,43989,3282,2274,130,325507,10288
32,31900,3231900,Henderson city,Nevada,1,1990,64942,48.93,71.72,8.34,32279,32663,59387,1725,1201,635,115,59662,5280
32,40000,3240000,Las Vegas city,Nevada,1,1990,258295,48.67,75.04,10.27,130981,127314,202549,29529,8789,2282,536,225926,32369
32,51800,3251800,North Las Vegas city,Nevada,1,1990,47707,47.80,65.81,6.76,23630,24077,21578,17827,1017,500,110,37117,10590
32,60600,3260600,Reno city,Nevada,1,1990,133850,51.49,79.21,11.81,68034,65816,115203,3851,5857,1909,648,118978,14872
32,68400,3268400,Sparks city,Nevada,1,1990,53367,50.48,74.65,9.32,26299,27068,47194,1270,2262,767,133,48797,4570
33,45140,3345140,Manchester city,New Hampshire,1,1990,99567,50.07,76.96,13.68,47725,51842,96550,968,1055,206,37,97446,2121
33,50260,3350260,Nashua city,New Hampshire,1,1990,79662,51.31,75.90,10.15,39078,40584,75800,1293,1524,177,12,77255,2407
34,08920,3408920,Burlington city,New Jersey,1,1990,9835,43.22,77.47,18.47,4631,5204,7404,2308,54,17,1,9647,188
34,10000,3410000,Camden city,New Jersey,1,1990,87492,46.94,64.39,8.40,41605,45887,16620,49362,1136,363,16,60219,27273
34,13360,3413360,Clayton borough,New Jersey,1,1990,6155,48.89,68.95,9.96,2948,3207,5080,968,32,21,0,5970,185
34,13690,3413690,Clifton city,New Jersey,1,1990,71742,43.36,82.22,20.92,33941,37801,66546,1005,2508,74,5,66865,4877
34,20350,3420350,Egg Harbor City city,New Jersey,1,1990,4583,46.26,71.63,13.86,2191,2392,3612,509,33,6,0,3624,959
34,21000,3421000,Elizabeth city,New Jersey,1,1990,110002,48.32,75.38,12.06,53617,56385,72098,21833,2969,297,33,66952,43050
34,26340,3426340,Glassboro borough,New Jersey,1,1990,15614,55.85,78.12,10.41,7360,8254,12291,2893,214,30,20,15162,452
34,29430,3429430,Hammonton town,New Jersey,1,1990,12208,43.23,78.74,18.33,5754,6454,11580,139,85,4,0,11163,1045
34,36000,3436000,Jersey City city,New Jersey,1,1990,228537,51.06,75.43,11.06,111102,117435,110263,67864,25824,787,135,173142,55395
34,39420,3439420,Lawnside borough,New Jersey,1,1990,2841,40.13,76.98,15.77,1287,1554,51,2744,7,26,0,2811,30
34,46680,3446680,Millville city,New Jersey,1,1990,25992,45.69,73.40,13.38,12316,13676,22522,2195,149,101,6,24018,1974
34,51000,3451000,Newark city,New Jersey,1,1990,275221,49.62,71.48,9.28,131584,143637,78771,160885,3205,649,76,203460,71761
34,56550,3456550,Passaic city,New Jersey,1,1990,58041,50.14,72.72,10.40,28466,29575,26304,11955,4066,292,28,29013,29028
34,57000,3457000,Paterson city,New Jersey,1,1990,140891,49.36,71.04,9.62,67797,73094,57977,50729,1989,436,35,83180,57711
34,57750,3457750,Penns Grove borough,New Jersey,1,1990,5228,43.04,68.61,13.85,2399,2829,3061,1860,10,21,2,4816,412
34,59640,3459640,Pleasantville city,New Jersey,1,1990,16027,47.94,74.91,13.97,7483,8544,5825,8826,291,62,2,14337,1690
34,65490,3465490,Salem city,New Jersey,1,1990,6883,44.36,71.22,14.85,3171,3712,3226,3489,18,24,0,6632,251
34,74000,3474000,Trenton city,New Jersey,1,1990,88675,48.22,73.41,12.71,43009,45666,37392,43689,523,223,62,76145,12530
34,74630,3474630,Union City city,New Jersey,1,1990,58012,49.17,75.83,10.03,28397,29615,43323,2965,1206,137,9,14143,43869
35,02000,3502000,Albuquerque city,New Mexico,1,1990,384736,49.74,74.99,11.12,186584,198152,301010,11484,6409,11708,251,252030,132706
35,39380,3539380,Las Cruces city,New Mexico,1,1990,62126,49.13,73.26,11.31,30418,31708,54791,1211,659,538,31,33002,29124
35,70500,3570500,Santa Fe city,New Mexico,1,1990,55859,47.23,76.95,12.79,26533,29326,45359,332,325,1249,28,29366,26493
36,01000,3601000,Albany city,New York,1,1990,101082,54.50,82.16,15.33,46999,54083,76323,20869,2312,277,14,97899,3183
36,11000,3611000,Buffalo city,New York,1,1990,328123,47.67,75.76,14.84,153050,175073,212449,100579,3229,2547,32,311994,16129
36,49121,3649121,Mount Vernon city,New York,1,1990,67153,45.91,76.83,14.88,30356,36797,26698,37138,1230,263,8,61916,5237
36,50617,3650617,New Rochelle city,New York,1,1990,67265,43.92,79.71,17.27,31484,35781,51141,12166,1961,80,6,60018,7247
36,51000,3651000,New York city,New York,1,1990,7322564,48.25,76.97,13.02,3437687,3884877,3827088,2102512,509955,27531,2764,5539053,1783511
36,63000,3663000,Rochester city,New York,1,1990,231636,51.28,74.02,12.15,109286,122350,141503,73024,4045,1103,36,211581,20055
36,65508,3665508,Schenectady city,New York,1,1990,65566,47.80,77.90,17.05,30868,34698,58093,5697,683,191,13,63805,1761
36,73000,3673000,Syracuse city,New York,1,1990,163860,51.03,77.37,14.89,76342,87518,122867,33320,3525,2062,34,159126,4734
36,84000,3684000,Yonkers city,New York,1,1990,188082,44.70,78.48,16.45,87721,100361,143339,26547,5609,342,28,156606,31476
37,02140,3702140,Asheville city,North Carolina,1,1990,61607,42.82,79.53,20.05,27944,33663,48726,12207,369,165,5,61074,533
37,10740,3710740,Cary town,North Carolina,1,1990,43858,56.42,73.69,4.43,21653,22205,39374,2417,1678,119,6,43175,683
37,12000,3712000,Charlotte city,North Carolina,1,1990,395934,51.87,75.82,9.80,188088,207846,259760,125827,7134,1425,77,390363,5571
37,14100,3714100,Concord city,North Carolina,1,1990,27347,44.81,77.77,16.78,12728,14619,21495,5623,146,63,4,27197,150
37,19000,3719000,Durham city,North Carolina,1,1990,136611,55.52,78.02,11.30,63474,73137,70640,62449,2658,334,14,135001,1610
37,22920,3722920,Fayetteville city,North Carolina,1,1990,75695,49.76,75.14,10.65,35839,39856,43578,28979,1030,973,121,73314,2381
37,25580,3725580,Gastonia city,North Carolina,1,1990,54732,45.34,74.69,14.43,25491,29241,40501,13617,381,103,3,54438,294
37,28000,3728000,Greensboro city,North Carolina,1,1990,183521,52.35,78.61,11.76,85244,98277,117237,62305,2610,852,23,181756,1765
37,28080,3728080,Greenville city,North Carolina,1,1990,44972,61.15,80.31,8.69,21278,23694,28867,15337,496,105,28,44593,379
37,31400,3731400,High Point city,North Carolina,1,1990,69496,46.67,75.89,14.10,32198,37298,47347,20980,633,375,20,68944,552
37,34200,3734200,Jacksonville city,North Carolina,1,1990,30013,52.41,70.76,7.70,14351,15662,20303,8007,800,144,102,28442,1571
37,55000,3755000,Raleigh city,North Carolina,1,1990,207951,58.88,80.37,8.82,100848,107103,143862,57354,5092,584,35,205011,2940
37,74440,3774440,Wilmington city,North Carolina,1,1990,55530,48.54,78.20,15.89,25150,30380,36059,18815,298,167,21,55053,477
37,75000,3775000,Winston-Salem city,North Carolina,1,1990,143485,49.27,78.31,14.17,65810,77675,85330,56328,1075,325,22,142249,1236
38,25700,3825700,Fargo city,North Dakota,1,1990,74111,55.99,77.58,10.06,36786,37325,71968,260,915,796,14,73567,544
39,01000,3901000,Akron city,Ohio,1,1990,223019,47.29,75.54,14.87,105192,117827,164493,54656,2668,603,33,221418,1601
39,12000,3912000,Canton city,Ohio,1,1990,84161,44.19,73.93,16.37,38843,45318,67890,15325,246,429,21,83272,889
39,15000,3915000,Cincinnati city,Ohio,1,1990,364040,48.72,74.91,13.93,169305,194735,220285,138132,3983,660,47,361654,2386
39,16000,3916000,Cleveland city,Ohio,1,1990,505616,45.13,73.08,13.99,237211,268405,250234,235405,5020,1562,95,482419,23197
39,18000,3918000,Columbus city,Ohio,1,1990,632910,55.39,76.29,9.15,305574,327336,471025,142748,14880,1469,113,626169,6741
39,21000,3921000,Dayton city,Ohio,1,1990,182044,47.79,74.18,13.14,85675,96369,106258,73595,1117,410,40,180688,1356
39,61000,3961000,Parma city,Ohio,1,1990,87876,42.46,78.85,19.10,41690,46186,86028,639,945,85,12,87108,768
39,77000,3977000,Toledo city,Ohio,1,1990,332943,47.05,73.81,13.58,157941,175002,256239,65598,3463,920,24,319736,13207
39,88000,3988000,Youngstown city,Ohio,1,1990,95732,41.24,73.77,18.25,44319,51413,56777,36487,278,228,11,91912,3820
40,09050,4009050,Broken Arrow city,Oklahoma,1,1990,58043,51.16,66.08,5.51,28642,29401,53219,1809,526,2079,32,56814,1229
40,23200,4023200,Edmond city,Oklahoma,1,1990,52315,51.26,70.84,7.02,25414,26901,48005,1621,1037,1317,19,51394,921
40,41850,4041850,Lawton city,Oklahoma,1,1990,80561,49.25,70.51,9.17,39227,41334,57019,15575,2302,2684,319,75457,5104
40,52500,4052500,Norman city,Oklahoma,1,1990,80071,57.76,77.69,8.23,39992,40079,70053,2861,2535,3867,37,78167,1904
40,55000,4055000,Oklahoma City city,Oklahoma,1,1990,444719,47.70,74.03,11.87,214466,230253,332539,71064,10233,18794,258,422686,22033
40,75000,4075000,Tulsa city,Oklahoma,1,1990,367302,47.83,75.64,12.71,175538,191764,291444,49825,5002,17091,131,357738,9564
41,05350,4105350,Beaverton city,Oregon,1,1990,53310,53.49,74.96,9.12,25514,27796,47679,533,3962,290,123,51549,1761
41,05800,4105800,Bend city,Oregon,1,1990,20469,50.41,75.22,13.48,9987,10482,19959,39,133,174,20,19984,485
41,23850,4123850,Eugene city,Oregon,1,1990,112669,53.76,78.74,12.67,54193,58476,105268,1410,3659,1004,237,109618,3051
41,31250,4131250,Gresham city,Oregon,1,1990,68235,49.29,72.62,10.04,33117,35118,64027,740,1731,654,144,65951,2284
41,34100,4134100,Hillsboro city,Oregon,1,1990,37520,49.24,69.01,8.68,18582,18938,33235,183,747,209,80,33317,4203
41,47000,4147000,Medford city,Oregon,1,1990,46951,43.48,74.76,17.39,22285,24666,44501,120,487,565,55,44564,2387
41,59000,4159000,Portland city,Oregon,1,1990,437319,49.86,78.10,14.56,211914,225405,370135,33530,21997,5399,1188,423445,13874
41,64900,4164900,Salem city,Oregon,1,1990,107786,48.71,75.96,14.55,53591,54195,98277,1632,2292,1771,285,101198,6588
42,02000,4202000,Allentown city,Pennsylvania,1,1990,105090,46.59,78.07,16.91,49690,55400,90557,5230,1397,186,17,92816,12274
42,06088,4206088,Bethlehem city,Pennsylvania,1,1990,71428,47.11,79.26,17.23,34280,37148,62540,2080,1217,59,11,62128,9300
42,24000,4224000,Erie city,Pennsylvania,1,1990,108718,45.88,74.92,16.09,51286,57432,93556,13086,501,229,13,106112,2606
42,60000,4260000,Philadelphia city,Pennsylvania,1,1990,1585577,46.27,76.07,15.18,737763,847814,848586,631936,43096,3454,426,1496384,89193
42,61000,4261000,Pittsburgh city,Pennsylvania,1,1990,369879,47.09,80.16,17.93,171722,198157,266791,95362,5862,671,75,366411,3468
42,63624,4263624,Reading city,Pennsylvania,1,1990,78380,44.80,74.63,16.64,36776,41604,61640,7607,1100,113,14,63894,14486
42,69000,4269000,Scranton city,Pennsylvania,1,1990,81805,41.79,79.06,21.92,37496,44309,79498,1290,741,73,6,81260,545
44,19180,4419180,Cranston city,Rhode Island,1,1990,76060,45.79,80.71,18.57,36594,39466,72318,1837,1338,139,10,74528,1532
44,54640,4454640,Pawtucket city,Rhode Island,1,1990,72644,46.29,76.99,16.32,34167,38477,64836,2608,457,203,15,67433,5211
44,59000,4459000,Providence city,Rhode Island,1,1990,160728,51.75,76.37,13.56,76439,84289,112404,23828,9428,1495,119,135746,24982
44,74300,4474300,Warwick city,Rhode Island,1,1990,85427,44.77,78.55,16.79,40562,44865,83695,673,702,183,11,84582,845
45,13330,4513330,Charleston city,South Carolina,1,1990,80414,52.00,77.74,12.85,37951,42463,46023,33439,661,92,24,79765,649
45,16000,4516000,Columbia city,South Carolina,1,1990,98052,59.21,80.34,11.83,48218,49834,52625,42837,1242,341,157,96108,1944
45,48535,4548535,Mount Pleasant town,South Carolina,1,1990,30108,53.10,75.48,9.36,14715,15393,27075,2766,185,39,5,29829,279
45,50875,4550875,North Charleston city,South Carolina,1,1990,70218,59.67,73.82,5.87,38208,32010,44003,24117,1070,345,72,68474,1744
45,61405,4561405,Rock Hill city,South Carolina,1,1990,41643,51.38,75.23,12.37,18940,22703,25161,15884,332,186,9,41378,265
46,52980,4652980,Rapid City city,South Dakota,1,1990,54523,48.11,72.46,11.47,26661,27862,48082,691,491,4852,50,53308,1215
46,59020,4659020,Sioux Falls city,South Dakota,1,1990,100814,49.54,74.16,11.68,48020,52794,97627,733,658,1574,30,100243,571
47,14000,4714000,Chattanooga city,Tennessee,1,1990,152466,45.32,76.69,15.26,70421,82045,99057,51338,1463,329,15,151492,974
47,15160,4715160,Clarksville city,Tennessee,1,1990,75494,56.13,73.82,7.13,39061,36433,56588,15776,1461,319,184,72583,2911
47,40000,4740000,Knoxville city,Tennessee,1,1990,165121,50.76,80.17,15.41,77047,88074,136604,26053,1696,399,29,164022,1099
47,48000,4748000,Memphis city,Tennessee,1,1990,610337,47.75,73.14,12.22,285010,325327,268600,334737,4703,960,102,605882,4455
47,51560,4751560,Murfreesboro city,Tennessee,1,1990,44922,56.37,77.87,9.87,21411,23511,36977,6508,1245,82,8,44564,358
47,52006,4752006,Nashville-Davidson (remainder),Tennessee,1,1990,488374,51.45,77.14,11.43,231709,256665,360284,118627,6754,1130,98,483742,4632
48,01000,4801000,Abilene city,Texas,1,1990,106654,48.71,72.88,11.78,51893,54761,87888,7474,1336,407,63,90105,16549
48,01924,4801924,Allen city,Texas,1,1990,18309,55.89,64.26,2.73,9162,9147,17061,595,209,111,5,17509,800
48,03000,4803000,Amarillo city,Texas,1,1990,157615,45.76,71.85,12.04,75523,82092,130358,9441,2939,1187,21,134384,23231
48,04000,4804000,Arlington city,Texas,1,1990,261721,56.71,72.91,4.97,131153,130568,216284,22009,10066,1323,205,238409,23312
48,05000,4805000,Austin city,Texas,1,1990,465622,59.25,76.94,7.43,232473,233149,328542,57868,13911,1756,230,358754,106868
48,06128,4806128,Baytown city,Texas,1,1990,63850,48.46,69.33,9.68,31453,32397,46590,7672,459,211,20,49066,14784
48,07000,4807000,Beaumont city,Texas,1,1990,114323,45.15,73.22,13.77,54377,59946,62842,47164,1892,243,13,109404,4919
48,10768,4810768,Brownsville city,Texas,1,1990,98962,46.65,63.44,8.72,46714,52248,83895,193,289,140,12,9756,89206
48,10912,4810912,Bryan city,Texas,1,1990,55002,52.75,72.88,9.78,27256,27746,38437,9452,835,135,16,44110,10892
48,13024,4813024,Carrollton city,Texas,1,1990,82169,57.43,72.03,3.40,40461,41708,68300,4014,5561,348,37,73749,8420
48,15976,4815976,College Station city,Texas,1,1990,52456,78.68,86.20,2.80,28116,24340,43520,3293,3399,108,29,47777,4679
48,17000,4817000,Corpus Christi city,Texas,1,1990,257453,47.46,69.80,10.07,125716,131737,196019,12347,2292,1112,98,127745,129708
48,19000,4819000,Dallas city,Texas,1,1990,1006877,52.78,75.03,9.72,495141,511736,556760,296994,21584,4792,368,796637,210240
48,19972,4819972,Denton city,Texas,1,1990,66270,61.77,79.73,8.13,31789,34481,54315,6316,1829,299,31,60333,5937
48,22660,4822660,Edinburg city,Texas,1,1990,29885,48.96,67.05,9.03,14316,15569,22191,139,128,55,4,4217,25668
48,24000,4824000,El Paso city,Texas,1,1990,515342,48.18,68.12,8.74,247163,268179,396122,17708,5563,2239,393,159673,355669
48,27000,4827000,Fort Worth city,Texas,1,1990,447619,49.97,73.37,11.22,220268,227351,285549,98532,8729,1914,181,360274,87345
48,27684,4827684,Frisco city,Texas,1,1990,6141,53.74,69.50,5.47,3200,2941,5121,126,29,37,0,4811,1330
48,29000,4829000,Garland city,Texas,1,1990,180650,52.63,69.99,5.52,89314,91336,143927,16028,8024,954,60,159635,21015
48,30464,4830464,Grand Prairie city,Texas,1,1990,99616,52.45,69.90,6.36,49474,50142,75524,9694,2932,774,70,79149,20467
48,35000,4835000,Houston city,Texas,1,1990,1630553,52.25,73.27,8.28,809048,821505,859069,457990,66581,4126,532,1180070,450483
48,37000,4837000,Irving city,Texas,1,1990,155037,57.88,76.05,5.43,77875,77162,122068,11653,7048,1006,98,129799,25238
48,39148,4839148,Killeen city,Texas,1,1990,63535,57.41,69.43,3.97,32006,31529,36908,19109,3140,340,514,54637,8898
48,41464,4841464,Laredo city,Texas,1,1990,122899,47.22,64.09,8.15,58725,64174,87048,144,464,195,9,7539,115360
48,41980,4841980,League City city,Texas,1,1990,30159,53.87,69.80,4.67,15111,15048,26575,1547,691,103,8,26619,3540
48,42508,4842508,Lewisville city,Texas,1,1990,46521,58.54,72.96,4.46,23239,23282,41226,2159,889,278,3,42495,4026
48,43888,4843888,Longview city,Texas,1,1990,70311,45.63,72.92,13.05,33708,36603,53884,13989,404,308,11,67415,2896
48,45000,4845000,Lubbock city,Texas,1,1990,186206,52.67,74.36,9.83,91432,94774,144549,15939,2564,570,53,144290,41916
48,45384,4845384,McAllen city,Texas,1,1990,84021,47.03,66.92,10.43,39968,44053,59603,288,562,165,14,19349,64672
48,45744,4845744,McKinney city,Texas,1,1990,21283,49.97,71.90,11.50,10459,10824,16152,2742,106,111,5,17685,3598
48,47892,4847892,Mesquite city,Texas,1,1990,101484,52.38,69.35,5.29,49144,52340,88501,5912,2622,557,44,92584,8900
48,48072,4848072,Midland city,Texas,1,1990,89443,46.40,69.10,9.37,43136,46307,71382,8179,830,332,28,70383,19060
48,48768,4848768,Mission city,Texas,1,1990,28653,43.12,66.31,14.18,13688,14965,21595,47,32,51,10,5708,22945
48,48804,4848804,Missouri City city,Texas,1,1990,36176,51.55,67.88,4.09,17750,18426,21922,10653,2250,102,11,32830,3346
48,53388,4853388,Odessa city,Texas,1,1990,89699,46.18,69.21,10.06,43397,46302,67624,5355,598,447,16,61779,27920
48,56000,4856000,Pasadena city,Texas,1,1990,119363,49.93,69.93,7.66,59568,59795,99943,1162,1826,579,47,84952,34411
48,56348,4856348,Pearland city,Texas,1,1990,18697,48.55,71.21,7.96,9168,9529,17001,312,261,64,9,16386,2311
48,57200,4857200,Pharr city,Texas,1,1990,32921,43.97,63.42,11.45,15824,17097,23122,38,32,61,0,3810,29111
48,58016,4858016,Plano city,Texas,1,1990,128713,54.11,69.53,3.56,64179,64534,113879,5325,5109,441,49,120694,8019
48,61796,4861796,Richardson city,Texas,1,1990,74840,47.29,73.35,7.52,36454,38386,64947,3502,4927,239,22,71585,3255
48,63500,4863500,Round Rock city,Texas,1,1990,30923,54.64,66.62,4.66,15200,15723,26175,1714,315,135,16,25128,5795
48,64472,4864472,San Angelo city,Texas,1,1990,84474,47.59,73.17,13.08,40667,43807,66571,4057,919,319,42,60828,23646
48,65000,4865000,San Antonio city,Texas,1,1990,935933,48.49,70.96,10.51,450695,485238,676082,65884,10254,3303,449,415651,520282
48,70808,4870808,Sugar Land city,Texas,1,1990,24529,49.11,69.27,6.66,12100,12429,19422,1219,3152,47,5,22452,2077
48,74144,4874144,Tyler city,Texas,1,1990,75450,46.25,74.52,14.76,35472,39978,49891,21252,375,214,11,68726,6724
48,76000,4876000,Waco city,Texas,1,1990,103590,49.26,75.76,14.91,49504,54086,70031,23972,923,291,32,86656,16934
48,79000,4879000,Wichita Falls city,Texas,1,1990,96259,48.17,74.02,12.61,47310,48949,77415,10788,1689,693,73,86598,9661
49,43660,4943660,Layton city,Utah,1,1990,41784,47.45,60.40,4.49,20937,20847,38727,864,893,278,72,39434,2350
49,55980,4955980,Ogden city,Utah,1,1990,63909,44.91,70.98,14.60,31211,32698,55885,1741,1007,687,116,56240,7669
49,57300,4957300,Orem city,Utah,1,1990,67561,44.34,55.96,6.17,33401,34160,65121,88,661,534,380,65521,2040
49,62470,4962470,Provo city,Utah,1,1990,86835,63.40,74.44,6.50,42112,44723,81683,229,1750,929,624,83212,3623
49,65330,4965330,St. George city,Utah,1,1990,28502,39.06,67.35,18.01,13848,14654,27586,52,128,464,72,27923,579
49,67000,4967000,Salt Lake City city,Utah,1,1990,159936,49.45,75.04,14.50,78799,81137,139177,2752,5446,2541,2120,144428,15508
49,82950,4982950,West Jordan city,Utah,1,1990,42892,47.82,53.49,2.75,21522,21370,40324,121,588,272,237,40108,2784
50,10675,5010675,Burlington city,Vermont,1,1990,39127,62.69,84.03,10.57,18231,20896,37876,390,573,123,10,38644,483
51,01000,5101000,Alexandria city,Virginia,1,1990,111183,58.90,84.59,10.26,52741,58442,76789,24339,4507,333,125,100405,10778
51,16000,5116000,Chesapeake city,Virginia,1,1990,151976,49.69,71.29,8.45,74467,77509,107399,41662,1834,444,65,150063,1913
51,35000,5135000,Hampton city,Virginia,1,1990,133793,51.15,75.02,9.57,65226,68567,78149,51981,2233,392,106,131157,2636
51,47672,5147672,Lynchburg city,Virginia,1,1990,66049,46.88,77.58,16.44,29746,36303,47853,17445,484,105,17,65573,476
51,56000,5156000,Newport News city,Virginia,1,1990,170045,51.43,72.56,9.29,83356,86689,106418,57077,3705,579,264,165335,4710
51,57000,5157000,Norfolk city,Virginia,1,1990,261229,56.25,77.04,10.51,139310,121919,148228,102012,6549,1165,266,253618,7611
51,64000,5164000,Portsmouth city,Virginia,1,1990,103907,46.03,73.19,13.86,49454,54453,53212,49180,781,303,46,102543,1364
51,67000,5167000,Richmond city,Virginia,1,1990,203056,49.84,79.32,15.36,92795,110261,88028,112122,1751,463,36,201158,1898
51,68000,5168000,Roanoke city,Virginia,1,1990,96397,45.73,78.03,17.06,44590,51807,71907,23395,702,165,15,95732,665
51,76432,5176432,Suffolk city,Virginia,1,1990,52141,43.95,72.88,12.95,24708,27433,28511,23245,186,112,14,51822,319
51,82000,5182000,Virginia Beach city,Virginia,1,1990,393069,55.28,72.04,5.91,199571,193498,316408,54671,16660,1384,365,380932,12137
53,03180,5303180,Auburn city,Washington,1,1990,33102,48.33,73.98,11.63,16163,16939,30571,452,867,689,130,32092,1010
53,05210,5305210,Bellevue city,Washington,1,1990,86874,48.45,78.94,10.39,42488,44386,75150,1939,8459,383,183,84685,2189
53,05280,5305280,Bellingham city,Washington,1,1990,52179,55.16,80.83,14.11,24838,27341,48923,411,1381,943,72,50923,1256
53,22640,5322640,Everett city,Washington,1,1990,69961,49.47,75.04,13.04,34714,35247,64177,1160,2590,1218,148,67988,1973
53,23515,5323515,Federal Way CDP,Washington,1,1990,67554,53.22,73.03,6.18,33451,34103,58537,2709,4635,604,242,65344,2210
53,35275,5335275,Kennewick city,Washington,1,1990,42155,48.52,69.15,9.06,20677,21478,37892,476,791,323,46,38471,3684
53,35415,5335415,Kent city,Washington,1,1990,37960,56.53,75.42,6.53,19053,18907,33860,1455,1571,513,97,36498,1462
53,57745,5357745,Renton city,Washington,1,1990,41688,52.98,77.78,10.53,20721,20967,34790,2731,3093,491,134,40454,1234
53,63000,5363000,Seattle city,Washington,1,1990,516259,54.12,83.55,15.19,252042,264217,388858,51948,58040,7326,2779,497910,18349
53,67000,5367000,Spokane city,Washington,1,1990,177196,46.51,75.58,16.25,84577,92619,165284,3416,3399,3622,287,173519,3677
53,70000,5370000,Tacoma city,Washington,1,1990,176664,47.70,73.96,13.73,85432,91232,138054,20110,10922,3567,1294,169994,6670
53,74060,5374060,Vancouver city,Washington,1,1990,46380,46.85,76.66,16.35,22152,24228,42795,1050,1293,593,180,44981,1399
53,80010,5380010,Yakima city,Washington,1,1990,54827,44.28,73.19,16.40,26410,28417,45258,1315,652,1108,49,45913,8914
54,14600,5414600,Charleston city,West Virginia,1,1990,57287,42.78,78.26,18.38,26038,31249,48179,8163,714,108,18,56931,356
55,02375,5502375,Appleton city,Wisconsin,1,1990,65695,48.12,72.62,11.91,31659,34036,63458,163,1573,279,9,65118,577
55,31000,5531000,Green Bay city,Wisconsin,1,1990,96466,49.09,74.07,12.62,46070,50396,90888,453,2206,2448,28,95403,1063
55,39225,5539225,Kenosha city,Wisconsin,1,1990,80352,46.45,72.99,13.50,38687,41665,72139,5137,426,297,22,75620,4732
55,48000,5548000,Madison city,Wisconsin,1,1990,191262,60.31,81.36,9.32,93179,98083,173504,8109,7414,752,57,187385,3877
55,53000,5553000,Milwaukee city,Wisconsin,1,1990,628088,48.42,72.59,12.44,296837,331251,398033,191255,11635,5858,182,588679,39409
55,66000,5566000,Racine city,Wisconsin,1,1990,84298,45.43,70.97,13.09,39985,44313,64378,15551,453,273,5,77445,6853
55,84250,5584250,Waukesha city,Wisconsin,1,1990,56958,51.55,73.53,9.81,27530,29428,54319,317,695,161,24,53592,3366
56,13900,5613900,Cheyenne city,Wyoming,1,1990,50008,46.73,73.58,12.04,24439,25569,44814,1561,534,351,50,44096,5912
