FIPS_STATE,FIPS_PLACE,FIPS_STATE_PLACE,CITY_NAME,ST_NAME,NYU_500_LARGEST,YEAR,POP_TOTAL,PER_AGE_15TO44,PER_AGE_18PLUS,PER_AGE_65PLUS,POP_MALE,POP_FEMALE,POP_WHITE,POP_BLACK,POP_ASIAN,POP_AIAN,POP_NHOPI,POP_NONHISPANIC,POP_HISPANIC
01,21184,0121184,Dothan city,Alabama,0,2000,57737,41.04,74.58,14.58,27093,30644,38873,17385,491,160,11,56973,764
01,03076,0103076,Auburn city,Alabama,0,2000,42987,69.09,84.64,6.43,21431,21556,33553,7217,1422,82,17,42321,666
01,07000,0107000,Birmingham city,Alabama,1,2000,242820,45.16,74.96,13.46,112046,130774,58457,178372,1942,422,87,239056,3764
01,35896,0135896,Hoover city,Alabama,1,2000,62742,44.63,75.23,10.86,30577,32165,54997,4248,1812,99,21,60362,2380
01,37000,0137000,Huntsville city,Alabama,1,2000,158216,43.98,76.86,13.38,76174,82042,101998,47792,3519,857,88,154991,3225
01,50000,0150000,Mobile city,Alabama,1,2000,198915,43.15,73.47,13.71,93015,105900,100251,92068,3022,487,52,196087,2828
01,51000,0151000,Montgomery city,Alabama,1,2000,201568,46.07,74.06,11.81,94573,106995,96085,100048,2146,500,71,199084,2484
01,77256,0177256,Tuscaloosa city,Alabama,1,2000,77906,53.24,80.18,11.76,37081,40825,42143,33287,1162,127,19,76814,1092
02,03000,0203000,Anchorage municipality,Alaska,1,2000,260283,48.29,70.85,5.47,131668,128615,188009,15199,14433,18941,2423,245484,14799
04,54050,0454050,Peoria city,Arizona,1,2000,108364,41.79,71.63,14.44,52058,56306,92050,3012,2077,734,120,91665,16699
04,23620,0423620,Flagstaff city,Arizona,0,2000,52894,56.48,75.74,5.34,26226,26668,41214,927,660,5284,65,44394,8500
04,04720,0404720,Avondale city,Arizona,1,2000,35883,47.86,65.76,5.29,18155,17728,22704,1866,678,459,52,19294,16589
04,07940,0407940,Buckeye town,Arizona,0,2000,6537,43.83,66.24,8.21,3297,3240,4742,220,29,112,5,4141,2396
04,12000,0412000,Chandler city,Arizona,1,2000,176581,50.73,70.20,5.82,88140,88441,136296,6151,7453,2121,251,139522,37059
04,27400,0427400,Gilbert town,Arizona,1,2000,109697,49.89,65.83,3.75,54531,55166,94043,2639,3937,676,134,96671,13026
04,27820,0427820,Glendale city,Arizona,1,2000,218812,47.38,69.90,7.39,109168,109644,165293,10270,6003,3181,293,164469,54343
04,28380,0428380,Goodyear city,Arizona,0,2000,18911,45.98,77.80,9.94,9625,9286,14775,983,323,200,16,14978,3933
04,46000,0446000,Mesa city,Arizona,1,2000,396375,45.14,72.66,13.34,196378,199997,323655,9977,5917,6572,932,318094,78281
04,55000,0455000,Phoenix city,Arizona,1,2000,1321045,48.46,71.05,8.08,671760,649285,938853,67416,26449,26696,1766,871073,449972
04,65000,0465000,Scottsdale city,Arizona,1,2000,202705,40.13,80.68,16.72,97785,104920,186883,2501,3964,1240,167,188594,14111
04,71510,0471510,Surprise city,Arizona,1,2000,30848,31.57,80.11,25.42,15158,15690,26521,806,329,134,16,23664,7184
04,73000,0473000,Tempe city,Arizona,1,2000,158625,57.84,80.15,7.19,81942,76683,122952,5801,7531,3186,455,130152,28473
04,10670,0410670,Casas Adobes CDP,Arizona,0,2000,54011,40.49,76.97,16.15,25610,28401,47889,891,1180,355,33,46577,7434
04,77000,0477000,Tucson city,Arizona,1,2000,486699,48.14,75.42,11.88,238408,248291,341424,21057,11959,11038,796,312831,173868
04,85540,0485540,Yuma city,Arizona,1,2000,77515,43.58,70.42,13.87,38589,38926,52968,2491,1164,1168,145,42115,35400
05,23290,0523290,Fayetteville city,Arkansas,1,2000,58047,58.76,80.05,8.68,29458,28589,50212,2969,1484,730,90,55226,2821
05,60410,0560410,Rogers city,Arkansas,0,2000,38829,44.82,70.56,11.79,18947,19882,33296,184,556,407,29,31339,7490
05,66080,0566080,Springdale city,Arkansas,1,2000,45798,46.52,70.99,10.24,22730,23068,37380,377,772,431,712,36793,9005
05,24550,0524550,Fort Smith city,Arkansas,1,2000,80268,43.31,74.58,13.71,38918,41350,61798,6943,3682,1358,43,73220,7048
05,35710,0535710,Jonesboro city,Arkansas,1,2000,55515,48.45,77.08,11.81,26610,28905,47394,6259,462,175,16,54218,1297
05,15190,0515190,Conway city,Arkansas,0,2000,43167,55.36,76.72,9.01,20515,22652,36272,5232,541,155,14,42184,983
05,41000,0541000,Little Rock city,Arkansas,1,2000,183133,45.68,75.30,11.65,86322,96811,100848,74003,3032,500,64,178244,4889
05,50450,0550450,North Little Rock city,Arkansas,0,2000,60433,41.74,74.50,14.59,28240,32193,37801,20535,356,249,20,58970,1463
06,03526,0603526,Bakersfield city,California,1,2000,247057,45.09,67.34,8.78,120105,126952,152849,22641,10708,3454,298,166887,80170
06,13014,0613014,Chico city,California,1,2000,59954,57.24,78.86,9.89,29422,30532,49377,1215,2524,782,115,52603,7351
06,14218,0614218,Clovis city,California,1,2000,68468,44.82,69.33,9.36,32868,35600,51914,1302,4441,1025,108,54592,13876
06,27000,0627000,Fresno city,California,1,2000,427652,45.74,67.08,9.25,210107,217545,214556,35763,48028,6763,583,257132,170520
06,45022,0645022,Madera city,California,0,2000,43207,46.27,64.58,8.82,21904,21303,20804,1665,618,1207,44,13933,29274
06,00884,0600884,Alhambra city,California,1,2000,85804,47.39,77.65,13.19,40418,45386,25758,1437,40520,614,86,55351,30453
06,02000,0602000,Anaheim city,California,1,2000,328014,48.16,69.83,8.16,164058,163956,179627,8735,39311,3041,1393,174640,153374
06,02364,0602364,Apple Valley town,California,1,2000,54239,38.50,68.45,13.73,26251,27988,41449,4277,1198,530,123,44172,10067
06,03666,0603666,Baldwin Park city,California,1,2000,75837,47.72,65.09,6.15,37911,37926,30472,1219,8826,1096,112,16177,59660
06,04982,0604982,Bellflower city,California,1,2000,72878,46.66,68.15,8.43,35520,37358,33593,9540,7062,667,511,41375,31503
06,08786,0608786,Buena Park city,California,1,2000,78282,46.54,70.59,9.33,38800,39482,41479,3000,16490,750,397,52061,26221
06,08954,0608954,Burbank city,California,1,2000,100316,46.65,77.73,12.82,48635,51681,72409,2066,9181,549,142,75363,24953
06,10046,0610046,Camarillo city,California,0,2000,57077,39.15,74.74,16.96,27641,29436,46036,856,4129,299,114,48208,8869
06,11530,0611530,Carson city,California,1,2000,89730,43.08,71.60,10.66,43315,46415,23049,22804,19987,505,2680,58398,31332
06,13210,0613210,Chino city,California,1,2000,67168,51.15,71.52,5.86,37223,29945,37412,5250,3308,628,139,35338,31830
06,13214,0613214,Chino Hills city,California,1,2000,66787,48.10,67.14,4.23,33207,33580,37656,3697,14744,375,85,49636,17151
06,15044,0615044,Compton city,California,1,2000,93493,45.69,61.50,6.89,45857,47636,15625,37690,237,656,985,40350,53143
06,16350,0616350,Corona city,California,1,2000,124966,48.51,66.60,5.83,61849,63117,77514,8031,9425,1086,387,80397,44569
06,16532,0616532,Costa Mesa city,California,1,2000,108724,53.44,76.76,8.45,55694,53030,75542,1520,7501,845,656,74201,34523
06,19766,0619766,Downey city,California,1,2000,107323,45.86,70.78,11.02,52176,55147,57395,4028,8308,929,236,45234,62089
06,20802,0620802,East Los Angeles CDP,California,0,2000,124283,48.28,65.44,7.90,62625,61658,48788,490,962,1603,70,3976,120307
06,22230,0622230,El Monte city,California,1,2000,115965,48.60,65.93,6.91,58584,57381,41360,889,21465,1596,140,32020,83945
06,24477,0624477,Florence-Graham CDP,California,0,2000,60197,48.53,60.03,4.87,30352,29845,14778,7908,70,590,56,8485,51712
06,24680,0624680,Fontana city,California,1,2000,128929,48.04,62.15,4.74,63982,64947,58006,15255,5618,1450,427,54505,74424
06,28000,0628000,Fullerton city,California,1,2000,126003,47.77,74.86,11.33,62276,63727,77977,2861,20259,865,296,87989,38014
06,29000,0629000,Garden Grove city,California,1,2000,165196,47.09,71.54,9.54,82688,82508,77443,2168,51078,1260,1081,111588,53608
06,30000,0630000,Glendale city,California,1,2000,194973,44.50,77.62,13.91,93074,101899,123960,2468,31424,629,163,156521,38452
06,32548,0632548,Hawthorne city,California,1,2000,84112,49.99,68.34,6.14,40448,43664,24618,27775,5660,629,721,46885,37227
06,33182,0633182,Hemet city,California,1,2000,58812,31.03,77.44,33.07,26941,31871,47335,1527,872,708,79,45227,13585
06,33434,0633434,Hesperia city,California,1,2000,62582,42.24,67.25,11.01,30865,31717,46485,2522,670,796,122,44182,18400
06,36000,0636000,Huntington Beach city,California,1,2000,189594,46.84,77.75,10.37,95004,94590,150194,1527,17709,1224,456,161796,27798
06,36448,0636448,Indio city,California,1,2000,49116,45.68,64.74,9.06,24710,24406,23903,1361,742,510,49,12088,37028
06,36546,0636546,Inglewood city,California,1,2000,112580,46.66,67.63,7.09,53423,59157,21505,53060,1280,773,410,60751,51829
06,36770,0636770,Irvine city,California,1,2000,143072,50.94,76.55,7.20,69235,73837,87354,2068,42672,257,194,132533,10539
06,39248,0639248,Laguna Niguel city,California,0,2000,61891,42.58,73.41,8.88,30137,31754,51682,776,4784,180,73,55466,6425
06,39486,0639486,Lake Elsinore city,California,0,2000,28928,46.55,63.98,6.68,14431,14497,18981,1501,592,374,87,17921,11007
06,39496,0639496,Lake Forest city,California,1,2000,58707,45.57,73.05,8.60,28863,29844,44629,1073,5693,295,120,47794,10913
06,39892,0639892,Lakewood city,California,1,2000,79345,43.49,72.45,11.86,38421,40924,49724,5825,10716,473,489,61274,18071
06,40130,0640130,Lancaster city,California,1,2000,118718,46.39,67.66,8.59,60257,58461,74573,19009,4523,1213,278,90074,28644
06,43000,0643000,Long Beach city,California,1,2000,461522,47.91,70.83,9.08,226718,234804,208410,68618,55591,3881,5605,296430,165092
06,44000,0644000,Los Angeles city,California,1,2000,3694820,48.98,73.44,9.67,1841805,1853015,1734036,415195,369254,29412,5915,1975747,1719073
06,44574,0644574,Lynwood city,California,1,2000,69845,49.78,61.96,4.20,35702,34143,23481,9451,533,839,269,12342,57503
06,48256,0648256,Mission Viejo city,California,1,2000,93102,41.48,72.85,10.89,45525,47577,77418,1067,7199,348,174,81836,11266
06,49270,0649270,Moreno Valley city,California,1,2000,142381,46.29,63.19,5.48,69645,72736,66689,28310,8427,1343,733,87692,54689
06,50076,0650076,Murrieta city,California,1,2000,44282,42.39,66.31,11.43,21704,22578,36152,1500,1775,293,98,36543,7739
06,51182,0651182,Newport Beach city,California,1,2000,70032,41.93,84.27,17.56,34638,35394,64583,371,2804,179,83,66731,3301
06,52526,0652526,Norwalk city,California,1,2000,103298,46.23,67.88,9.01,51109,52189,46303,4774,11924,1201,404,38333,64965
06,53896,0653896,Ontario city,California,1,2000,158007,48.64,65.63,5.90,79225,78782,75575,11864,6125,1682,587,63397,94610
06,53980,0653980,Orange city,California,1,2000,128821,47.41,73.34,9.63,64665,64156,90822,2056,12000,1010,296,87387,41434
06,54652,0654652,Oxnard city,California,1,2000,170358,47.81,68.23,8.12,87090,83268,71688,6446,12581,2143,698,57551,112807
06,55156,0655156,Palmdale city,California,1,2000,116670,45.46,62.01,5.59,57338,59332,63905,16913,4468,1198,224,72679,43991
06,56000,0656000,Pasadena city,California,1,2000,133936,47.45,76.89,12.11,65495,68441,71469,19319,13399,952,132,89202,44734
06,56700,0656700,Perris city,California,1,2000,36189,46.08,60.40,6.24,17739,18450,14909,5748,995,529,121,15867,20322
06,58072,0658072,Pomona city,California,1,2000,149473,48.61,65.38,6.39,75630,73843,62419,14398,10762,1883,311,53103,96370
06,59451,0659451,Rancho Cucamonga city,California,1,2000,127743,48.27,70.14,6.10,63895,63848,84987,10059,7656,855,341,92252,35491
06,59962,0659962,Redlands city,California,1,2000,63591,43.30,73.82,12.55,30024,33567,46858,2739,3257,597,146,48287,15304
06,60018,0660018,Redondo Beach city,California,1,2000,63261,51.98,81.20,8.48,31870,31391,49735,1592,5756,295,224,54737,8524
06,60466,0660466,Rialto city,California,1,2000,91873,45.43,62.31,6.43,44913,46960,36168,20464,2271,965,392,44823,47050
06,62000,0662000,Riverside city,California,1,2000,255166,47.74,69.94,9.03,125705,129461,151377,18906,14501,2779,991,157851,97315
06,65000,0665000,San Bernardino city,California,1,2000,185401,45.76,64.84,8.23,91150,94251,83849,30425,7772,2591,680,97379,88022
06,65042,0665042,San Buenaventura (Ventura) city,California,1,2000,100916,43.45,74.97,12.81,49654,51262,79511,1421,3028,1173,175,76343,24573
06,65084,0665084,San Clemente city,California,0,2000,49936,42.34,75.90,13.08,25264,24672,43905,385,1317,307,69,42003,7933
06,69000,0669000,Santa Ana city,California,1,2000,337977,51.71,65.82,5.49,175219,162758,144425,5749,29778,4013,1160,80880,257097
06,69088,0669088,Santa Clarita city,California,1,2000,151088,46.39,69.70,7.10,74764,76324,120157,3122,7923,886,220,120120,30968
06,70000,0670000,Santa Monica city,California,1,2000,84084,48.33,85.36,14.36,40517,43567,65832,3176,6100,396,86,72780,11304
06,72016,0672016,Simi Valley city,California,1,2000,111351,45.22,71.55,7.64,55098,56253,90561,1401,7052,780,154,92622,18729
06,73080,0673080,South Gate city,California,1,2000,96375,49.33,64.43,5.45,47767,48608,40136,923,804,901,114,7706,88669
06,73430,0673430,South Whittier CDP,California,0,2000,55193,46.96,66.95,8.21,27710,27483,28958,812,1669,678,142,16937,38256
06,78120,0678120,Temecula city,California,1,2000,57716,46.25,65.29,7.10,28510,29206,45555,1974,2728,497,174,46742,10974
06,78582,0678582,Thousand Oaks city,California,1,2000,117005,41.31,74.03,11.11,57440,59565,99563,1241,6873,627,124,101677,15328
06,80000,0680000,Torrance city,California,1,2000,137946,43.15,76.99,14.08,67087,70859,81605,3022,39462,560,481,120309,17637
06,80854,0680854,Tustin city,California,1,2000,67504,50.98,73.15,7.12,33044,34460,39639,1970,10058,448,203,44394,23110
06,81344,0681344,Upland city,California,1,2000,68393,43.40,72.66,10.76,32872,35521,45966,5164,4969,518,101,49563,18830
06,82590,0682590,Victorville city,California,1,2000,64029,42.34,65.77,11.17,31004,33025,39091,7630,2226,713,129,42603,21426
06,84200,0684200,West Covina city,California,1,2000,105080,45.09,71.50,10.35,51019,54061,46086,6696,23849,823,226,57029,48051
06,84550,0684550,Westminster city,California,1,2000,88207,45.48,74.07,11.16,44080,44127,40392,871,33629,535,406,69069,19138
06,85292,0685292,Whittier city,California,1,2000,83680,45.12,71.72,12.53,40687,42993,52876,1019,2770,1105,126,36915,46765
06,86832,0686832,Yorba Linda city,California,0,2000,58918,41.08,70.70,7.68,28943,29975,48015,688,6537,220,56,52874,6044
06,46898,0646898,Merced city,California,1,2000,63893,44.47,65.32,9.42,31226,32667,33481,4044,7267,818,133,37468,26425
06,48354,0648354,Modesto city,California,1,2000,188856,43.58,69.93,11.10,91572,97284,131414,7499,11388,2335,951,140546,48310
06,80812,0680812,Turlock city,California,1,2000,55810,44.97,70.16,11.83,26870,28940,40370,798,2518,523,153,39388,16422
06,59920,0659920,Redding city,California,1,2000,80865,40.70,73.89,15.54,38750,42115,71727,851,2386,1802,94,76472,4393
06,02553,0602553,Arden-Arcade CDP,California,0,2000,96025,42.98,78.60,16.63,45550,50475,74285,5779,4664,920,411,84524,11501
06,11390,0611390,Carmichael CDP,California,0,2000,49742,39.11,76.68,17.06,23548,26194,43083,1338,1780,412,136,46263,3479
06,13588,0613588,Citrus Heights city,California,1,2000,85071,44.61,74.77,12.95,41155,43916,72001,2442,2423,860,288,76532,8539
06,18100,0618100,Davis city,California,0,2000,60308,61.31,81.37,6.64,28763,31545,42256,1417,10576,407,144,54515,5793
06,22020,0622020,Elk Grove CDP,California,1,2000,59984,45.98,67.05,6.75,29268,30716,35464,5110,10553,562,355,51586,8398
06,24638,0624638,Folsom city,California,1,2000,51884,49.20,75.80,8.81,28658,23226,40415,3109,3731,302,100,46970,4914
06,59444,0659444,Rancho Cordova CDP,California,0,2000,55060,46.34,71.63,10.11,26897,28163,36704,6245,4537,521,300,47960,7100
06,62364,0662364,Rocklin city,California,0,2000,36330,45.45,70.01,8.63,17760,18570,32086,330,1510,291,70,33456,2874
06,62938,0662938,Roseville city,California,1,2000,79921,41.93,73.24,14.47,38302,41619,68756,1047,3442,559,157,70696,9225
06,64000,0664000,Sacramento city,California,1,2000,407018,45.42,72.66,11.41,197784,209234,196549,62968,67635,5300,3861,319044,87974
06,64224,0664224,Salinas city,California,1,2000,151060,50.33,67.97,7.07,80361,70699,68218,4943,9390,1903,407,54180,96880
06,11194,0611194,Carlsbad city,California,1,2000,78247,41.62,76.69,14.03,38291,39956,67723,753,3315,329,155,69077,9170
06,13392,0613392,Chula Vista city,California,1,2000,173556,45.49,71.27,11.02,84237,89319,95553,8022,19063,1352,1013,87483,86073
06,21712,0621712,El Cajon city,California,1,2000,94869,46.61,72.14,11.33,46279,48590,70206,5090,2643,941,352,73556,21313
06,22804,0622804,Escondido city,California,1,2000,133559,46.01,70.29,11.02,66233,67326,90578,3009,5957,1646,311,81866,51693
06,53322,0653322,Oceanside city,California,1,2000,161029,45.34,72.39,13.57,79719,81310,106866,10189,8896,1370,2042,112338,48691
06,66000,0666000,San Diego city,California,1,2000,1223400,50.01,75.98,10.46,616884,606516,736207,96216,166968,7543,5853,912648,310752
06,68196,0668196,San Marcos city,California,1,2000,54977,45.82,70.89,11.87,27271,27706,37051,1099,2567,453,130,34706,20271
06,82996,0682996,Vista city,California,1,2000,89857,48.49,70.34,10.02,44891,44966,57750,3814,3323,895,607,54867,34990
06,00562,0600562,Alameda city,California,1,2000,72259,44.09,78.50,13.29,34689,37570,41148,4488,18894,484,434,65534,6725
06,02252,0602252,Antioch city,California,1,2000,90532,45.64,67.73,7.41,44331,46201,59148,8824,6697,843,360,70508,20024
06,06000,0606000,Berkeley city,California,1,2000,102743,55.70,85.87,10.20,50456,52287,60797,14007,16837,467,146,92742,10001
06,11964,0611964,Castro Valley CDP,California,0,2000,57292,41.17,76.27,14.65,27844,29448,40587,2946,7757,336,254,50308,6984
06,16000,0616000,Concord city,California,1,2000,121780,45.84,74.67,10.73,60147,61633,86114,3706,11438,929,612,95220,26560
06,17918,0617918,Daly City city,California,1,2000,103621,46.55,77.54,12.05,50971,52650,26836,4720,52522,456,940,80549,23072
06,23182,0623182,Fairfield city,California,1,2000,96178,47.03,70.20,8.98,47882,48296,54063,14446,10471,744,899,78128,18050
06,26000,0626000,Fremont city,California,1,2000,203413,48.47,74.21,8.34,102273,101140,96968,6310,75165,1048,819,176004,27409
06,33000,0633000,Hayward city,California,1,2000,140030,48.19,73.22,10.16,69490,70540,60146,15374,26579,1177,2679,92180,47850
06,41992,0641992,Livermore city,California,1,2000,73345,46.36,71.86,7.52,36664,36681,60070,1148,4251,444,208,62804,10541
06,47766,0647766,Milpitas city,California,1,2000,62698,51.49,75.38,7.04,32960,29738,19353,2295,32482,388,393,52281,10417
06,49670,0649670,Mountain View city,California,1,2000,70708,54.16,82.04,10.49,36523,34185,45090,1789,14613,273,182,57797,12911
06,50258,0650258,Napa city,California,1,2000,72585,42.43,74.28,13.83,35635,36950,58302,381,1241,657,117,53110,19475
06,53000,0653000,Oakland city,California,1,2000,399484,47.37,75.03,10.46,192757,206727,125013,142460,60851,2655,2002,312017,87467
06,55282,0655282,Palo Alto city,California,0,2000,58598,41.00,78.83,15.60,28671,29927,44391,1184,10090,122,84,55876,2722
06,57456,0657456,Pittsburg city,California,0,2000,56769,46.46,69.18,8.21,27887,28882,24712,10724,7179,423,491,38482,18287
06,57792,0657792,Pleasanton city,California,1,2000,63654,43.24,71.80,7.60,31270,32384,51203,876,7444,210,85,58643,5011
06,60102,0660102,Redwood City city,California,1,2000,75402,48.94,76.80,10.20,37930,37472,52008,1916,6715,384,663,51845,23557
06,60620,0660620,Richmond city,California,1,2000,99216,45.29,72.29,9.88,48233,50983,31117,35777,12198,639,498,72897,26319
06,67000,0667000,San Francisco city,California,1,2000,776733,51.96,85.48,13.66,394828,381905,385728,60515,239565,3458,3844,667229,109504
06,68000,0668000,San Jose city,California,1,2000,894943,49.46,73.62,8.25,454798,440145,425017,31349,240375,6865,3584,624954,269989
06,68084,0668084,San Leandro city,California,1,2000,79452,43.18,77.78,15.97,38300,41152,40754,7849,18242,609,683,63513,15939
06,68252,0668252,San Mateo city,California,1,2000,92482,45.51,79.63,15.06,45201,47281,61251,2397,13961,447,1517,73509,18973
06,68378,0668378,San Ramon city,California,1,2000,44722,45.33,73.70,6.06,22058,22664,34354,862,6680,160,95,41484,3238
06,69084,0669084,Santa Clara city,California,1,2000,102361,53.19,80.08,10.65,52086,50275,56903,2341,29966,542,437,85997,16364
06,69112,0669112,Santa Cruz city,California,0,2000,54593,56.06,82.67,8.54,27180,27413,42984,945,2677,469,72,45102,9491
06,70098,0670098,Santa Rosa city,California,1,2000,147595,43.70,75.74,13.94,72078,75517,114527,3177,5675,2099,382,119277,28318
06,73262,0673262,South San Francisco city,California,0,2000,60552,45.17,75.78,12.60,30009,30543,26671,1707,17510,362,944,41270,19282
06,77000,0677000,Sunnyvale city,California,1,2000,131760,51.74,79.59,10.59,67783,63977,70193,2927,42524,608,428,111370,20390
06,81204,0681204,Union City city,California,1,2000,66869,47.21,72.24,8.13,33248,33621,20198,4479,29016,356,610,50849,16020
06,81554,0681554,Vacaville city,California,1,2000,88625,49.05,73.01,8.26,48050,40575,63909,8880,3706,856,403,72778,15847
06,81666,0681666,Vallejo city,California,1,2000,116760,43.05,72.41,11.23,56553,60207,41996,27655,28205,767,1276,98169,18591
06,83346,0683346,Walnut Creek city,California,0,2000,64296,35.31,82.41,25.32,29683,34613,53937,688,6017,210,94,60445,3851
06,69070,0669070,Santa Barbara city,California,1,2000,92325,49.04,80.23,13.78,45454,46871,68355,1636,2554,990,126,59995,32330
06,69196,0669196,Santa Maria city,California,1,2000,77423,45.97,68.39,11.34,39312,38111,44962,1449,3673,1360,138,31227,46196
06,42202,0642202,Lodi city,California,0,2000,56999,42.23,71.77,14.28,27819,29180,42421,344,2881,494,68,41535,15464
06,45484,0645484,Manteca city,California,1,2000,49258,44.86,68.40,9.29,24161,25097,36534,1406,1733,643,179,36895,12363
06,75000,0675000,Stockton city,California,1,2000,243771,43.71,67.56,10.25,118751,125020,105446,27417,48506,2727,981,164554,79217
06,80238,0680238,Tracy city,California,1,2000,56929,47.37,65.57,6.39,28492,28437,37127,3117,4633,518,315,41164,15765
06,82954,0682954,Visalia city,California,1,2000,91565,43.34,68.75,10.88,44167,47398,63654,1754,4683,1235,117,58946,32619
06,86972,0686972,Yuba City city,California,0,2000,36758,44.68,71.01,12.21,17960,18798,24611,1035,3284,643,107,27729,9029
08,16000,0816000,Colorado Springs city,Colorado,1,2000,360890,47.33,73.50,9.64,178469,182421,291095,23677,10179,3175,764,317560,43330
08,03455,0803455,Arvada city,Colorado,1,2000,102153,42.89,73.76,10.71,50021,52132,92999,672,2215,665,68,92122,10031
08,04000,0804000,Aurora city,Colorado,1,2000,276393,49.10,72.43,7.43,136901,139492,190311,37104,12066,2248,501,221629,54764
08,07850,0807850,Boulder city,Colorado,1,2000,94673,61.45,85.17,7.81,48895,45778,83627,1154,3806,450,48,86872,7801
08,09280,0809280,Broomfield city,Colorado,0,2000,38272,48.72,70.67,6.56,19227,19045,33918,352,1585,235,14,34801,3471
08,20000,0820000,Denver city,Colorado,1,2000,554636,50.10,78.05,11.26,280207,274429,362180,61649,15611,7290,648,378932,175704
08,32155,0832155,Greeley city,Colorado,1,2000,76930,50.28,74.36,10.15,37698,39232,61853,672,885,639,106,54247,22683
08,36410,0836410,Highlands Ranch CDP,Colorado,0,2000,70931,50.20,67.31,3.27,35134,35797,64375,915,2861,233,52,67084,3847
08,43000,0843000,Lakewood city,Colorado,1,2000,144126,45.83,77.77,12.08,71141,72985,125611,2128,3918,1599,117,123177,20949
08,45970,0845970,Longmont city,Colorado,1,2000,71093,46.11,72.12,9.20,35166,35927,60255,385,1252,687,43,57535,13558
08,77290,0877290,Thornton city,Colorado,1,2000,82384,50.07,69.96,5.60,40978,41406,68137,1206,2063,924,87,64801,17583
08,83835,0883835,Westminster city,Colorado,1,2000,100940,49.99,73.14,6.52,50509,50431,84983,1237,5534,745,77,85571,15369
08,27425,0827425,Fort Collins city,Colorado,1,2000,118652,57.09,78.48,7.86,59593,59059,106347,1213,2948,715,143,108250,10402
08,46465,0846465,Loveland city,Colorado,1,2000,50608,43.11,73.10,12.50,24795,25813,46990,188,419,349,15,46271,4337
08,62000,0862000,Pueblo city,Colorado,1,2000,102121,41.33,74.88,16.61,49442,52679,77830,2465,683,1766,63,57055,45066
09,37000,0937000,Hartford city,Connecticut,1,2000,121578,47.07,69.92,9.53,58071,63507,33705,46264,1971,659,135,72318,49260
09,50370,0950370,New Britain city,Connecticut,1,2000,71538,45.18,75.83,15.77,34257,37281,49634,7794,1687,264,43,52400,19138
09,08000,0908000,Bridgeport city,Connecticut,1,2000,139529,46.06,71.57,11.48,66554,72975,62822,42925,4536,664,148,95051,44478
09,18430,0918430,Danbury city,Connecticut,1,2000,74848,48.95,78.32,11.00,36690,38158,56853,5060,4082,214,26,63057,11791
09,52000,0952000,New Haven city,Connecticut,1,2000,123626,51.53,74.56,10.25,59185,64441,53723,46181,4819,535,79,97183,26443
09,55990,0955990,Norwalk city,Connecticut,1,2000,82951,45.58,77.93,12.78,40481,42470,61339,12663,2699,174,40,69985,12966
09,73000,0973000,Stamford city,Connecticut,1,2000,117083,45.51,77.88,13.81,56622,60461,81718,18019,5856,243,46,97448,19635
09,80000,0980000,Waterbury city,Connecticut,1,2000,107271,42.67,73.47,14.96,50781,56490,72018,17500,1615,453,61,83917,23354
10,77580,1077580,Wilmington city,Delaware,1,2000,72664,46.08,74.14,12.56,34674,37990,25811,41001,473,185,20,65516,7148
11,50000,1150000,Washington city,District of Columbia,1,2000,572059,48.79,79.90,12.22,269366,302693,176101,343312,15189,1713,348,527106,44953
12,16525,1216525,Daytona Beach city,Florida,0,2000,64112,45.06,82.38,19.75,32004,32108,39963,20994,1112,206,41,61880,2232
12,17200,1217200,Deltona city,Florida,1,2000,69543,41.41,72.98,14.98,33760,35783,58659,4848,650,245,36,56796,12747
12,54200,1254200,Palm Coast city,Florida,1,2000,32732,27.76,81.47,30.24,15545,17187,27834,3360,497,78,10,30536,2196
12,10275,1210275,Cape Coral city,Florida,1,2000,102286,36.35,77.43,19.57,49584,52702,95133,2046,938,260,56,93765,8521
12,24125,1224125,Fort Myers city,Florida,0,2000,48208,45.65,73.71,14.32,23806,24402,27166,16095,471,181,49,41224,6984
12,39925,1239925,Lehigh Acres CDP,Florida,0,2000,33430,38.12,73.96,19.51,16200,17230,28183,2938,280,96,6,28964,4466
12,58715,1258715,Port St. Lucie city,Florida,1,2000,88769,38.02,75.68,18.84,43123,45646,78011,6295,1101,200,31,82092,6677
12,25175,1225175,Gainesville city,Florida,1,2000,95447,59.27,82.24,9.78,46666,48781,65243,22181,4282,235,30,89335,6112
12,35000,1235000,Jacksonville city,Florida,1,2000,735617,46.30,73.31,10.32,356284,379333,474307,213514,20427,2474,448,705023,30594
12,38250,1238250,Lakeland city,Florida,1,2000,78452,38.41,78.59,23.00,36444,42008,57677,16682,1050,217,46,73420,5032
12,43975,1243975,Melbourne city,Florida,1,2000,71382,41.40,79.33,19.72,34643,36739,60339,6658,1657,245,47,67424,3958
12,54000,1254000,Palm Bay city,Florida,1,2000,79413,41.80,73.45,14.71,38723,40690,64755,8983,1354,281,37,72563,6850
12,14400,1214400,Coral Springs city,Florida,1,2000,117549,45.92,69.33,5.99,57251,60298,95860,10766,4152,208,79,99316,18233
12,16475,1216475,Davie town,Florida,1,2000,75720,45.63,73.63,9.41,36910,38810,65916,3454,2111,187,30,61450,14270
12,16725,1216725,Deerfield Beach city,Florida,1,2000,64583,37.09,84.42,29.33,30081,34502,49894,10339,896,108,20,58940,5643
12,24000,1224000,Fort Lauderdale city,Florida,1,2000,152397,43.69,80.59,15.29,79826,72571,97941,44010,1565,344,74,137991,14406
12,30000,1230000,Hialeah city,Florida,1,2000,226419,41.54,77.03,16.64,108893,117526,199276,5453,906,304,53,21876,204543
12,32000,1232000,Hollywood city,Florida,1,2000,139357,41.67,78.71,17.34,67577,71780,109190,16853,2757,381,117,107965,31392
12,32275,1232275,Homestead city,Florida,0,2000,31909,48.71,66.84,7.83,16499,15410,19465,7194,243,159,27,15372,16537
12,36100,1236100,Kendall CDP,Florida,0,2000,75226,44.49,76.73,11.54,35311,39915,65055,3348,2250,106,21,37677,37549
12,39550,1239550,Lauderhill city,Florida,1,2000,57585,43.10,73.39,16.14,26382,31203,19482,33840,910,67,35,53590,3995
12,45000,1245000,Miami city,Florida,1,2000,362470,42.85,78.26,17.04,180194,182276,241470,80858,2376,810,130,124119,238351
12,45025,1245025,Miami Beach city,Florida,1,2000,87933,48.24,86.56,19.25,45048,42885,76276,3548,1202,206,39,40933,47000
12,45975,1245975,Miramar city,Florida,1,2000,72739,48.67,68.95,6.33,34610,38129,31704,31498,2202,118,72,51365,21374
12,55775,1255775,Pembroke Pines city,Florida,1,2000,137427,43.77,74.38,15.19,64044,73383,103870,18210,5163,255,68,98727,38700
12,57425,1257425,Plantation city,Florida,1,2000,82934,42.98,76.87,13.09,39413,43521,64967,11426,2390,143,37,72074,10860
12,58050,1258050,Pompano Beach city,Florida,1,2000,78191,39.19,82.26,23.36,38565,39626,52989,19897,636,186,22,70421,7770
12,69700,1269700,Sunrise city,Florida,1,2000,85779,43.05,75.08,17.69,40120,45659,59597,17557,2642,156,61,71124,14655
12,70675,1270675,Tamarac city,Florida,0,2000,55588,30.61,86.56,37.78,24862,30726,45625,5845,823,99,20,47314,8274
12,71569,1271569,The Hammocks CDP,Florida,0,2000,47379,51.36,71.70,6.28,22480,24899,37260,3259,1540,101,32,16426,30953
12,76582,1276582,Weston city,Florida,0,2000,49286,45.47,67.60,6.72,23892,25394,43286,1832,1561,58,8,34406,14880
12,36950,1236950,Kissimmee city,Florida,0,2000,47814,51.07,73.02,7.63,23682,24132,32139,4775,1614,247,46,27860,19954
12,53000,1253000,Orlando city,Florida,1,2000,185951,51.20,77.97,11.34,90080,95871,113611,49933,4982,638,150,153441,32510
12,56825,1256825,Pine Hills CDP,Florida,0,2000,41764,46.41,67.09,7.87,20118,21646,14172,21473,1205,116,23,35889,5875
12,57900,1257900,Poinciana CDP,Florida,0,2000,13647,44.87,65.95,8.08,6667,6980,8884,2420,140,66,13,8254,5393
12,58350,1258350,Port Charlotte CDP,Florida,0,2000,46451,29.77,81.32,30.72,21697,24754,41448,3033,529,132,22,44056,2395
12,49675,1249675,North Port city,Florida,0,2000,22797,35.41,76.68,23.41,10895,11902,21127,954,115,53,3,22058,739
12,70600,1270600,Tallahassee city,Florida,1,2000,150624,60.45,82.61,8.25,71137,79487,91007,51569,3617,376,82,144315,6309
12,08150,1208150,Brandon CDP,Florida,0,2000,77895,46.45,73.11,8.73,37743,40152,63798,7213,1865,315,72,68013,9882
12,12875,1212875,Clearwater city,Florida,1,2000,108787,38.74,80.86,21.47,52065,56722,91223,10651,1782,346,75,99033,9754
12,39425,1239425,Largo city,Florida,1,2000,69371,33.71,84.39,30.15,32268,37103,64314,1869,1171,237,58,66469,2902
12,54350,1254350,Palm Harbor CDP,Florida,0,2000,59248,35.65,79.21,23.35,27855,31393,56780,574,760,112,14,57201,2047
12,60950,1260950,Riverview CDP,Florida,0,2000,12035,44.52,72.02,8.63,5950,6085,10327,1002,160,53,8,10950,1085
12,63000,1263000,St. Petersburg city,Florida,1,2000,248232,41.43,78.47,17.39,118411,129821,177133,55502,6640,769,130,237730,10502
12,68350,1268350,Spring Hill CDP,Florida,0,2000,69078,30.52,80.54,29.36,32622,36456,64591,2073,534,167,15,64358,4720
12,71000,1271000,Tampa city,Florida,1,2000,303447,46.16,75.36,12.51,148050,155397,194871,79118,6527,1155,281,244925,58522
12,72145,1272145,Town 'n' Country CDP,Florida,0,2000,72523,47.15,75.98,10.16,35339,37184,56913,5724,2377,262,60,51513,21010
12,75875,1275875,Wesley Chapel CDP,Florida,0,2000,5691,48.01,70.90,6.47,2788,2903,4670,408,297,12,7,5016,675
12,07300,1207300,Boca Raton city,Florida,1,2000,74764,37.79,81.09,19.84,36445,38319,67851,2810,1489,123,29,68405,6359
12,07875,1207875,Boynton Beach city,Florida,1,2000,60389,37.54,80.15,25.80,28255,32134,42487,13822,918,133,30,54825,5564
12,17100,1217100,Delray Beach city,Florida,0,2000,60020,36.29,81.78,25.91,28635,31385,39908,15981,651,102,49,55836,4184
12,35875,1235875,Jupiter town,Florida,0,2000,39328,37.34,79.33,18.87,19385,19943,37307,480,442,73,47,36447,2881
12,75812,1275812,Wellington village,Florida,0,2000,38216,41.10,68.99,8.95,18669,19547,33918,2057,758,49,10,33821,4395
12,76600,1276600,West Palm Beach city,Florida,1,2000,82103,44.66,78.66,16.01,40491,41612,47696,26446,1197,274,133,67148,14955
12,71625,1271625,The Villages CDP,Florida,0,2000,8333,1.85,99.65,57.53,3970,4363,8201,43,44,8,1,8225,108
13,01052,1301052,Albany city,Georgia,1,2000,76939,45.48,72.16,11.84,35425,41514,25553,49855,459,160,22,75989,950
13,03440,1303440,Athens-Clarke County (balance),Georgia,1,2000,100266,61.81,82.24,8.04,48961,51305,64878,27442,3158,210,45,93864,6402
13,01696,1301696,Alpharetta city,Georgia,0,2000,34854,50.96,72.95,5.83,17276,17578,29150,2256,1998,68,7,32927,1927
13,04000,1304000,Atlanta city,Georgia,1,2000,416474,51.84,77.67,9.73,206725,209749,138352,255689,8046,765,173,397754,18720
13,67284,1367284,Roswell city,Georgia,1,2000,79334,47.55,75.53,7.50,39664,39670,64666,6773,2964,160,23,70913,8421
13,68516,1368516,Sandy Springs CDP,Georgia,1,2000,85781,53.77,82.21,9.76,42150,43631,66522,10332,2820,154,44,77267,8514
13,04204,1304204,Augusta-Richmond County (balance),Georgia,1,2000,195182,46.32,73.22,10.88,94141,101041,87651,98320,2976,536,238,189735,5447
13,49000,1349000,Macon city,Georgia,1,2000,97255,42.78,73.05,14.26,43141,54114,34482,60740,628,188,28,96089,1166
13,80508,1380508,Warner Robins city,Georgia,1,2000,48804,46.04,72.48,10.76,23674,25130,30504,15663,875,148,34,46948,1856
13,69000,1369000,Savannah city,Georgia,1,2000,131510,45.80,74.44,13.28,62039,69471,51108,75072,1997,303,92,128572,2938
16,08830,1608830,Boise City city,Idaho,1,2000,185787,48.34,74.67,10.02,92014,93773,171204,1437,3870,1300,302,177377,8410
16,52120,1652120,Meridian city,Idaho,1,2000,34919,48.20,66.32,6.45,17138,17781,32927,164,440,166,42,33628,1291
16,56260,1656260,Nampa city,Idaho,1,2000,51867,46.97,69.04,11.17,25404,26463,43281,206,484,490,92,42585,9282
17,06613,1706613,Bloomington city,Illinois,1,2000,64808,49.46,75.05,9.93,31413,33395,55032,5602,1958,115,28,62658,2150
17,12385,1712385,Champaign city,Illinois,1,2000,67518,61.37,82.21,8.41,34206,33312,49398,10543,4611,159,23,64794,2724
17,02154,1702154,Arlington Heights village,Illinois,1,2000,76031,39.70,76.91,16.07,36556,39475,68854,728,4548,58,30,72638,3393
17,03012,1703012,Aurora city,Illinois,1,2000,142990,50.38,68.27,6.25,72020,70970,97340,15817,4370,511,47,96433,46557
17,07133,1707133,Bolingbrook village,Illinois,1,2000,56321,48.26,67.75,4.28,28111,28210,36330,11494,3591,130,36,48950,7371
17,14000,1714000,Chicago city,Illinois,1,2000,2896016,48.57,73.76,10.32,1405107,1490909,1215315,1065009,125974,10290,1788,2142372,753644
17,14351,1714351,Cicero town,Illinois,1,2000,85616,49.55,65.37,7.09,44007,41609,41327,956,828,759,38,19317,66299
17,23074,1723074,Elgin city,Illinois,1,2000,94487,48.38,70.98,8.56,47213,47274,66600,6427,3668,382,58,62057,32430
17,24582,1724582,Evanston city,Illinois,1,2000,74239,51.60,79.79,10.79,34967,39272,48429,16704,4524,140,64,69700,4539
17,38570,1738570,Joliet city,Illinois,1,2000,106221,47.49,70.55,11.02,52623,53598,73633,19294,1215,301,22,86669,19552
17,51622,1751622,Naperville city,Illinois,1,2000,128358,44.88,68.17,6.23,62831,65527,109346,3887,12380,154,24,124198,4160
17,57225,1757225,Palatine village,Illinois,1,2000,65479,48.21,75.17,8.80,32616,32863,54381,1407,4953,147,27,56232,9247
17,68003,1768003,Schaumburg village,Illinois,1,2000,75386,48.65,78.13,9.49,36694,38692,59391,2526,10697,77,43,71398,3988
17,70122,1770122,Skokie village,Illinois,0,2000,63348,36.68,77.01,19.55,30016,33332,43661,2854,13483,109,16,59728,3620
17,79293,1779293,Waukegan city,Illinois,1,2000,87901,49.79,69.79,7.90,44621,43280,44073,16890,3146,471,57,48505,39396
17,18823,1718823,Decatur city,Illinois,1,2000,81860,40.95,76.02,16.37,38303,43557,63519,15940,540,141,15,80882,978
17,59000,1759000,Peoria city,Illinois,1,2000,112936,43.22,74.31,14.20,53471,59465,78254,27992,2629,229,42,110097,2839
17,65000,1765000,Rockford city,Illinois,1,2000,150115,43.02,73.34,14.06,72384,77731,109303,26072,3301,474,67,134837,15278
17,72000,1772000,Springfield city,Illinois,1,2000,111454,42.63,76.03,14.44,52370,59084,90287,17096,1620,231,34,110117,1337
18,05860,1805860,Bloomington city,Indiana,1,2000,69291,68.90,87.32,7.87,33650,35641,60301,2940,3644,199,49,67569,1722
18,27000,1827000,Gary city,Indiana,1,2000,102746,40.00,70.11,12.79,47088,55658,12245,86340,140,213,24,97681,5065
18,31000,1831000,Hammond city,Indiana,1,2000,83048,44.06,72.66,12.96,40521,42527,60089,12102,383,339,64,65575,17473
18,22000,1822000,Evansville city,Indiana,1,2000,121582,43.80,77.27,16.24,57170,64412,104858,13275,870,257,55,120190,1392
18,25000,1825000,Fort Wayne city,Indiana,1,2000,205727,45.11,72.99,12.45,99659,106068,155231,35752,3205,806,86,193843,11884
18,10342,1810342,Carmel city,Indiana,1,2000,37733,39.55,69.77,9.74,18322,19411,34951,555,1651,52,17,37084,649
18,23278,1823278,Fishers town,Indiana,1,2000,37835,53.35,67.85,3.43,18487,19348,34910,1110,1171,44,7,37071,764
18,36003,1836003,Indianapolis city (balance),Indiana,1,2000,781870,47.07,74.34,10.98,378310,403560,540212,199412,11161,1985,322,751234,30636
18,54180,1854180,Noblesville city,Indiana,0,2000,28590,46.07,70.47,8.49,14042,14548,27545,326,230,58,15,28192,398
18,40788,1840788,Lafayette city,Indiana,1,2000,56397,49.26,76.82,12.01,27868,28529,50143,1816,689,210,24,51261,5136
18,51876,1851876,Muncie city,Indiana,1,2000,67430,51.96,80.20,13.21,31928,35502,57799,7397,534,183,62,66459,971
18,71000,1871000,South Bend city,Indiana,1,2000,107789,43.80,72.72,14.79,51383,56406,71195,26522,1292,440,69,98679,9110
19,73335,1973335,Sioux City city,Iowa,1,2000,85013,43.76,72.92,13.29,41515,43498,72460,2047,2396,1661,33,75756,9257
19,12000,1912000,Cedar Rapids city,Iowa,1,2000,120758,45.24,75.53,13.08,58833,61925,110931,4481,2135,306,78,118693,2065
19,19000,1919000,Davenport city,Iowa,1,2000,98359,45.13,73.80,12.14,47832,50527,82311,9093,1967,368,24,93091,5268
19,02305,1902305,Ankeny city,Iowa,0,2000,27117,49.10,72.86,7.97,13140,13977,26287,206,254,40,7,26824,293
19,21000,1921000,Des Moines city,Iowa,1,2000,198682,46.17,75.17,12.36,96157,102525,163494,16025,6946,705,95,185544,13138
19,83910,1983910,West Des Moines city,Iowa,0,2000,46403,48.81,75.33,9.81,22239,24164,42995,868,1280,61,16,44999,1404
19,38595,1938595,Iowa City city,Iowa,1,2000,62220,63.68,83.84,7.03,30508,31712,54334,2333,3509,191,27,60387,1833
19,82425,1982425,Waterloo city,Iowa,1,2000,68747,42.07,75.32,15.34,32985,35762,56103,9529,587,150,34,66941,1806
19,01855,1901855,Ames city,Iowa,0,2000,50731,66.28,85.39,7.67,26491,24240,44308,1343,3906,75,22,49729,1002
20,36000,2036000,Kansas City city,Kansas,1,2000,146866,44.65,71.44,11.60,71769,75097,81910,44240,2527,1103,56,122227,24639
20,52575,2052575,Olathe city,Kansas,1,2000,92962,50.56,69.15,5.18,46348,46614,82393,3440,2549,402,44,87902,5060
20,53775,2053775,Overland Park city,Kansas,1,2000,149080,43.67,73.83,11.43,72170,76910,135137,3801,5703,401,52,143460,5620
20,64500,2064500,Shawnee city,Kansas,0,2000,47996,46.23,73.21,8.51,23618,24378,43362,1422,1273,149,13,45903,2093
20,38900,2038900,Lawrence city,Kansas,1,2000,80098,62.12,81.43,7.18,39803,40295,67122,4078,3030,2344,56,77177,2921
20,71000,2071000,Topeka city,Kansas,1,2000,122377,42.81,75.73,15.05,58759,63618,96093,14332,1340,1603,50,111530,10847
20,79000,2079000,Wichita city,Kansas,1,2000,344284,45.00,72.88,11.88,169604,174680,258900,39325,13647,3986,198,311172,33112
21,46027,2146027,Lexington-Fayette,Kentucky,1,2000,260512,51.11,78.68,10.05,127905,132607,211120,35116,6407,507,83,251951,8561
21,08902,2108902,Bowling Green city,Kentucky,0,2000,49296,53.78,79.81,11.96,23841,25455,39842,6267,959,111,61,47285,2011
22,05000,2205000,Baton Rouge city,Louisiana,1,2000,227818,48.83,75.55,11.44,108255,119563,104117,113953,5972,405,76,223900,3918
22,40735,2240735,Lafayette city,Louisiana,1,2000,110257,47.31,74.93,11.22,53158,57099,75232,31434,1584,272,26,108186,2071
22,41155,2241155,Lake Charles city,Louisiana,1,2000,71757,43.03,74.49,14.66,34177,37580,36042,33599,770,167,18,70750,1007
22,39475,2239475,Kenner city,Louisiana,1,2000,70517,44.63,72.75,8.95,33876,36641,48038,15900,2002,279,41,60915,9602
22,50115,2250115,Metairie CDP,Louisiana,0,2000,146136,41.76,79.43,16.45,69777,76359,126445,9984,4041,394,34,135541,10595
22,55000,2255000,New Orleans city,Louisiana,1,2000,484674,45.23,73.30,11.69,227094,257580,135956,325947,10972,991,109,469848,14826
22,08920,2208920,Bossier City city,Louisiana,0,2000,56461,45.94,71.78,10.96,27426,29035,40335,12840,976,322,60,54229,2232
22,70000,2270000,Shreveport city,Louisiana,1,2000,200145,42.83,73.09,13.87,93333,106812,93394,101679,1590,619,66,197039,3106
23,60545,2360545,Portland city,Maine,1,2000,64249,50.01,81.21,13.87,30753,33496,58638,1665,1982,302,36,63275,974
24,04000,2404000,Baltimore city,Maryland,1,2000,651154,44.81,75.22,13.20,303687,347467,205982,418951,9985,2097,222,640093,11061
24,19125,2419125,Columbia CDP,Maryland,0,2000,88254,45.12,73.75,7.47,42553,45701,58708,18949,6440,232,46,84618,3636
24,26000,2426000,Ellicott City CDP,Maryland,0,2000,56397,41.45,71.50,9.56,27610,28787,44177,4138,6714,84,9,55188,1209
24,30325,2430325,Frederick city,Maryland,0,2000,52767,48.13,74.87,11.27,25126,27641,40651,7777,1664,154,32,50234,2533
24,31175,2431175,Gaithersburg city,Maryland,0,2000,52613,50.42,74.98,8.25,25647,26966,30625,7680,7241,188,33,42215,10398
24,32025,2432025,Germantown CDP,Maryland,0,2000,55419,54.45,71.12,3.10,26985,28434,34473,10600,5456,187,37,49759,5660
24,32650,2432650,Glen Burnie CDP,Maryland,0,2000,38922,45.12,76.30,12.89,18933,19989,31569,5263,933,135,27,37964,958
24,67675,2467675,Rockville city,Maryland,0,2000,47388,42.95,76.62,13.12,23106,24282,32120,4317,7030,160,15,41859,5529
24,72450,2472450,Silver Spring CDP,Maryland,0,2000,76540,49.47,77.05,9.61,36964,39576,35678,21482,6293,338,48,59536,17004
24,81175,2481175,Waldorf CDP,Maryland,0,2000,22312,48.89,69.44,4.84,10834,11478,13634,7136,578,121,5,21662,650
25,07000,2507000,Boston city,Massachusetts,1,2000,589141,55.15,80.22,10.41,283588,305553,320944,149202,44284,2365,366,504052,85089
25,09000,2509000,Brockton city,Massachusetts,1,2000,94304,44.07,72.16,11.73,45206,49098,57989,16811,2066,338,34,86752,7552
25,11000,2511000,Cambridge city,Massachusetts,1,2000,101355,61.83,86.73,9.16,49674,51681,69022,12079,12036,290,77,93900,7455
25,24960,2524960,Framingham CDP,Massachusetts,0,2000,66910,46.66,78.58,12.99,31942,34968,53373,3409,3527,116,27,59645,7265
25,34550,2534550,Lawrence city,Massachusetts,1,2000,72043,46.21,68.05,9.82,34439,37604,35044,3516,1910,583,71,29024,43019
25,37000,2537000,Lowell city,Massachusetts,1,2000,105167,48.65,73.05,10.76,51807,53360,72145,4423,17371,256,38,90433,14734
25,37490,2537490,Lynn city,Massachusetts,1,2000,89050,44.40,72.99,12.77,43079,45971,60452,9394,5730,332,79,72667,16383
25,45000,2545000,New Bedford city,Massachusetts,1,2000,93768,42.31,75.12,16.69,44173,49595,73950,4112,614,579,44,84192,9576
25,45560,2545560,Newton city,Massachusetts,1,2000,83829,42.25,78.75,15.08,38951,44878,73831,1653,6434,61,29,81718,2111
25,55745,2555745,Quincy city,Massachusetts,1,2000,88025,46.87,82.53,16.30,41944,46081,70066,1947,13546,142,20,86190,1835
25,62535,2562535,Somerville city,Massachusetts,1,2000,77478,60.83,85.16,10.45,37730,39748,59635,5035,4990,171,50,70692,6786
25,82000,2582000,Worcester city,Massachusetts,1,2000,172648,47.35,76.41,14.13,82914,89734,133124,11892,8402,769,96,146493,26155
25,23000,2523000,Fall River city,Massachusetts,1,2000,91938,42.89,75.88,16.94,42953,48985,83815,2283,1987,172,25,88898,3040
25,67000,2567000,Springfield city,Massachusetts,1,2000,152082,44.37,71.05,12.43,71802,80280,85329,31960,2916,569,143,110739,41343
26,03000,2603000,Ann Arbor city,Michigan,1,2000,114024,60.65,83.24,7.91,56352,57672,85151,10070,13566,332,41,110210,3814
26,21000,2621000,Dearborn city,Michigan,1,2000,97775,41.62,72.17,15.58,48639,49136,84931,1248,1441,258,14,94844,2931
26,22000,2622000,Detroit city,Michigan,1,2000,951270,43.67,68.91,10.41,448319,502951,116599,775772,9268,3140,251,904103,47167
26,27440,2627440,Farmington Hills city,Michigan,1,2000,82111,41.94,76.93,14.37,39733,42378,68107,5699,6188,142,15,80900,1211
26,29000,2629000,Flint city,Michigan,1,2000,124943,43.85,69.39,10.47,58704,66239,51710,66560,547,798,19,121201,3742
26,49000,2649000,Livonia city,Michigan,1,2000,100545,39.28,76.17,16.90,48718,51827,95975,951,1951,223,14,98814,1731
26,69035,2669035,Rochester Hills city,Michigan,1,2000,68825,41.24,74.03,10.64,33539,35286,61084,1667,4652,139,20,67249,1576
26,74900,2674900,Southfield city,Michigan,1,2000,78296,42.31,78.45,15.18,35955,42341,30406,42454,2416,157,24,77362,934
26,76460,2676460,Sterling Heights city,Michigan,1,2000,124471,43.08,75.93,11.76,60970,63501,112899,1614,6123,260,45,122806,1665
26,80700,2680700,Troy city,Michigan,1,2000,80959,41.30,73.79,10.23,40081,40878,66627,1694,10730,125,18,79775,1184
26,84000,2684000,Warren city,Michigan,1,2000,138247,42.01,77.05,17.27,67560,70687,126205,3697,4275,494,30,136379,1868
26,86000,2686000,Westland city,Michigan,1,2000,86602,46.32,76.72,13.23,41626,44976,75527,5867,2437,396,28,84464,2138
26,34000,2634000,Grand Rapids city,Michigan,1,2000,197800,48.71,72.96,11.61,96761,101039,133116,40373,3195,1454,238,171982,25818
26,88940,2688940,Wyoming city,Michigan,1,2000,69368,49.13,72.01,9.38,34244,35124,58491,3362,2025,406,27,62664,6704
26,42160,2642160,Kalamazoo city,Michigan,1,2000,77145,57.26,79.71,10.11,37198,39947,54593,15924,1847,445,50,73841,3304
26,46000,2646000,Lansing city,Michigan,1,2000,119128,48.10,73.23,9.74,57186,61942,77766,26095,3367,953,62,107242,11886
27,56896,2756896,St. Cloud city,Minnesota,0,2000,59107,55.48,79.23,10.26,29816,29291,54229,1402,1839,425,37,58323,784
27,17000,2717000,Duluth city,Minnesota,1,2000,86918,46.18,78.69,15.13,41973,44945,80532,1415,993,2122,25,85997,921
27,06382,2706382,Blaine city,Minnesota,0,2000,44942,48.61,70.87,5.31,22494,22448,42002,387,1142,281,10,44169,773
27,06616,2706616,Bloomington city,Minnesota,1,2000,85172,41.11,79.38,15.68,41132,44040,75055,2917,4339,296,29,82882,2290
27,07966,2707966,Brooklyn Park city,Minnesota,1,2000,67388,49.33,71.17,5.62,33473,33915,48145,9659,6214,381,44,65444,1944
27,17288,2717288,Eagan city,Minnesota,0,2000,63557,49.96,70.02,4.21,31278,32279,55949,2166,3372,164,66,62133,1424
27,35180,2735180,Lakeville city,Minnesota,0,2000,43128,48.64,63.92,2.84,21835,21293,40654,553,868,165,10,42293,835
27,40166,2740166,Maple Grove city,Minnesota,0,2000,50365,46.97,69.25,4.05,24934,25431,47717,528,1267,119,16,49831,534
27,43000,2743000,Minneapolis city,Minnesota,1,2000,382618,54.28,78.00,9.12,192232,190386,249186,68818,23455,8378,289,353443,29175
27,51730,2751730,Plymouth city,Minnesota,1,2000,65894,44.80,72.89,7.57,32454,33440,60200,1783,2495,217,9,64815,1079
27,58000,2758000,St. Paul city,Minnesota,1,2000,287151,48.82,72.90,10.32,138863,148288,192444,33637,35488,3259,203,264436,22715
27,71428,2771428,Woodbury city,Minnesota,0,2000,46463,47.04,69.40,6.08,22523,23940,41836,1168,2329,113,6,45467,996
27,54880,2754880,Rochester city,Minnesota,1,2000,85806,46.65,74.23,11.48,41720,44086,75088,3064,4830,258,33,83241,2565
28,29700,2829700,Gulfport city,Mississippi,1,2000,71127,45.97,73.98,11.40,35244,35883,44229,23848,891,305,65,69313,1814
28,36000,2836000,Jackson city,Mississippi,1,2000,184256,46.20,71.48,10.89,85656,98600,51208,130151,1056,236,24,182805,1451
29,15670,2915670,Columbia city,Missouri,1,2000,84531,58.44,80.27,8.61,40453,44078,68923,9173,3636,331,30,82798,1733
29,35000,2935000,Independence city,Missouri,1,2000,113288,41.53,76.12,15.53,54173,59115,104081,2939,788,721,523,109113,4175
29,38000,2938000,Kansas City city,Missouri,1,2000,441545,46.28,74.64,11.71,213141,228404,267931,137879,8182,2122,493,410941,30604
29,41348,2941348,Lee's Summit city,Missouri,1,2000,70700,44.29,70.84,10.22,33849,36851,65874,2454,698,257,44,69306,1394
29,64550,2964550,St. Joseph city,Missouri,1,2000,73990,44.22,75.87,15.38,36170,37820,67981,3722,351,340,19,72061,1929
29,54074,2954074,O'Fallon city,Missouri,1,2000,46169,49.46,66.62,6.18,22772,23397,44006,1033,342,108,13,45498,671
29,64082,2964082,St. Charles city,Missouri,0,2000,60321,46.57,76.63,12.19,29592,30729,56270,2097,612,160,22,59134,1187
29,65000,2965000,St. Louis city,Missouri,1,2000,348189,45.61,74.25,13.74,163567,184622,152666,178266,6891,950,94,341167,7022
29,70000,2970000,Springfield city,Missouri,1,2000,151580,48.61,80.10,14.90,73016,78564,138987,4961,2060,1142,136,148079,3501
30,06550,3006550,Billings city,Montana,1,2000,89847,42.88,75.97,14.85,43214,46633,82539,495,533,3088,38,86089,3758
30,50200,3050200,Missoula city,Montana,1,2000,57053,53.64,80.27,10.38,28352,28701,53387,207,703,1341,57,56049,1004
31,28000,3128000,Lincoln city,Nebraska,1,2000,225581,50.93,76.99,10.42,112361,113220,201322,6960,7048,1537,141,217427,8154
31,37000,3137000,Omaha city,Nebraska,1,2000,390007,46.09,74.37,11.80,190032,199975,305745,51917,6773,2616,228,360610,29397
32,23770,3223770,Enterprise CDP,Nevada,0,2000,14676,42.96,79.54,11.36,7506,7170,12078,464,762,118,80,12910,1766
32,31900,3231900,Henderson city,Nevada,1,2000,175381,44.29,74.90,10.14,87001,88380,148181,6590,6983,1236,728,156596,18785
32,40000,3240000,Las Vegas city,Nevada,1,2000,478434,44.51,74.07,11.56,243077,235357,334230,49570,22879,3570,2145,365472,112962
32,51800,3251800,North Las Vegas city,Nevada,1,2000,115488,48.20,66.07,5.78,58947,56541,64591,21970,3740,943,610,72053,43435
32,54600,3254600,Paradise CDP,Nevada,0,2000,186070,47.17,78.84,11.08,97081,88989,134927,12260,12135,1424,1097,142407,43663
32,68585,3268585,Spring Valley CDP,Nevada,0,2000,117390,46.43,78.83,10.73,58567,58823,85224,6214,13164,701,567,101225,16165
32,71400,3271400,Sunrise Manor CDP,Nevada,0,2000,156120,45.32,70.27,9.23,77838,78282,102212,20117,8445,1529,713,115501,40619
32,60600,3260600,Reno city,Nevada,1,2000,180480,46.73,76.82,11.42,92254,88226,139793,4651,9555,2271,1004,145864,34616
32,68400,3268400,Sparks city,Nevada,1,2000,66346,44.91,73.11,10.23,32784,33562,52001,1591,3308,780,330,53278,13068
33,45140,3345140,Manchester city,New Hampshire,1,2000,107006,46.59,76.30,12.92,52394,54612,98178,2246,2487,326,38,102062,4944
33,50260,3350260,Nashua city,New Hampshire,1,2000,86605,45.33,75.34,11.60,42775,43830,77291,1740,3363,275,29,81217,5388
34,03580,3403580,Bayonne city,New Jersey,0,2000,61842,42.65,77.89,16.55,29269,32573,48631,3416,2562,106,30,50827,11015
34,13690,3413690,Clifton city,New Jersey,1,2000,78672,41.84,78.43,17.58,37560,41112,59960,2277,5066,192,27,63064,15608
34,19390,3419390,East Orange city,New Jersey,0,2000,69824,44.22,71.88,11.24,31429,38395,2683,62462,302,177,51,66540,3284
34,21000,3421000,Elizabeth city,New Jersey,1,2000,120568,48.32,73.72,9.99,59674,60894,67250,24090,2830,580,55,60941,59627
34,36000,3436000,Jersey City city,New Jersey,1,2000,240055,49.56,75.25,9.76,117144,122911,81637,67994,38881,1071,181,172103,67952
34,51000,3451000,Newark city,New Jersey,1,2000,273546,48.45,72.06,9.25,132701,140845,72537,146250,3263,1005,135,192924,80622
34,56550,3456550,Passaic city,New Jersey,1,2000,67861,48.53,69.20,8.12,33852,34009,24044,9385,3740,531,29,25474,42387
34,57000,3457000,Paterson city,New Jersey,1,2000,149222,47.66,70.22,8.31,72473,76749,45913,49095,2831,901,84,74448,74774
34,73110,3473110,Toms River CDP,New Jersey,0,2000,86327,39.13,76.22,16.64,41539,44788,80598,1565,2194,110,21,82317,4010
34,74000,3474000,Trenton city,New Jersey,1,2000,85403,46.01,72.31,11.38,42180,43223,27802,44465,716,300,199,67012,18391
34,74630,3474630,Union City city,New Jersey,1,2000,67088,49.41,74.70,9.98,33639,33449,39167,2442,1441,467,54,11862,55226
34,08920,3408920,Burlington city,New Jersey,1,2000,9736,41.33,76.09,16.80,4618,5118,6638,2592,125,26,1,9404,332
34,10000,3410000,Camden city,New Jersey,1,2000,79904,46.77,65.37,7.62,38784,41120,13454,42628,1958,435,59,48885,31019
34,13360,3413360,Clayton borough,New Jersey,1,2000,7139,44.82,70.89,9.64,3415,3724,5656,1146,47,30,2,6905,234
34,20350,3420350,Egg Harbor City city,New Jersey,1,2000,4545,42.90,71.75,13.93,2197,2348,3036,645,57,17,4,3429,1116
34,26340,3426340,Glassboro borough,New Jersey,1,2000,19068,54.84,77.93,9.79,9126,9942,14212,3712,441,32,17,18340,728
34,29430,3429430,Hammonton town,New Jersey,1,2000,12604,40.72,77.20,17.97,6105,6499,11073,219,144,18,3,10728,1876
34,39420,3439420,Lawnside borough,New Jersey,1,2000,2692,34.99,76.71,18.83,1224,1468,47,2520,14,27,2,2628,64
34,46680,3446680,Millville city,New Jersey,1,2000,26847,41.98,72.07,12.89,12678,14169,20438,4025,216,139,8,23849,2998
34,57750,3457750,Penns Grove borough,New Jersey,1,2000,4886,42.16,67.03,11.79,2252,2634,2387,1942,14,18,8,4041,845
34,59640,3459640,Pleasantville city,New Jersey,1,2000,19012,43.78,69.61,11.17,8925,10087,4755,10969,371,54,5,14854,4158
34,65490,3465490,Salem city,New Jersey,1,2000,5857,38.98,69.05,14.02,2615,3242,2194,3325,14,35,0,5571,286
35,02000,3502000,Albuquerque city,New Mexico,1,2000,448607,45.67,75.46,11.96,217887,230720,321179,13854,10068,17444,452,269532,179075
35,63460,3563460,Rio Rancho city,New Mexico,1,2000,51765,43.92,70.82,11.70,25106,26659,40563,1376,758,1226,89,37436,14329
35,39380,3539380,Las Cruces city,New Mexico,1,2000,74267,47.09,74.89,13.09,36036,38231,51248,1738,863,1289,55,35846,38421
35,70500,3570500,Santa Fe city,New Mexico,1,2000,62203,41.55,79.72,13.90,29758,32445,47459,409,791,1373,49,32459,29744
36,01000,3601000,Albany city,New York,1,2000,95658,51.66,80.05,13.36,45467,50191,60383,26915,3116,301,34,90309,5349
36,65508,3665508,Schenectady city,New York,1,2000,61821,44.85,75.67,15.23,29539,32282,47460,9132,1239,222,24,58189,3632
36,11000,3611000,Buffalo city,New York,1,2000,292648,44.72,73.70,13.44,137443,155205,159300,108951,4093,2250,120,270572,22076
36,15000,3615000,Cheektowaga CDP,New York,0,2000,79988,39.25,79.41,20.61,37430,42558,75487,2683,829,135,6,79195,793
36,08026,3608026,Brentwood CDP,New York,0,2000,53917,48.05,70.12,8.25,26979,26938,25736,9735,1084,310,61,24666,29251
36,49121,3649121,Mount Vernon city,New York,1,2000,68381,43.30,74.67,12.93,30861,37520,19577,40743,1448,219,43,61298,7083
36,50617,3650617,New Rochelle city,New York,1,2000,72182,41.94,75.96,15.50,34322,37860,49001,13848,2334,141,35,57690,14492
36,51000,3651000,New York city,New York,1,2000,8008278,46.72,75.77,11.71,3794204,4214074,3576385,2129762,787047,41289,5430,5847724,2160554
36,84000,3684000,Yonkers city,New York,1,2000,196086,43.13,75.67,14.98,92132,103954,118007,32575,9526,861,98,145234,50852
36,63000,3663000,Rochester city,New York,1,2000,219773,47.70,71.91,10.00,105083,114690,106161,84717,4943,1033,104,191741,28032
36,73000,3673000,Syracuse city,New York,1,2000,147306,48.45,75.03,12.86,69308,77998,94663,37336,4961,1670,72,139538,7768
37,02140,3702140,Asheville city,North Carolina,1,2000,68889,42.28,80.41,18.29,32207,36682,53701,12129,635,240,39,66300,2589
37,12000,3712000,Charlotte city,North Carolina,1,2000,540828,50.22,75.29,8.81,264978,275850,315061,176964,18418,1863,283,501028,39800
37,14100,3714100,Concord city,North Carolina,1,2000,55977,46.30,73.79,11.10,27345,28632,44128,8450,684,168,14,51608,4369
37,25580,3725580,Gastonia city,North Carolina,1,2000,66277,43.04,75.04,13.79,31325,34952,46513,16981,773,137,19,62664,3613
37,22920,3722920,Fayetteville city,North Carolina,1,2000,121015,47.90,74.60,10.96,57967,63048,59007,51338,2653,1331,264,114153,6862
37,28000,3728000,Greensboro city,North Carolina,1,2000,223891,49.01,77.71,11.87,105573,118318,124243,83728,6357,989,89,214149,9742
37,31400,3731400,High Point city,North Carolina,1,2000,85839,44.80,74.00,11.87,41022,44817,51985,27275,2872,392,17,81642,4197
37,75000,3775000,Winston-Salem city,North Carolina,1,2000,185776,45.62,76.66,13.67,87345,98431,103243,68924,2108,567,67,169733,16043
37,28080,3728080,Greenville city,North Carolina,1,2000,60476,59.82,81.19,8.78,27997,32479,37133,20649,1098,181,26,59232,1244
37,34200,3734200,Jacksonville city,North Carolina,1,2000,66715,65.00,75.72,4.77,40678,26037,42655,15987,1380,503,126,60013,6702
37,10740,3710740,Cary town,North Carolina,1,2000,94536,49.34,70.94,5.36,47075,47461,77683,5813,7643,251,28,90489,4047
37,19000,3719000,Durham city,North Carolina,1,2000,187035,52.91,77.07,9.31,89884,97151,85126,81937,6815,575,71,171023,16012
37,55000,3755000,Raleigh city,North Carolina,1,2000,276093,55.51,79.14,8.33,136648,139445,174786,76756,9327,981,118,256785,19308
37,74440,3774440,Wilmington city,North Carolina,1,2000,75838,48.47,81.62,15.34,35397,40441,53516,19579,682,266,67,73847,1991
38,07200,3807200,Bismarck city,North Dakota,0,2000,55532,44.78,76.46,13.76,26891,28641,52634,156,251,1884,15,55117,415
38,25700,3825700,Fargo city,North Dakota,1,2000,90599,53.74,78.88,10.07,45306,45293,85321,922,1482,1119,40,89432,1167
39,12000,3912000,Canton city,Ohio,1,2000,80806,42.93,73.40,14.30,37700,43106,60164,16999,257,396,24,79800,1006
39,15000,3915000,Cincinnati city,Ohio,1,2000,331285,48.29,75.51,12.27,156357,174928,175492,142176,5132,709,130,327055,4230
39,01000,3901000,Akron city,Ohio,1,2000,217074,44.61,74.68,13.51,103670,113404,145924,61827,3257,575,48,214561,2513
39,16000,3916000,Cleveland city,Ohio,1,2000,478403,43.94,71.49,12.54,226550,251853,198510,243939,6444,1458,178,443675,34728
39,44856,3944856,Lorain city,Ohio,0,2000,68652,41.53,71.66,13.96,32549,36103,47848,10943,227,304,24,54214,14438
39,61000,3961000,Parma city,Ohio,1,2000,85655,40.39,77.72,19.61,40846,44809,81948,905,1349,118,17,84332,1323
39,18000,3918000,Columbus city,Ohio,1,2000,711470,52.48,75.84,8.86,345878,365592,483332,174065,24495,2090,367,693999,17471
39,21000,3921000,Dayton city,Ohio,1,2000,166179,47.17,74.89,12.01,80142,86037,88676,71668,1075,500,63,163553,2626
39,77000,3977000,Toledo city,Ohio,1,2000,313619,44.87,73.81,13.14,150204,163415,220261,73854,3233,970,76,296478,17141
39,88000,3988000,Youngstown city,Ohio,1,2000,82026,40.45,74.20,17.43,39278,42748,41737,35937,267,246,29,77744,4282
40,41850,4041850,Lawton city,Oklahoma,1,2000,92757,50.92,72.17,9.28,48335,44422,56897,21388,2285,3534,407,84038,8719
40,23200,4023200,Edmond city,Oklahoma,1,2000,68315,45.81,72.50,8.80,33046,35269,59144,2760,2225,1554,53,66434,1881
40,52500,4052500,Norman city,Oklahoma,1,2000,95694,54.34,78.76,8.98,48085,47609,78812,4080,3342,4262,48,91971,3723
40,55000,4055000,Oklahoma City city,Oklahoma,1,2000,506132,45.84,74.46,11.48,247313,258819,346226,77810,17595,17743,360,454764,51368
40,09050,4009050,Broken Arrow city,Oklahoma,1,2000,74859,45.29,69.16,7.51,36498,38361,63886,2793,1425,3007,39,72195,2664
40,75000,4075000,Tulsa city,Oklahoma,1,2000,393049,44.79,75.23,12.85,189937,203112,275488,60794,7150,18551,202,364938,28111
41,23850,4123850,Eugene city,Oregon,1,2000,137893,49.47,79.66,12.08,67540,70353,121546,1729,4916,1281,294,131050,6843
41,47000,4147000,Medford city,Oregon,1,2000,63154,40.16,74.19,16.52,30262,32892,56834,313,720,677,163,57313,5841
41,05350,4105350,Beaverton city,Oregon,1,2000,76129,49.52,75.05,8.98,37582,38547,59615,1324,7349,507,272,67666,8463
41,31250,4131250,Gresham city,Oregon,1,2000,90205,45.94,72.45,9.80,44593,45612,74619,1707,3007,848,243,79473,10732
41,34100,4134100,Hillsboro city,Oregon,1,2000,70186,52.59,71.66,6.27,36047,34139,54391,858,4585,577,177,56924,13262
41,59000,4159000,Portland city,Oregon,1,2000,529121,48.40,78.94,11.56,261565,267556,412241,35115,33470,5587,1993,493063,36058
41,64900,4164900,Salem city,Oregon,1,2000,136924,45.73,74.57,12.44,68752,68172,113746,1750,3304,2064,643,116951,19973
41,05800,4105800,Bend city,Oregon,1,2000,52029,45.39,75.54,12.36,25633,26396,48897,145,521,412,42,49633,2396
42,02000,4202000,Allentown city,Pennsylvania,1,2000,106632,44.52,75.25,15.14,51037,55595,77361,8370,2421,356,78,80574,26058
42,06088,4206088,Bethlehem city,Pennsylvania,1,2000,71329,44.59,79.04,17.92,34091,37238,58382,2596,1585,183,24,58327,13002
42,24000,4224000,Erie city,Pennsylvania,1,2000,103717,43.97,74.60,15.36,49355,54362,83550,14724,776,232,42,99145,4572
42,60000,4260000,Philadelphia city,Pennsylvania,1,2000,1517550,44.35,74.73,14.08,705107,812443,683267,655824,67654,4073,729,1388622,128928
42,61000,4261000,Pittsburgh city,Pennsylvania,1,2000,334563,46.68,80.12,16.45,159119,175444,226258,90750,9195,628,111,330138,4425
42,63624,4263624,Reading city,Pennsylvania,1,2000,81207,44.94,70.08,12.40,39205,42002,48059,9947,1296,356,32,50905,30302
42,69000,4269000,Scranton city,Pennsylvania,1,2000,76415,41.54,79.22,20.10,35543,40872,71480,2304,823,85,15,74416,1999
44,19180,4419180,Cranston city,Rhode Island,1,2000,79269,42.90,78.43,17.30,38800,40469,70703,2926,2599,236,33,75656,3613
44,54640,4454640,Pawtucket city,Rhode Island,1,2000,72958,44.21,75.12,14.84,34600,38358,55004,5334,621,217,42,62817,10141
44,59000,4459000,Providence city,Rhode Island,1,2000,173618,51.53,73.92,10.46,83035,90583,94666,25243,10432,1975,270,121472,52146
44,74300,4474300,Warwick city,Rhode Island,1,2000,85808,40.59,78.11,16.97,40835,44973,81695,996,1281,213,15,84436,1372
45,13330,4513330,Charleston city,South Carolina,1,2000,96650,49.35,80.01,13.48,45758,50892,60964,32864,1197,145,55,95188,1462
45,48535,4548535,Mount Pleasant town,South Carolina,1,2000,47609,45.45,74.92,10.29,22811,24798,42928,3453,562,80,10,46974,635
45,50875,4550875,North Charleston city,South Carolina,1,2000,79641,49.55,72.13,9.05,39435,40206,35651,39348,1263,349,75,76478,3163
45,61405,4561405,Rock Hill city,South Carolina,1,2000,49765,49.23,74.94,11.27,22790,26975,29230,18578,690,248,13,48529,1236
45,16000,4516000,Columbia city,South Carolina,1,2000,116278,56.60,79.90,10.30,56999,59279,57236,53465,2008,296,104,112758,3520
45,30850,4530850,Greenville city,South Carolina,0,2000,56002,48.33,80.04,14.43,26506,29496,34788,19008,709,77,35,54075,1927
46,52980,4652980,Rapid City city,South Dakota,1,2000,59607,44.94,74.73,13.23,29224,30383,50266,579,594,6046,35,57957,1650
46,59020,4659020,Sioux Falls city,South Dakota,1,2000,123975,48.22,74.80,11.08,61120,62855,113938,2226,1479,2627,68,120888,3087
47,14000,4714000,Chattanooga city,Tennessee,1,2000,155554,43.16,77.59,15.23,73370,82184,92874,56086,2396,446,164,152273,3281
47,15160,4715160,Clarksville city,Tennessee,1,2000,103455,52.37,71.19,7.26,51950,51505,70254,24030,2233,560,262,97214,6241
47,37640,4737640,Jackson city,Tennessee,0,2000,59643,45.43,74.13,13.16,27822,31821,32883,25091,470,92,6,58354,1289
47,38320,4738320,Johnson City city,Tennessee,0,2000,55469,45.15,80.17,15.86,26448,29021,49973,3549,678,143,12,54421,1048
47,40000,4740000,Knoxville city,Tennessee,1,2000,173890,49.36,80.33,14.37,82390,91500,138611,28171,2525,541,60,171139,2751
47,48000,4748000,Memphis city,Tennessee,1,2000,650100,45.85,72.11,10.93,307643,342457,223728,399208,9482,1217,239,630783,19317
47,27740,4727740,Franklin city,Tennessee,0,2000,41842,49.48,72.13,7.39,20224,21618,35368,4330,674,99,19,39817,2025
47,51560,4751560,Murfreesboro city,Tennessee,1,2000,68816,54.81,77.31,8.80,34184,34632,54947,9560,1853,192,18,66386,2430
47,52006,4752006,Nashville-Davidson (balance),Tennessee,1,2000,545524,49.57,77.88,10.98,264095,281429,359581,146235,12992,1639,400,519750,25774
48,01000,4801000,Abilene city,Texas,1,2000,115930,48.80,74.36,12.01,58529,57401,90502,10215,1543,642,81,93382,22548
48,17000,4817000,Corpus Christi city,Texas,1,2000,277454,44.65,71.86,11.10,135572,141882,198714,12969,3551,1766,212,126717,150737
48,48072,4848072,Midland city,Texas,1,2000,94996,42.54,70.10,12.31,45575,49421,71735,7948,956,602,29,67453,27543
48,03000,4803000,Amarillo city,Texas,1,2000,173627,43.52,72.11,12.61,83370,90257,134563,10358,3563,1346,64,135680,37947
48,05000,4805000,Austin city,Texas,1,2000,656562,57.16,77.53,6.69,337569,318993,429100,65956,30960,3889,469,455983,200579
48,13552,4813552,Cedar Park city,Texas,0,2000,26049,50.67,66.48,4.29,12859,13190,22510,865,679,88,15,22533,3516
48,29336,4829336,Georgetown city,Texas,0,2000,28339,41.71,76.56,17.65,13807,14532,24200,960,190,100,15,23218,5121
48,63500,4863500,Round Rock city,Texas,1,2000,61136,51.83,68.05,4.46,30425,30711,46927,4718,1767,305,59,47625,13511
48,07000,4807000,Beaumont city,Texas,1,2000,113866,43.16,72.90,13.37,54142,59724,52826,52206,2827,269,46,104838,9028
48,10768,4810768,Brownsville city,Texas,1,2000,139722,44.27,65.36,9.51,65783,73939,114083,575,752,580,46,12187,127535
48,32372,4832372,Harlingen city,Texas,0,2000,57564,41.16,69.25,15.05,27402,30162,45290,528,506,301,16,15683,41881
48,10912,4810912,Bryan city,Texas,1,2000,65660,52.67,73.00,9.32,32701,32959,42452,11635,1084,265,52,47389,18271
48,15976,4815976,College Station city,Texas,1,2000,67890,74.88,85.58,3.62,34667,33223,54673,3698,4951,206,44,61131,6759
48,01924,4801924,Allen city,Texas,1,2000,43554,50.92,65.08,2.82,21743,21811,37953,1915,1625,228,20,40516,3038
48,04000,4804000,Arlington city,Texas,1,2000,332969,50.96,71.71,6.14,166465,166504,225379,45727,20015,1817,475,272152,60817
48,13024,4813024,Carrollton city,Texas,1,2000,109576,49.40,71.74,5.21,54275,55301,78758,6862,11944,503,75,88176,21400
48,19000,4819000,Dallas city,Texas,1,2000,1188580,51.15,73.45,8.61,598991,589589,604209,307957,32118,6472,590,765993,422587
48,19972,4819972,Denton city,Texas,1,2000,80537,59.27,79.33,7.90,39594,40943,60900,7344,2731,464,43,67349,13188
48,26232,4826232,Flower Mound town,Texas,0,2000,50702,48.44,65.16,2.66,25243,25459,45753,1482,1547,178,27,47847,2855
48,27000,4827000,Fort Worth city,Texas,1,2000,534694,48.30,71.75,9.62,263720,270974,319159,108310,14105,3144,341,375326,159368
48,27684,4827684,Frisco city,Texas,1,2000,33714,54.09,69.25,3.61,16700,17014,29417,1268,791,128,10,29998,3716
48,29000,4829000,Garland city,Texas,1,2000,215768,47.45,70.18,7.10,106937,108831,140835,25609,15806,1284,141,160576,55192
48,30464,4830464,Grand Prairie city,Texas,1,2000,127427,48.88,69.46,6.35,63058,64369,78970,17242,5632,982,74,85389,42038
48,37000,4837000,Irving city,Texas,1,2000,191615,55.02,74.84,6.10,97687,93928,123019,19583,15784,1244,248,131777,59838
48,42508,4842508,Lewisville city,Texas,1,2000,77737,56.63,73.41,4.26,38855,38882,60015,5747,3028,544,25,63938,13799
48,45744,4845744,McKinney city,Texas,1,2000,54369,49.86,69.05,6.77,27501,26868,42628,3913,811,293,35,44493,9876
48,46452,4846452,Mansfield city,Texas,0,2000,28031,47.41,68.20,5.72,14205,13826,24221,1232,346,159,5,24457,3574
48,47892,4847892,Mesquite city,Texas,1,2000,124523,48.20,69.50,7.14,59987,64536,91572,16585,4665,750,65,105023,19500
48,52356,4852356,North Richland Hills city,Texas,0,2000,55635,46.22,72.77,8.85,27364,28271,49224,1501,1475,303,93,50359,5276
48,58016,4858016,Plano city,Texas,1,2000,222030,47.78,71.29,4.91,110619,111411,173761,11155,22594,803,98,199673,22357
48,61796,4861796,Richardson city,Texas,1,2000,91802,45.49,75.21,9.97,45347,46455,69209,5675,10709,409,58,82382,9420
48,63572,4863572,Rowlett city,Texas,0,2000,44503,47.55,66.53,5.20,21998,22505,36406,4010,1481,220,25,40604,3899
48,24000,4824000,El Paso city,Texas,1,2000,563662,44.30,68.96,10.67,267651,296011,413061,17586,6321,4601,583,131787,431875
48,04462,4804462,Atascocita CDP,Texas,0,2000,35757,49.62,70.03,3.75,18877,16880,27876,4648,874,114,15,31460,4297
48,06128,4806128,Baytown city,Texas,1,2000,66430,45.34,70.01,9.98,32250,34180,45088,8888,651,337,51,43682,22748
48,16432,4816432,Conroe city,Texas,0,2000,36811,49.56,71.89,9.67,18517,18294,26193,4097,348,149,18,24805,12006
48,35000,4835000,Houston city,Texas,1,2000,1953631,49.17,72.53,8.40,975551,978080,962610,494496,103694,8568,1182,1222766,730865
48,41980,4841980,League City city,Texas,1,2000,45444,47.17,70.56,5.90,22610,22834,38170,2311,1439,168,24,39314,6130
48,48804,4848804,Missouri City city,Texas,1,2000,52913,43.89,69.18,5.40,25633,27280,23435,20290,5610,107,21,47158,5755
48,56000,4856000,Pasadena city,Texas,1,2000,141674,47.51,68.43,7.91,70767,70907,101219,2316,2589,957,58,73326,68348
48,56348,4856348,Pearland city,Texas,1,2000,37640,46.43,71.16,8.39,18468,19172,31100,2006,1373,157,14,31533,6107
48,70808,4870808,Sugar Land city,Texas,1,2000,63328,41.32,68.83,6.72,30983,32345,41798,3294,15072,149,18,58275,5053
48,72656,4872656,The Woodlands CDP,Texas,0,2000,55649,40.87,68.18,7.56,26796,28853,51399,973,1556,160,30,51952,3697
48,39148,4839148,Killeen city,Texas,1,2000,86911,55.92,70.12,4.86,43603,43308,39788,29109,3759,680,787,71442,15469
48,72176,4872176,Temple city,Texas,0,2000,54514,42.02,73.74,15.84,26082,28432,38030,8988,833,280,50,44798,9716
48,41464,4841464,Laredo city,Texas,1,2000,176576,46.30,64.51,7.81,84704,91872,145267,652,820,784,47,10360,166216
48,43888,4843888,Longview city,Texas,1,2000,73344,44.07,73.27,13.31,35347,37997,51417,16214,609,369,16,65780,7564
48,45000,4845000,Lubbock city,Texas,1,2000,199564,49.73,75.10,11.14,97023,102541,145426,17292,3078,1118,65,144778,54786
48,22660,4822660,Edinburg city,Texas,1,2000,48465,48.22,66.98,8.21,23655,24810,35533,281,315,230,19,5484,42981
48,45384,4845384,McAllen city,Texas,1,2000,106414,45.01,69.24,10.43,50438,55976,83491,647,2059,429,41,20987,85427
48,48768,4848768,Mission city,Texas,1,2000,45408,41.61,67.89,14.21,21642,23766,35249,168,288,174,3,8614,36794
48,57200,4857200,Pharr city,Texas,1,2000,46660,42.66,65.24,11.89,22218,24442,37075,110,109,335,13,4378,42282
48,53388,4853388,Odessa city,Texas,1,2000,90943,43.76,70.17,11.76,43864,47079,66781,5347,797,702,37,53272,37671
48,64472,4864472,San Angelo city,Texas,1,2000,88439,45.36,74.16,13.81,42395,46044,68183,4185,844,579,70,59118,29321
48,50820,4850820,New Braunfels city,Texas,0,2000,36494,41.08,74.33,16.87,17472,19022,30763,501,211,201,11,23895,12599
48,65000,4865000,San Antonio city,Texas,1,2000,1144646,46.24,71.46,10.43,553245,591401,774708,78120,17934,9584,1067,473252,671394
48,74144,4874144,Tyler city,Texas,1,2000,83650,43.12,73.89,15.23,39184,44466,51795,22275,806,287,32,70416,13234
48,75428,4875428,Victoria city,Texas,0,2000,60603,42.65,71.22,12.60,29140,31463,43140,4599,612,312,24,34591,26012
48,76000,4876000,Waco city,Texas,1,2000,113726,49.29,74.62,13.41,54295,59431,69119,25754,1567,576,61,86841,26885
48,79000,4879000,Wichita Falls city,Texas,1,2000,104197,48.53,75.34,12.29,53657,50540,78258,12920,2288,897,103,89627,14570
49,44320,4944320,Lehi city,Utah,0,2000,19028,47.59,59.00,5.17,9531,9497,18206,47,89,110,82,18459,569
49,57300,4957300,Orem city,Utah,1,2000,84324,49.45,64.62,6.95,41879,42445,76567,280,1226,615,721,77107,7217
49,62470,4962470,Provo city,Utah,1,2000,105166,66.77,77.74,5.72,50572,54594,93094,486,1924,846,882,94153,11013
49,43660,4943660,Layton city,Utah,1,2000,58474,48.37,64.92,5.70,29487,28987,52573,943,1216,307,159,54406,4068
49,55980,4955980,Ogden city,Utah,1,2000,77226,47.84,71.24,11.30,39050,38176,61016,1785,1105,927,133,58973,18253
49,67000,4967000,Salt Lake City city,Utah,1,2000,181743,52.25,76.36,10.96,92045,89698,143933,3433,6579,2442,3437,147489,34254
49,67440,4967440,Sandy city,Utah,1,2000,88418,45.45,65.55,5.24,44405,44013,82685,445,1916,311,275,84543,3875
49,70850,4970850,South Jordan city,Utah,0,2000,29437,45.77,60.77,4.71,14765,14672,28115,88,298,30,140,28475,962
49,82950,4982950,West Jordan city,Utah,1,2000,68336,50.29,62.19,3.17,34309,34027,60653,434,1393,385,644,61454,6882
49,83470,4983470,West Valley City city,Utah,1,2000,108896,48.85,66.35,5.38,55078,53818,85172,1247,4671,1273,3157,88770,20126
49,65330,4965330,St. George city,Utah,1,2000,49663,40.53,71.63,19.26,24134,25529,45823,120,282,812,293,46326,3337
50,10675,5010675,Burlington city,Vermont,1,2000,38889,59.08,83.72,10.52,18764,20125,35883,693,1031,182,8,38343,546
51,47672,5147672,Lynchburg city,Virginia,1,2000,65269,44.34,77.85,16.31,29841,35428,43487,19382,838,169,28,64391,878
51,16000,5116000,Chesapeake city,Virginia,1,2000,199184,45.45,71.24,8.96,96728,102456,133193,56823,3673,770,101,195108,4076
51,35000,5135000,Hampton city,Virginia,1,2000,146437,49.03,75.76,10.34,72579,73858,72556,65428,2694,616,136,142284,4153
51,56000,5156000,Newport News city,Virginia,1,2000,180150,47.74,72.51,10.08,87178,92972,96383,70388,4195,752,214,172555,7595
51,57000,5157000,Norfolk city,Virginia,1,2000,234403,51.66,75.96,10.89,119830,114573,113358,103387,6593,1071,251,225488,8915
51,64000,5164000,Portsmouth city,Virginia,1,2000,100565,44.38,74.29,13.78,48583,51982,46096,50899,775,478,67,98817,1748
51,76432,5176432,Suffolk city,Virginia,1,2000,63677,42.63,72.15,11.41,30410,33267,34271,27718,491,191,15,62868,809
51,82000,5182000,Virginia Beach city,Virginia,1,2000,425257,48.74,72.51,8.45,210524,214733,303681,80593,20869,1619,416,407487,17770
51,67000,5167000,Richmond city,Virginia,1,2000,197790,48.01,78.17,13.21,92068,105722,75744,113108,2471,479,157,192716,5074
51,68000,5168000,Roanoke city,Virginia,1,2000,94911,41.90,77.39,16.39,44501,50410,65848,25380,1096,190,23,93506,1405
51,01000,5101000,Alexandria city,Virginia,1,2000,128283,54.89,83.21,9.05,61974,66309,76702,28915,7249,355,112,109401,18882
51,03000,5103000,Arlington CDP,Virginia,0,2000,189453,55.17,83.51,9.38,95443,94010,130601,17705,16327,662,143,154185,35268
51,14440,5114440,Centreville CDP,Virginia,0,2000,48661,55.60,71.58,3.27,24037,24624,33816,4322,6934,143,25,44200,4461
51,21088,5121088,Dale City CDP,Virginia,0,2000,55971,48.80,67.30,3.77,27662,28309,31818,16099,2840,235,107,50437,5534
53,05280,5305280,Bellingham city,Washington,1,2000,67171,53.26,82.31,12.44,32291,34880,59031,655,2853,997,116,64060,3111
53,74060,5374060,Vancouver city,Washington,1,2000,143560,45.89,73.29,10.74,70644,72916,121752,3593,6470,1399,779,134525,9035
53,35275,5335275,Kennewick city,Washington,1,2000,54693,44.73,70.43,10.18,27109,27584,45355,624,1161,507,59,46190,8503
53,53545,5353545,Pasco city,Washington,0,2000,32066,45.46,64.47,8.69,16550,15516,16919,1033,567,248,46,14025,18041
53,03180,5303180,Auburn city,Washington,1,2000,40314,45.35,73.37,11.57,20005,20309,33382,977,1410,1024,204,37295,3019
53,05210,5305210,Bellevue city,Washington,1,2000,109569,44.03,78.88,13.41,54347,55222,81441,2183,19056,356,257,103742,5827
53,22640,5322640,Everett city,Washington,1,2000,91488,49.44,74.88,10.29,46526,44962,74152,3061,5773,1423,330,84949,6539
53,23515,5323515,Federal Way city,Washington,1,2000,83259,47.34,71.76,7.65,40944,42315,57318,6609,10232,740,852,76993,6266
53,35415,5335415,Kent city,Washington,1,2000,79524,49.27,72.32,7.34,39440,40084,56307,6547,7489,777,608,73058,6466
53,35940,5335940,Kirkland city,Washington,0,2000,45054,50.37,81.53,10.24,21921,23133,38420,717,3512,238,89,43202,1852
53,43955,5343955,Marysville city,Washington,0,2000,25315,45.18,69.86,11.33,12347,12968,22331,257,967,406,90,24093,1222
53,57535,5357535,Redmond city,Washington,0,2000,45256,50.98,78.55,9.32,22674,22582,35868,687,5893,203,82,42718,2538
53,57745,5357745,Renton city,Washington,1,2000,50052,50.20,78.20,10.24,24886,25166,34105,4238,6692,358,250,46234,3818
53,61115,5361115,Sammamish city,Washington,0,2000,34104,43.31,66.61,3.99,17192,16912,29950,289,2690,99,30,33251,853
53,63000,5363000,Seattle city,Washington,1,2000,563374,52.90,84.41,12.04,280973,282401,394889,47541,73910,5659,2804,533655,29719
53,70000,5370000,Tacoma city,Washington,1,2000,193556,46.21,74.22,11.88,94419,99137,133704,21757,14656,3794,1798,180294,13262
53,67000,5367000,Spokane city,Washington,1,2000,195629,44.86,75.20,13.96,94267,101362,175018,4052,4399,3444,372,189772,5857
53,80010,5380010,Yakima city,Washington,1,2000,71845,42.84,70.57,14.02,35125,36720,49409,1433,860,1435,102,47632,24213
54,14600,5414600,Charleston city,West Virginia,1,2000,53421,39.85,79.33,17.64,24906,28515,43072,8048,979,127,16,52989,432
55,02375,5502375,Appleton city,Wisconsin,1,2000,70087,46.31,72.59,11.31,34448,35639,64116,695,3231,401,21,68312,1775
55,60500,5560500,Oshkosh city,Wisconsin,0,2000,62916,51.38,79.27,13.09,31449,31467,58339,1376,1908,326,17,61854,1062
55,39225,5539225,Kenosha city,Wisconsin,1,2000,90352,45.76,72.78,12.18,44422,45930,75566,6943,893,398,40,81349,9003
55,22300,5522300,Eau Claire city,Wisconsin,0,2000,61704,52.03,78.35,11.94,29342,32362,57657,429,2259,337,23,61085,619
55,31000,5531000,Green Bay city,Wisconsin,1,2000,102313,47.45,74.56,11.77,50433,51880,87841,1407,3845,3355,36,95019,7294
55,48000,5548000,Madison city,Wisconsin,1,2000,208054,56.51,82.09,9.22,102248,105806,174689,12155,12065,759,77,199542,8512
55,53000,5553000,Milwaukee city,Wisconsin,1,2000,596974,46.78,71.36,10.91,285363,311611,298379,222933,17571,5212,301,525328,71646
55,66000,5566000,Racine city,Wisconsin,1,2000,81855,44.53,71.25,12.25,39869,41986,56408,16634,497,328,42,70433,11422
55,84250,5584250,Waukesha city,Wisconsin,1,2000,64825,48.42,75.31,10.63,31683,33142,59133,831,1407,216,23,59262,5563
56,13900,5613900,Cheyenne city,Wyoming,1,2000,53011,42.95,75.07,13.80,25870,27141,46707,1472,561,430,59,46365,6646
