FIPS_STATE,FIPS_PLACE,FIPS_STATE_PLACE,CITY_NAME,ST_NAME,NYU_500_LARGEST,YEAR,POP_TOTAL,PER_AGE_15TO44,PER_AGE_18PLUS,PER_AGE_65PLUS,POP_MALE,POP_FEMALE,POP_WHITE,POP_BLACK,POP_ASIAN,POP_AIAN,POP_NHOPI,POP_NONHISPANIC,POP_HISPANIC
72,6593,7206593,Bayam√≥n zona urbana, Puerto Rico,0,2015,170259,40.1,80.4,19.6,80128,90131,102122,12028,118,302,0,1104,169155
72,52431,7252431,Mayag√ºez zona urbana, Puerto Rico,0,2015,66581,41.3,80.3,21,30799,35782,17887,2916,155,0,0,1060,65521
1,7000,107000,Birmingham city, Alabama,1,2015,214911,42.7,79.2,13.8,102122,112789,49826,156354,1394,438,0,205971,8940
1,21184,121184,Dothan city, Alabama,0,2015,67536,38.6,76.2,16.9,32172,35364,42298,22489,770,238,140,65832,1704
1,35896,135896,Hoover city, Alabama,1,2015,84839,37.8,74.2,15.5,38040,46799,60365,17378,4505,0,0,81409,3430
1,37000,137000,Huntsville city, Alabama,1,2015,189114,40.7,79.7,15.8,91764,97350,117924,59235,4785,259,47,178227,10887
1,50000,150000,Mobile city, Alabama,1,2015,194305,41.1,78.9,15.4,91275,103030,89161,93089,4854,372,0,189076,5229
1,51000,151000,Montgomery city, Alabama,1,2015,200586,42.5,76.5,13.5,94582,106004,70322,119588,4575,232,16,193938,6648
1,77256,177256,Tuscaloosa city, Alabama,1,2015,98338,54.1,83.2,10.8,47293,51045,52144,42061,2577,128,275,95863,2475
2,3000,203000,Anchorage municipality, Alaska,1,2015,298695,45.7,75.2,9.2,152945,145750,188025,18385,29106,19466,5556,271434,27261
4,4720,404720,Avondale city, Arizona,1,2015,80683,45.4,67.8,7.8,38712,41971,60327,10505,2243,313,73,45967,34716
4,10670,410670,Casas Adobes CDP, Arizona,0,2015,65265,35.6,81.9,22.8,30890,34375,55162,847,2082,752,603,51656,13609
4,12000,412000,Chandler city, Arizona,1,2015,260833,42.6,74,9.9,128885,131948,199992,12847,28715,3978,0,203674,57159
4,23620,423620,Flagstaff city, Arizona,0,2015,70317,59.4,81.1,7.5,33224,37093,55560,1749,1830,4520,183,56711,13606
4,27400,427400,Gilbert town, Arizona,1,2015,247523,42.8,69.3,7.3,116711,130812,204014,7024,16558,4009,276,207586,39937
4,27820,427820,Glendale city, Arizona,1,2015,240114,42.3,74.2,11.2,116795,123319,193269,12775,12331,1738,468,156403,83711
4,28380,428380,Goodyear city, Arizona,0,2015,79003,40.9,75.6,15,36711,42292,61361,7878,4700,303,103,57400,21603
4,46000,446000,Mesa city, Arizona,1,2015,471833,40.4,76.4,16,234998,236835,397988,17601,10340,10504,2110,340408,131425
4,54050,454050,Peoria city, Arizona,1,2015,171242,36.2,73.5,15.3,80139,91103,146359,6167,4752,1808,522,130113,41129
4,55000,455000,Phoenix city, Arizona,1,2015,1563001,44.2,73.7,10.4,786833,776168,1119488,110408,51845,31203,2672,893087,669914
4,64210,464210,San Tan Valley CDP, Arizona,0,2015,82797,40.3,66.1,10.2,40429,42368,71208,1631,954,2296,0,64064,18733
4,65000,465000,Scottsdale city, Arizona,1,2015,236844,34.7,84.6,24.1,115712,121132,200629,3831,9212,5212,599,212078,24766
4,71510,471510,Surprise city, Arizona,1,2015,128442,35.2,72.6,21.1,62875,65567,110910,7720,1605,267,280,103076,25366
4,73000,473000,Tempe city, Arizona,1,2015,175826,57.6,83.8,9.5,91350,84476,124518,9759,14658,3355,821,131422,44404
4,77000,477000,Tucson city, Arizona,1,2015,531674,45.5,78.4,13.7,264893,266781,386958,27290,16623,17754,641,300649,231025
4,85540,485540,Yuma city, Arizona,1,2015,94145,42.7,75.7,15.2,48298,45847,67688,2868,727,498,0,37091,57054
5,23290,523290,Fayetteville city, Arkansas,1,2015,82832,57,81,10.3,41959,40873,64520,6403,3305,318,0,77297,5535
5,24550,524550,Fort Smith city, Arkansas,1,2015,88195,40.1,75.8,14.4,43346,44849,62947,9447,5210,1301,0,71091,17104
5,35710,535710,Jonesboro city, Arkansas,1,2015,73906,48.2,75.7,12.2,35666,38240,54103,12712,1282,1473,0,69292,4614
5,41000,541000,Little Rock city, Arkansas,1,2015,197986,41.8,77.1,13.1,96997,100989,100467,84068,7412,37,59,182486,15500
5,50450,550450,North Little Rock city, Arkansas,0,2015,66506,42.6,71.1,12.9,31671,34835,-998,-998,-998,-998,-998,61646,4860
5,66080,566080,Springdale city, Arkansas,1,2015,80454,42.8,69.6,9.2,36840,43614,55848,1537,1239,259,5227,50254,30200
6,562,600562,Alameda city, California,1,2015,78614,38.8,80.9,14.8,37747,40867,39158,6085,24025,342,758,70349,8265
6,884,600884,Alhambra city, California,1,2015,85572,42.5,83.8,15.3,42184,43388,19318,1508,43279,42,243,54186,31386
6,2000,602000,Anaheim city, California,1,2015,350738,46.5,75.2,10.3,179603,171135,252059,8238,48515,818,1362,149145,201593
6,2252,602252,Antioch city, California,1,2015,110542,41.1,73.3,9.9,54733,55809,45776,21411,11135,1404,2698,74979,35563
6,2364,602364,Apple Valley town, California,1,2015,72185,37,71.1,17.1,32873,39312,57222,6703,1322,782,45,46257,25928
6,2553,602553,Arden-Arcade CDP, California,0,2015,96276,39,81.2,17.8,47596,48680,65115,11373,5938,599,0,81003,15273
6,3526,603526,Bakersfield city, California,1,2015,373627,45,70.9,9.4,182154,191473,263245,31245,29215,3791,783,193386,180241
6,3666,603666,Baldwin Park city, California,1,2015,77056,40.2,75.1,13,38747,38309,35892,1504,14954,237,0,20774,56282
6,4982,604982,Bellflower city, California,1,2015,78434,44.3,71.3,11.5,38936,39498,21887,12191,10080,486,151,35962,42472
6,6000,606000,Berkeley city, California,1,2015,120971,54.3,87,14.1,60142,60829,76218,9122,22282,666,100,105542,15429
6,8786,608786,Buena Park city, California,1,2015,83264,41.1,74.1,12.6,41593,41671,46459,790,23363,158,1856,50349,32915
6,8954,608954,Burbank city, California,1,2015,105314,41.3,77.6,13.8,50405,54909,75789,2842,12866,525,0,83225,22089
6,10046,610046,Camarillo city, California,0,2015,67623,35.5,77.6,21.8,31941,35682,56522,919,5247,28,0,51437,16186
6,11194,611194,Carlsbad city, California,1,2015,113466,36.4,77.5,17,55119,58347,96043,513,10219,540,223,100497,12969
6,11390,611390,Carmichael CDP, California,0,2015,63215,36.9,78.8,18.6,29281,33934,50066,3123,1617,210,268,53924,9291
6,11530,611530,Carson city, California,1,2015,93296,40,80.6,17.1,43790,49506,26187,18859,29489,1579,2389,60358,32938
6,13014,613014,Chico city, California,1,2015,90336,52.4,81.3,13.2,46168,44168,75512,1191,4554,879,134,74758,15578
6,13210,613210,Chino city, California,1,2015,85599,46.7,80.9,9.3,50989,34610,38503,4386,10959,504,146,40104,45495
6,13214,613214,Chino Hills city, California,1,2015,78313,39.1,78.7,10.8,39639,38674,37675,3221,26951,719,124,55774,22539
6,13392,613392,Chula Vista city, California,1,2015,265754,44,74.1,11.4,131485,134269,173466,13412,42433,823,1354,109232,156522
6,13588,613588,Citrus Heights city, California,1,2015,87053,40.1,78.9,16.8,41982,45071,74148,4782,2215,109,196,72392,14661
6,14218,614218,Clovis city, California,1,2015,104172,39.5,75.9,14.7,52392,51780,74136,2721,12745,731,0,80428,23744
6,15044,615044,Compton city, California,1,2015,98448,44.5,71.5,9,49264,49184,52935,25938,1624,269,981,30925,67523
6,16000,616000,Concord city, California,1,2015,128668,41.2,79,13,62310,66358,86429,5168,13828,145,936,87268,41400
6,16350,616350,Corona city, California,1,2015,164242,43.1,75.9,10.2,79749,84493,112825,8235,18099,571,221,95650,68592
6,16532,616532,Costa Mesa city, California,1,2015,113186,49.9,80.2,10.1,59097,54089,84639,2688,7676,1006,1256,74947,38239
6,17918,617918,Daly City city, California,1,2015,106574,43.9,84.1,14.5,53817,52757,22619,4570,59688,553,2255,82258,24316
6,18100,618100,Davis city, California,0,2015,67656,55.2,82.9,12.6,33493,34163,43506,1374,14682,97,98,58615,9041
6,19766,619766,Downey city, California,1,2015,114211,44.7,78.9,10.6,53006,61205,76069,4832,8782,243,101,29405,84806
6,20802,620802,East Los Angeles CDP, California,0,2015,119666,45.8,73.7,11,60460,59206,48057,363,945,451,0,3455,116211
6,21712,621712,El Cajon city, California,1,2015,103688,43.3,74.4,10.1,54450,49238,78399,5406,2707,168,912,72146,31542
6,22020,622020,Elk Grove city, California,1,2015,166890,40.9,73.6,9.9,80057,86833,75674,16672,50282,379,3014,138109,28781
6,22230,622230,El Monte city, California,1,2015,116745,41.8,77.9,14,57961,58784,63280,274,32881,426,130,39222,77523
6,22804,622804,Escondido city, California,1,2015,151458,44.4,76.3,12.3,76551,74907,116093,4333,12671,1333,393,77665,73793
6,23182,623182,Fairfield city, California,1,2015,112972,41,73.9,11.2,55550,57422,57900,15796,18386,578,1590,79996,32976
6,24477,624477,Florence-Graham CDP, California,0,2015,66359,47.5,70.3,6.5,34186,32173,-998,-998,-998,-998,-998,5464,60895
6,24638,624638,Folsom city, California,1,2015,76368,39.2,76.8,11,41051,35317,53741,2973,13405,311,627,70546,5822
6,24680,624680,Fontana city, California,1,2015,207472,47.2,69,5.6,100644,106828,79854,14490,12449,1206,224,51338,156134
6,26000,626000,Fremont city, California,1,2015,232191,43.4,77.7,11.4,114383,117808,58670,6071,132865,527,3959,202597,29594
6,27000,627000,Fresno city, California,1,2015,520072,44.1,70.7,10.1,256130,263942,311604,40021,69359,5904,1257,263927,256145
6,28000,628000,Fullerton city, California,1,2015,140849,45.2,78.8,12.6,69549,71300,85666,3174,30849,197,394,87390,53459
6,29000,629000,Garden Grove city, California,1,2015,175384,42,78.2,13.7,86779,88605,64048,1084,70118,1148,558,109346,66038
6,30000,630000,Glendale city, California,1,2015,201025,39.8,83.7,16.6,98181,102844,142232,3539,38323,167,371,170218,30807
6,32548,632548,Hawthorne city, California,1,2015,88444,46,74.8,8.9,43682,44762,22545,20617,7361,339,132,38329,50115
6,33000,633000,Hayward city, California,1,2015,158300,45.7,77.5,11.1,78152,80148,67679,16822,41446,941,3388,93420,64880
6,33182,633182,Hemet city, California,1,2015,83873,35.5,71.7,20.2,38622,45251,65152,6421,3196,1181,649,46425,37448
6,33434,633434,Hesperia city, California,1,2015,93286,41.2,68.9,9.9,43588,49698,76974,4703,1164,1490,65,39521,53765
6,36000,636000,Huntington Beach city, California,1,2015,201927,37.4,80.2,16.6,99967,101960,145828,2862,22739,1358,643,159624,42303
6,36448,636448,Indio city, California,1,2015,87526,42,72.7,15.5,43803,43723,47273,2887,2120,979,0,28674,58852
6,36546,636546,Inglewood city, California,1,2015,111656,43.5,75.6,12.2,52995,58661,31421,42220,1677,416,71,50783,60873
6,36770,636770,Irvine city, California,1,2015,256927,48,79.5,10,125411,131516,116385,7605,116420,207,362,237661,19266
6,37692,637692,Jurupa Valley city, California,0,2015,100314,42.4,74.6,10.9,49430,50884,56160,2853,4087,987,69,33789,66525
6,39248,639248,Laguna Niguel city, California,0,2015,65812,32,80,17,30193,35619,52322,397,6683,800,424,56609,9203
6,39496,639496,Lake Forest city, California,1,2015,82497,38.9,77.9,13.2,41515,40982,55977,1717,13868,219,0,65087,17410
6,39892,639892,Lakewood city, California,1,2015,81592,40.4,77.4,13.2,41523,40069,40989,5351,17524,142,2176,56605,24987
6,40130,640130,Lancaster city, California,1,2015,161113,44.3,71.4,9.1,80668,80445,104759,32622,7274,536,0,103690,57423
6,41992,641992,Livermore city, California,1,2015,88117,38.2,74.6,11.1,41522,46595,67710,1452,10932,273,109,68535,19582
6,43000,643000,Long Beach city, California,1,2015,474172,44.7,76.6,11.2,238159,236013,262242,58597,58754,8376,5017,266282,207890
6,44000,644000,Los Angeles city, California,1,2015,3971896,46.5,78.5,11.5,1958998,2012898,2068389,364740,457354,34816,6663,2035164,1936732
6,44574,644574,Lynwood city, California,1,2015,72005,48.1,71.4,7.8,35634,36371,47749,4915,865,375,0,8628,63377
6,45484,645484,Manteca city, California,1,2015,75450,40.7,71.9,10.9,37053,38397,50999,4106,5682,240,820,43898,31552
6,46842,646842,Menifee city, California,1,2015,87163,36.3,72.6,16.7,42866,44297,58026,4919,4592,742,289,57373,29790
6,46898,646898,Merced city, California,1,2015,82440,42.7,69,10.8,40048,42392,38789,4699,8554,855,20,38756,43684
6,47766,647766,Milpitas city, California,1,2015,77617,43.2,77.8,12.7,40098,37519,15425,2128,51283,262,349,65802,11815
6,48256,648256,Mission Viejo city, California,1,2015,97163,35,81.6,18.9,48849,48314,76857,1314,10335,83,181,78250,18913
6,48354,648354,Modesto city, California,1,2015,211257,40.6,74.1,13.4,104852,106405,159183,7428,15852,1721,2287,126116,85141
6,49270,649270,Moreno Valley city, California,1,2015,204181,47.3,71.7,8.4,98584,105597,86265,33400,9943,722,1165,83571,120610
6,49670,649670,Mountain View city, California,1,2015,80438,49.6,77.7,8.4,42493,37945,47871,1258,20805,167,135,64041,16397
6,50076,650076,Murrieta city, California,1,2015,109816,41.1,72.3,11.6,49363,60453,70564,7457,12728,443,591,76872,32944
6,50258,650258,Napa city, California,1,2015,80429,39.7,76.1,14.5,39828,40601,55882,382,2972,1066,106,47200,33229
6,51182,651182,Newport Beach city, California,1,2015,87131,32.8,81.9,23,43161,43970,72442,168,8056,286,109,79004,8127
6,52526,652526,Norwalk city, California,1,2015,107145,43.3,77,9.9,53125,54020,45320,4740,15214,724,220,31125,76020
6,53000,653000,Oakland city, California,1,2015,419278,46.9,79.7,11.7,203827,215451,154160,104481,64168,3540,1756,305224,114054
6,53322,653322,Oceanside city, California,1,2015,175714,41.1,78.9,15.4,87482,88232,130609,9381,14946,1108,1658,113614,62100
6,53896,653896,Ontario city, California,1,2015,171200,47.1,70.9,7.4,85059,86141,66111,11077,11853,1005,191,52908,118292
6,53980,653980,Orange city, California,1,2015,140995,44.8,79.4,12,67337,73658,97023,2415,19383,351,127,94740,46255
6,54652,654652,Oxnard city, California,1,2015,207252,45,71.2,9.4,101906,105346,159325,5249,15595,4414,1022,52341,154911
6,55156,655156,Palmdale city, California,1,2015,158350,39.8,70.5,9.6,76361,81989,68892,23906,9034,1670,598,70898,87452
6,55282,655282,Palo Alto city, California,0,2015,66848,38.5,76.3,17.6,31451,35397,40346,818,21074,36,0,63352,3496
6,56000,656000,Pasadena city, California,1,2015,142246,43,80.5,15.4,67712,74534,72764,14121,21205,395,148,89529,52717
6,56700,656700,Perris city, California,1,2015,74959,46.8,66.1,5.4,41623,33336,22487,8390,2799,406,0,20561,54398
6,57456,657456,Pittsburg city, California,0,2015,69427,43.8,75.6,8.9,33309,36118,20444,13169,11579,386,694,40822,28605
6,57792,657792,Pleasanton city, California,1,2015,79519,34.2,73.2,13,36662,42857,46094,1347,24950,232,890,71570,7949
6,58072,658072,Pomona city, California,1,2015,153252,46.5,74.7,10.4,74945,78307,88854,9971,14478,1532,365,44465,108787
6,59444,659444,Rancho Cordova city, California,0,2015,71026,43.6,75.7,11.5,34844,36182,42851,6063,10663,773,961,57056,13970
6,59451,659451,Rancho Cucamonga city, California,1,2015,175232,42.7,74.9,9.5,88127,87105,105040,21610,21614,1060,2321,109409,65823
6,59920,659920,Redding city, California,1,2015,91579,37.6,79,19.8,42530,49049,77152,1536,4608,2691,0,82436,9143
6,59962,659962,Redlands city, California,1,2015,71028,40.7,77,14.8,33993,37035,51625,5686,5231,480,294,51330,19698
6,60018,660018,Redondo Beach city, California,1,2015,68185,37.9,81.5,12.4,34855,33330,48727,1327,8846,444,112,59327,8858
6,60102,660102,Redwood City city, California,1,2015,85300,42.1,77.5,12.8,42676,42624,48497,1507,12627,170,1101,56289,29011
6,60466,660466,Rialto city, California,1,2015,103137,48,73.9,8.5,49902,53235,73103,10423,3291,693,0,24566,78571
6,60620,660620,Richmond city, California,1,2015,109715,44.8,78.5,12.6,52615,57100,32339,24231,18218,236,257,64583,45132
6,62000,662000,Riverside city, California,1,2015,322423,48.1,76,10.2,160613,161810,209493,19928,20371,2582,1804,161726,160697
17,14000,1714000,Chicago city, Illinois,1,2015,2720556,47.4,78.6,11.6,1320015,1400541,1316927,844768,168744,8982,689,1934831,785725
17,14351,1714351,Cicero town, Illinois,1,2015,83867,50,69.9,6.1,43153,40714,29745,2643,861,680,0,7442,76425
17,18823,1718823,Decatur city, Illinois,1,2015,72856,39.3,79.2,17.8,34646,38210,52496,14727,602,19,0,71147,1709
17,23074,1723074,Elgin city, Illinois,1,2015,111076,41.2,73.1,13,54852,56224,73789,6934,7064,10,0,62855,48221
17,24582,1724582,Evanston city, Illinois,1,2015,75523,43.8,80.5,14,34146,41377,51794,10910,7339,22,0,66448,9075
17,38570,1738570,Joliet city, Illinois,1,2015,150025,44.6,70.2,8.6,70863,79162,101876,26112,1686,42,56,104734,45291
17,51622,1751622,Naperville city, Illinois,1,2015,147159,39.4,73.9,11.1,71365,75794,105589,7974,28852,191,0,142231,4928
17,57225,1757225,Palatine village, Illinois,1,2015,69269,40.6,76.4,12.3,36506,32763,45153,1253,6625,0,0,50643,18626
17,59000,1759000,Peoria city, Illinois,1,2015,118661,42.2,74.8,13.7,56229,62432,71113,31525,5699,149,56,111787,6874
17,65000,1765000,Rockford city, Illinois,1,2015,149346,39.5,75.2,15.3,71076,78270,102639,29239,4779,1074,0,120423,28923
17,68003,1768003,Schaumburg village, Illinois,1,2015,75811,41,76.4,11.9,35971,39840,41629,1610,20443,633,686,63266,12545
17,70122,1770122,Skokie village, Illinois,0,2015,64819,34.9,78.6,20,31382,33437,37834,4816,18129,139,0,58229,6590
17,72000,1772000,Springfield city, Illinois,1,2015,117809,38.8,78.5,16,55639,62170,86966,21381,3349,117,0,115071,2738
17,79293,1779293,Waukegan city, Illinois,1,2015,88347,43.8,72.1,9.5,45514,42833,63475,10060,4247,129,8,34133,54214
18,5860,1805860,Bloomington city, Indiana,1,2015,83815,69,88.6,9.6,40588,43227,68032,3518,8561,143,0,80172,3643
18,10342,1810342,Carmel city, Indiana,1,2015,89029,36.5,72.6,10.8,42928,46101,-998,-998,-998,-998,-998,85918,3111
18,22000,1822000,Evansville city, Indiana,1,2015,117679,41.2,79.9,16.6,57198,60481,96413,14893,954,69,0,114416,3263
18,23278,1823278,Fishers town, Indiana,1,2015,86071,40.7,66.6,7.1,42161,43910,70703,5329,5714,0,0,82662,3409
18,25000,1825000,Fort Wayne city, Indiana,1,2015,258144,40.8,74.1,13.6,124815,133329,192349,38066,11179,872,602,236910,21234
18,27000,1827000,Gary city, Indiana,1,2015,77354,36.8,73.7,15.2,35876,41478,11887,59741,352,0,0,71088,6266
18,31000,1831000,Hammond city, Indiana,1,2015,77610,41.8,77.4,12.8,38923,38687,38721,18949,1096,98,0,52290,25320
18,36003,1836003,Indianapolis city (balance), Indiana,1,2015,848423,43,75.2,11.4,410615,437808,534462,236414,25280,2765,0,764997,83426
18,40788,1840788,Lafayette city, Indiana,1,2015,71170,44.9,77.4,13.8,34313,36857,61705,5403,1126,169,0,62019,9151
18,51876,1851876,Muncie city, Indiana,1,2015,69701,51.7,81.1,12.3,32446,37255,-998,-998,-998,-998,-998,67202,2499
18,71000,1871000,South Bend city, Indiana,1,2015,103757,42.5,71.6,11.2,50483,53274,66559,25812,1377,183,161,87295,16462
19,1855,1901855,Ames city, Iowa,0,2015,65052,67.3,86.9,8.4,33814,31238,54595,703,7817,114,0,63028,2024
19,12000,1912000,Cedar Rapids city, Iowa,1,2015,130405,43.9,77.2,13.8,63109,67296,111571,7397,3280,650,40,125077,5328
19,19000,1919000,Davenport city, Iowa,1,2015,102577,41.3,75.6,14.3,50123,52454,84478,10828,2297,274,29,93446,9131
19,21000,1921000,Des Moines city, Iowa,1,2015,210317,44.8,76.8,11.9,103726,106591,161279,22581,13004,2323,182,185011,25306
19,38595,1938595,Iowa City city, Iowa,1,2015,74227,59.7,82.9,9.4,37089,37138,58305,6839,4195,244,406,70155,4072
19,73335,1973335,Sioux City city, Iowa,1,2015,82776,40.5,74.6,13.4,38827,43949,69391,3353,2996,1307,289,67174,15602
19,82425,1982425,Waterloo city, Iowa,1,2015,68457,39.8,77.1,14.5,34488,33969,50068,10996,1511,292,0,63496,4961
20,36000,2036000,Kansas City city, Kansas,1,2015,151261,41,72.4,11,74606,76655,89987,36348,6641,638,23,106919,44342
20,38900,2038900,Lawrence city, Kansas,1,2015,93916,56.9,82.1,9.8,45592,48324,76643,4425,5064,2929,0,87481,6435
20,52575,2052575,Olathe city, Kansas,1,2015,134316,42,69.3,8.7,65046,69270,114787,6686,4841,569,443,118185,16131
20,53775,2053775,Overland Park city, Kansas,1,2015,186511,40.3,77.3,15,93355,93156,156864,8122,15073,424,73,176407,10104
20,64500,2064500,Shawnee city, Kansas,0,2015,65058,40.5,75.8,14.6,32313,32745,53570,5576,2491,0,0,60194,4864
20,71000,2071000,Topeka city, Kansas,1,2015,127257,40.2,76.6,16.6,60879,66378,102787,11283,2360,1520,268,108617,18640
20,79000,2079000,Wichita city, Kansas,1,2015,389955,41.2,74.6,12.8,192354,197601,295195,46253,23902,4628,239,324793,65162
21,46027,2146027,Lexington-Fayette urban county, Kentucky,1,2015,314488,46.6,79,12.1,154032,160456,238806,45159,11090,679,85,292722,21766
21,48006,2148006,Louisville/Jefferson County metro government (balance), Kentucky,1,2015,615389,40.1,77.1,14.4,298451,316938,439547,138480,15346,866,424,586677,28712
22,5000,2205000,Baton Rouge city, Louisiana,1,2015,228596,48.6,78.8,12.4,111492,117104,95463,122019,7007,379,72,221168,7428
22,8920,2208920,Bossier City city, Louisiana,0,2015,68097,44.9,76.3,14,33428,34669,45426,18387,1357,279,0,62508,5589
22,39475,2239475,Kenner city, Louisiana,1,2015,67106,40.3,77.3,14.7,33993,33113,44286,16899,2573,95,0,49337,17769
22,40735,2240735,Lafayette city, Louisiana,1,2015,127661,44.8,77.1,11.6,64018,63643,83446,38741,2390,235,0,121105,6556
22,41155,2241155,Lake Charles city, Louisiana,1,2015,76066,43.5,76.1,14.3,35678,40388,35334,37057,1203,465,0,72909,3157
22,50115,2250115,Metairie CDP, Louisiana,0,2015,146458,38.4,81.6,17.8,69515,76943,121782,16035,3334,86,0,126755,19703
22,55000,2255000,New Orleans city, Louisiana,1,2015,389617,44.3,79.6,12.5,185736,203881,134004,230722,12136,828,120,367767,21850
22,70000,2270000,Shreveport city, Louisiana,1,2015,196994,41.2,74.8,14.1,93138,103856,76882,110852,3637,311,67,191913,5081
23,60545,2360545,Portland city, Maine,1,2015,66872,43.1,85,15.9,31480,35392,56526,5003,1984,46,0,64841,2031
24,4000,2404000,Baltimore city, Maryland,1,2015,621849,44.6,78.9,12.5,294027,327822,193032,382922,16894,952,381,591896,29953
24,19125,2419125,Columbia CDP, Maryland,0,2015,103467,41,75.7,13.2,52202,51265,55228,26879,15372,0,0,95434,8033
24,26000,2426000,Ellicott City CDP, Maryland,0,2015,70932,34.1,76.1,15.1,34406,36526,41814,5483,21126,201,70,69330,1602
24,30325,2430325,Frederick city, Maryland,0,2015,69482,43.2,76.6,12.2,33146,36336,47064,11663,4774,128,0,56417,13065
24,31175,2431175,Gaithersburg city, Maryland,0,2015,67445,43.5,77.5,10.4,32211,35234,34739,11660,12515,86,27,48724,18721
24,32025,2432025,Germantown CDP, Maryland,0,2015,84122,42.7,73,8.1,41115,43007,41269,20159,14972,275,0,65920,18202
24,32650,2432650,Glen Burnie CDP, Maryland,0,2015,69859,40,76.2,13.9,33398,36461,48135,16078,2432,347,0,60722,9137
24,67675,2467675,Rockville city, Maryland,0,2015,66998,41.1,79.3,16.3,31205,35793,38817,6699,14871,157,0,57801,9197
24,72450,2472450,Silver Spring CDP, Maryland,0,2015,82463,47.8,76.4,8.8,40601,41862,34525,19740,7297,460,0,56539,25924
24,81175,2481175,Waldorf CDP, Maryland,0,2015,75512,43.4,72.5,8.1,35640,39872,22935,42702,3277,494,0,70702,4810
25,7000,2507000,Boston city, Massachusetts,1,2015,669469,54.3,83.3,10.6,322149,347320,352667,169390,63603,1282,153,538813,130656
25,9000,2509000,Brockton city, Massachusetts,1,2015,95314,42.6,76.1,12,46273,49041,38457,41624,2297,65,0,84424,10890
25,11000,2511000,Cambridge city, Massachusetts,1,2015,110402,62,89.5,12.6,55421,54981,77028,10401,16219,0,39,100969,9433
25,23000,2523000,Fall River city, Massachusetts,1,2015,88770,41.9,81.8,13.4,43314,45456,72667,3335,1684,0,246,79689,9081
25,24960,2524960,Framingham CDP, Massachusetts,0,2015,71210,42.1,81.4,12.8,35442,35768,50947,6593,5474,638,0,58210,13000
25,34550,2534550,Lawrence city, Massachusetts,1,2015,80240,45.2,73.5,10.1,37464,42776,37129,5848,2125,121,0,17065,63175
25,37000,2537000,Lowell city, Massachusetts,1,2015,110720,46,77.6,9,54422,56298,66454,5968,28650,242,0,88625,22095
25,37490,2537490,Lynn city, Massachusetts,1,2015,92459,45.2,75.5,10.8,44598,47861,43612,12130,8190,214,0,59209,33250
25,45000,2545000,New Bedford city, Massachusetts,1,2015,94959,40.2,78.7,15.7,43793,51166,61649,6646,1297,47,0,76623,18336
25,45560,2545560,Newton city, Massachusetts,1,2015,88809,36.5,78.7,17.7,41985,46824,67014,1993,13966,67,0,84019,4790
25,55745,2555745,Quincy city, Massachusetts,1,2015,93629,41,83.8,16.4,44129,49500,58004,3902,30135,0,0,91063,2566
25,62535,2562535,Somerville city, Massachusetts,1,2015,80334,64.8,90.5,10,41028,39306,60608,6038,8481,21,0,71544,8790
25,67000,2567000,Springfield city, Massachusetts,1,2015,154336,43.7,73.5,11.9,74744,79592,92933,30723,4544,835,0,85127,69209
25,82000,2582000,Worcester city, Massachusetts,1,2015,184806,46.9,81.3,13.2,90951,93855,127455,24337,14105,658,0,145806,39000
26,3000,2603000,Ann Arbor city, Michigan,1,2015,117070,59.8,87.7,12.5,58789,58281,86039,7780,16882,1044,118,111182,5888
26,21000,2621000,Dearborn city, Michigan,1,2015,95180,39.9,71.5,11.8,46482,48698,86285,3409,2357,185,0,91647,3533
26,22000,2622000,Detroit city, Michigan,1,2015,677124,41.1,74.7,12.7,319265,357859,95272,538304,8790,1738,188,623144,53980
26,27440,2627440,Farmington Hills city, Michigan,1,2015,81332,35.8,77.8,18.5,37527,43805,56106,12745,9888,130,0,79280,2052
26,29000,2629000,Flint city, Michigan,1,2015,98297,39.7,74.5,11.9,48984,49313,40994,51578,195,81,0,95772,2525
26,34000,2634000,Grand Rapids city, Michigan,1,2015,195099,47.4,77.3,11.5,95669,99430,134123,34841,4451,596,149,163817,31282
26,42160,2642160,Kalamazoo city, Michigan,1,2015,76040,54.9,80.3,10.3,37175,38865,52812,16101,1276,394,0,71926,4114
26,46000,2646000,Lansing city, Michigan,1,2015,114110,46.8,76.8,10.8,54333,59777,67182,26696,3941,431,0,99865,14245
26,49000,2649000,Livonia city, Michigan,1,2015,94633,32.7,82,19.1,45369,49264,86733,4181,2507,116,0,92861,1772
26,69035,2669035,Rochester Hills city, Michigan,1,2015,73432,39.3,76.9,15.8,36356,37076,60905,3046,7546,45,0,70037,3395
26,74900,2674900,Southfield city, Michigan,1,2015,73177,37.7,79.5,19.5,31369,41808,17246,52696,1230,59,0,72604,573
26,76460,2676460,Sterling Heights city, Michigan,1,2015,132062,39.2,80.4,18.4,64985,67077,110631,6990,11293,32,0,129251,2811
26,80700,2680700,Troy city, Michigan,1,2015,83276,34.4,77.5,15.5,42371,40905,53748,4048,21213,1142,0,80876,2400
26,84000,2684000,Warren city, Michigan,1,2015,135356,36.3,80.1,16.3,64063,71293,91619,25478,11717,398,123,132146,3210
26,86000,2686000,Westland city, Michigan,1,2015,81995,38,80.2,16.7,37742,44253,59486,15799,4325,133,0,79168,2827
26,88940,2688940,Wyoming city, Michigan,1,2015,75277,40.6,70.6,9.8,35967,39310,54314,5965,2771,1134,0,59952,15325
27,6616,2706616,Bloomington city, Minnesota,1,2015,86436,38.7,80.2,18.6,43318,43118,69711,5174,4191,1008,0,78415,8021
27,7966,2707966,Brooklyn Park city, Minnesota,1,2015,79150,40.7,72.3,9.7,37845,41305,40093,21333,13432,625,0,75012,4138
27,17000,2717000,Duluth city, Minnesota,1,2015,86126,45.9,82.2,15.3,41271,44855,78517,2054,1270,734,144,84145,1981
27,17288,2717288,Eagan city, Minnesota,0,2015,66288,42,77.6,9.9,31587,34701,49298,6529,5397,280,0,61960,4328
27,40166,2740166,Maple Grove city, Minnesota,0,2015,68381,33.9,73.1,10.1,31780,36601,-998,-998,-998,-998,-998,66696,1685
27,43000,2743000,Minneapolis city, Minnesota,1,2015,410935,52.4,80.1,9.2,206547,204388,260331,80984,27086,3687,0,370954,39981
27,51730,2751730,Plymouth city, Minnesota,1,2015,75928,37.1,76.7,16,39035,36893,62624,6633,5054,66,0,72654,3274
27,54880,2754880,Rochester city, Minnesota,1,2015,112216,41.5,75.2,14.5,54934,57282,90689,7679,8891,710,83,105599,6617
27,56896,2756896,St. Cloud city, Minnesota,0,2015,68253,50.1,77.8,13,34311,33942,57354,5588,1765,419,0,65614,2639
27,58000,2758000,St. Paul city, Minnesota,1,2015,300840,47,75.8,9.8,149547,151293,178216,46900,53452,1572,39,273533,27307
27,71428,2771428,Woodbury city, Minnesota,0,2015,67850,39,72.2,11.3,31982,35868,53593,4307,6131,70,0,64592,3258
28,29700,2829700,Gulfport city, Mississippi,1,2015,71872,42.1,76.2,14.6,33108,38764,40824,26068,1405,260,0,67625,4247
28,36000,2836000,Jackson city, Mississippi,1,2015,170811,43.7,73.8,11.1,79039,91772,28419,139016,801,0,0,167794,3017
29,15670,2915670,Columbia city, Missouri,1,2015,119098,57.1,81.7,7.6,56544,62554,91241,12834,6954,456,310,114142,4956
29,35000,2935000,Independence city, Missouri,1,2015,117255,37.2,77.2,16.1,54348,62907,96658,9295,445,656,501,105019,12236
29,38000,2938000,Kansas City city, Missouri,1,2015,475361,42.1,76.7,12.3,228430,246931,284279,141122,13804,1538,432,429324,46037
29,41348,2941348,Lee's Summit city, Missouri,1,2015,95068,38.6,72.4,14.1,48353,46715,81512,6784,2457,562,457,90564,4504
29,54074,2954074,O'Fallon city, Missouri,1,2015,85032,42.4,72.3,11.6,41762,43270,75531,4502,2514,200,0,82449,2583
29,64082,2964082,St. Charles city, Missouri,0,2015,68801,42.4,79.9,14.4,32054,36747,55837,4777,2643,0,119,64731,4070
29,64550,2964550,St. Joseph city, Missouri,1,2015,76096,41.7,77.3,15.6,37688,38408,65954,6059,605,484,0,70696,5400
29,65000,2965000,St. Louis city, Missouri,1,2015,315685,45.8,79.9,11.6,153026,162659,147897,147176,9152,507,521,303424,12261
29,70000,2970000,Springfield city, Missouri,1,2015,166798,48.4,83.1,16.2,81057,85741,146856,7923,4498,770,93,159698,7100
30,6550,3006550,Billings city, Montana,1,2015,110270,40.6,77.7,15.5,52705,57565,99558,985,1113,4886,0,102744,7526
30,50200,3050200,Missoula city, Montana,1,2015,71024,49.4,82.7,13.4,35002,36022,64376,628,1812,2018,0,68550,2474
31,28000,3128000,Lincoln city, Nebraska,1,2015,277346,46.6,77.2,11.9,138544,138802,237273,12270,11681,1650,270,257050,20296
31,37000,3137000,Omaha city, Nebraska,1,2015,443887,42.5,75.2,12.4,218789,225098,342188,57966,15370,3340,141,380371,63516
32,23770,3223770,Enterprise CDP, Nevada,0,2015,135474,49.3,76.7,8.9,69146,66328,77511,12196,30390,1018,1752,110167,25307
32,31900,3231900,Henderson city, Nevada,1,2015,285658,36.7,79.1,19.7,139412,146246,224975,15173,19916,1666,712,238504,47154
32,40000,3240000,Las Vegas city, Nevada,1,2015,623769,39.3,75.7,13.8,310568,313201,401097,72469,42622,4175,3844,418856,204913
32,51800,3251800,North Las Vegas city, Nevada,1,2015,234793,44.9,71.5,10.4,116350,118443,126034,47918,14114,1261,1321,139989,94804
32,54600,3254600,Paradise CDP, Nevada,0,2015,236946,44.1,79.4,13,122784,114162,141059,22312,23303,2562,3710,148599,88347
32,60600,3260600,Reno city, Nevada,1,2015,241443,42.8,78.4,14.7,122292,119151,186593,5277,14038,1522,2018,181541,59902
32,68400,3268400,Sparks city, Nevada,1,2015,96098,40.1,74.9,14.5,47780,48318,74870,3013,5639,1282,635,66939,29159
32,68585,3268585,Spring Valley CDP, Nevada,0,2015,193955,45.6,79.2,12.5,96808,97147,102224,23808,39287,869,1529,153581,40374
32,71400,3271400,Sunrise Manor CDP, Nevada,0,2015,192608,42.8,72.9,9.9,93505,99103,102159,24475,13136,2198,1313,92770,99838
33,45140,3345140,Manchester city, New Hampshire,1,2015,110223,41.6,80.1,13.6,54845,55378,98135,6424,3247,92,0,98261,11962
33,50260,3350260,Nashua city, New Hampshire,1,2015,87975,41.3,78.4,14.4,42926,45049,72795,3634,9593,32,0,77464,10511
34,3580,3403580,Bayonne city, New Jersey,0,2015,66303,39.6,76.6,13.8,32705,33598,40114,6731,6734,0,365,46778,19525
34,10000,3410000,Camden city, New Jersey,1,2015,76131,43.9,67.4,8.8,36437,39694,16938,31608,1686,564,101,34658,41473
34,13690,3413690,Clifton city, New Jersey,1,2015,86341,41.8,78.1,13.7,41932,44409,49736,8194,5489,1438,0,53165,33176
34,19390,3419390,East Orange city, New Jersey,0,2015,64962,44.5,76.6,11.9,29995,34967,2063,56406,472,197,0,58594,6368
34,21000,3421000,Elizabeth city, New Jersey,1,2015,129012,44.2,73.5,9.7,65896,63116,63780,23617,2514,455,0,42556,86456
34,36000,3436000,Jersey City city, New Jersey,1,2015,264277,50.3,79.1,9.9,131765,132512,93626,60304,64310,1317,104,184559,79718
34,51000,3451000,Newark city, New Jersey,1,2015,281913,44.8,75.7,10.7,138040,143873,72760,141422,6216,1439,0,181481,100432
34,56550,3456550,Passaic city, New Jersey,1,2015,71082,43.7,69.4,8.3,36505,34577,28955,4316,3338,137,0,17402,53680
34,57000,3457000,Paterson city, New Jersey,1,2015,147757,43,73.2,11.1,70640,77117,44849,38159,7930,245,0,62202,85555
34,73110,3473110,Toms River CDP, New Jersey,0,2015,87750,32.7,76.4,17.1,43864,43886,77182,2590,3420,0,0,77483,10267
34,74000,3474000,Trenton city, New Jersey,1,2015,84231,46,74.6,9,42581,41650,36595,42639,1182,74,0,53618,30613
34,74630,3474630,Union City city, New Jersey,1,2015,69149,46.6,79.3,10,35376,33773,48162,3594,3671,0,0,15975,53174
35,2000,3502000,Albuquerque city, New Mexico,1,2015,559131,41.9,77.1,14.2,273323,285808,392079,20159,13909,24876,391,287277,271854
35,39380,3539380,Las Cruces city, New Mexico,1,2015,101644,44.2,75.5,15.5,47835,53809,89030,2923,1954,1428,0,41030,60614
35,63460,3563460,Rio Rancho city, New Mexico,1,2015,94155,39.4,74.6,13.1,47251,46904,69900,3129,1162,2902,250,55481,38674
35,70500,3570500,Santa Fe city, New Mexico,1,2015,84112,34.4,79.6,21,40601,43511,73333,931,997,1307,38,38228,45884
36,1000,3601000,Albany city, New York,1,2015,98452,51.8,85.2,13.6,47627,50825,55009,27825,7187,597,79,89084,9368
36,8026,3608026,Brentwood CDP, New York,0,2015,63792,45.7,75,9.1,31395,32397,42265,7846,1211,554,0,23681,40111
36,11000,3611000,Buffalo city, New York,1,2015,258066,44,76.9,12.2,124537,133529,122319,96162,12822,1077,123,228410,29656
36,15000,3615000,Cheektowaga CDP, New York,0,2015,76075,38.8,81.5,18.1,37476,38599,62417,9498,1290,88,0,74081,1994
36,49121,3649121,Mount Vernon city, New York,1,2015,68621,41.5,79.7,13.7,31876,36745,12498,48882,1497,293,0,59175,9446
36,50617,3650617,New Rochelle city, New York,1,2015,79838,37.9,78.6,18.8,38871,40967,42145,16317,3887,5,91,56290,23548
36,51000,3651000,New York city, New York,1,2015,8550405,44.3,78.9,13.2,4081698,4468707,3639914,2055137,1205321,35617,1864,6065280,2485125
36,63000,3663000,Rochester city, New York,1,2015,209808,46.4,76.3,9.8,100135,109673,99825,86974,8132,2497,0,171804,38004
36,65508,3665508,Schenectady city, New York,1,2015,65299,44.3,81.5,12.9,32398,32901,37775,13310,3720,145,0,59342,5957
36,73000,3673000,Syracuse city, New York,1,2015,144152,48.6,78.2,12.8,69462,74690,83779,40762,8440,1018,109,130784,13368
36,84000,3684000,Yonkers city, New York,1,2015,201118,41.5,77.7,15.3,96580,104538,122998,34238,12932,292,82,127510,73608
37,2140,3702140,Asheville city, North Carolina,1,2015,88507,43.3,81.9,16.8,42100,46407,76861,8182,1517,253,0,84361,4146
37,10740,3710740,Cary town, North Carolina,1,2015,160514,39.1,75.4,11.4,78932,81582,115843,13474,23885,528,0,150187,10327
37,12000,3712000,Charlotte city, North Carolina,1,2015,827121,46.1,76.3,10,396646,430475,430362,285758,50389,2749,119,713390,113731
37,14100,3714100,Concord city, North Carolina,1,2015,87693,41,72.4,13.2,42732,44961,59548,17128,3121,86,0,76392,11301
37,19000,3719000,Durham city, North Carolina,1,2015,257598,49,77.9,10.4,121153,136445,120911,102819,13919,974,0,221294,36304
37,22920,3722920,Fayetteville city, North Carolina,1,2015,201965,46.7,75.8,11.7,101051,100914,92468,82656,5154,2036,500,176885,25080
37,25580,3725580,Gastonia city, North Carolina,1,2015,74550,39.4,75.3,14,35527,39023,45292,21303,2279,369,0,67897,6653
37,28000,3728000,Greensboro city, North Carolina,1,2015,285344,44.1,78.3,13.8,132251,153093,137388,118163,11353,685,27,263197,22147
37,28080,3728080,Greenville city, North Carolina,1,2015,90588,57.3,81.5,9.5,39897,50691,48267,36364,2248,274,0,86179,4409
37,31400,3731400,High Point city, North Carolina,1,2015,109828,41.3,75.5,13.6,51751,58077,54501,37090,9730,218,248,98382,11446
37,34200,3734200,Jacksonville city, North Carolina,1,2015,67363,63.1,79.3,6.2,40015,27348,46591,9854,2849,414,33,55416,11947
37,55000,3755000,Raleigh city, North Carolina,1,2015,451949,49.6,77.9,9.3,219184,232765,264843,133153,20151,1681,348,400163,51786
37,74440,3774440,Wilmington city, North Carolina,1,2015,115947,45.8,81.4,15.1,52346,63601,87929,23226,2518,182,108,109136,6811
37,75000,3775000,Winston-Salem city, North Carolina,1,2015,241232,42,75.7,13.7,112520,128712,135068,84731,5272,152,276,202911,38321
38,7200,3807200,Bismarck city, North Dakota,0,2015,70240,41.8,81,16,34675,35565,63521,1617,769,3038,0,68573,1667
38,25700,3825700,Fargo city, North Dakota,1,2015,119250,52.2,79.6,11.1,60560,58690,104053,5480,3853,1517,0,115683,3567
39,1000,3901000,Akron city, Ohio,1,2015,197553,41.2,79,15.1,96886,100667,120353,59364,8006,505,0,193869,3684
39,12000,3912000,Canton city, Ohio,1,2015,71895,41.5,73.7,13,34476,37419,-998,-998,-998,-998,-998,68298,3597
39,15000,3915000,Cincinnati city, Ohio,1,2015,298537,46,78.5,12.4,143654,154883,154285,125995,6259,521,0,289416,9121
39,16000,3916000,Cleveland city, Ohio,1,2015,388059,41.6,77.5,13.5,186436,201623,156443,196619,8089,2652,197,347456,40603
39,18000,3918000,Columbus city, Ohio,1,2015,849067,48.9,77.8,9.9,413981,435086,522370,235671,42933,1490,145,802212,46855
39,21000,3921000,Dayton city, Ohio,1,2015,140597,43.9,77,13,66631,73966,80076,51935,1548,265,15,135652,4945
39,44856,3944856,Lorain city, Ohio,0,2015,63651,40.4,73.1,12.8,30844,32807,42890,13001,308,277,52,44309,19342
39,61000,3961000,Parma city, Ohio,1,2015,79943,41.9,82.4,16.9,38425,41518,74751,1559,889,303,38,74582,5361
39,77000,3977000,Toledo city, Ohio,1,2015,279778,40.9,78,14.2,135455,144323,174466,76791,5918,740,205,256164,23614
39,88000,3988000,Youngstown city, Ohio,1,2015,64609,39.1,77.4,17.6,30758,33851,30886,29899,200,428,0,57045,7564
40,9050,4009050,Broken Arrow city, Oklahoma,1,2015,107595,39.3,72.6,12.6,52136,55459,83866,4665,3145,3529,0,98404,9191
40,23200,4023200,Edmond city, Oklahoma,1,2015,90090,43.5,74.3,12.2,45191,44899,71800,3631,3317,2273,37,83903,6187
40,41850,4041850,Lawton city, Oklahoma,1,2015,96659,48.8,75.6,9.7,51099,45560,55870,20690,3013,4510,405,82879,13780
40,52500,4052500,Norman city, Oklahoma,1,2015,120297,52,80.5,11,59483,60814,96299,3687,5341,3303,65,108565,11732
40,55000,4055000,Oklahoma City city, Oklahoma,1,2015,631263,42.1,74,12,309227,322036,426018,92592,29486,18320,545,513901,117362
40,75000,4075000,Tulsa city, Oklahoma,1,2015,403091,41.4,75.5,13.5,197437,205654,252987,61420,14180,18979,21,341874,61217
41,5350,4105350,Beaverton city, Oregon,1,2015,96577,46.1,78.8,11,47325,49252,77453,1735,8321,657,151,81125,15452
41,5800,4105800,Bend city, Oregon,1,2015,87017,39.4,76.8,15.5,42294,44723,80551,334,1120,378,0,78844,8173
41,23850,4123850,Eugene city, Oregon,1,2015,163448,49.6,82,14.9,79071,84377,136891,3589,5931,1463,264,146092,17356
41,31250,4131250,Gresham city, Oregon,1,2015,110582,40.4,75.5,13.5,53866,56716,89318,5837,3794,555,904,87006,23576
41,34100,4134100,Hillsboro city, Oregon,1,2015,102360,44.5,74.8,11.3,50926,51434,73977,2064,11233,1835,62,80191,22169
41,47000,4147000,Medford city, Oregon,1,2015,79795,37.3,76.6,16.6,39606,40189,72460,302,1027,335,351,65501,14294
41,59000,4159000,Portland city, Oregon,1,2015,632187,47.8,81.7,11.8,313516,318671,491427,36199,50253,4554,3483,571123,61064
41,64900,4164900,Salem city, Oregon,1,2015,164543,42.7,75.8,12.9,80839,83704,139523,2969,3566,2239,2240,125129,39414
42,2000,4202000,Allentown city, Pennsylvania,1,2015,120207,43.9,74.4,12.5,60626,59581,70022,18843,2326,384,491,61031,59176
42,6088,4206088,Bethlehem city, Pennsylvania,1,2015,74367,44.8,81,16.5,35861,38506,59387,3449,3025,84,0,50958,23409
42,24000,4224000,Erie city, Pennsylvania,1,2015,99470,41.6,76.8,13.2,48618,50852,73732,17115,2497,233,41,91611,7859
42,60000,4260000,Philadelphia city, Pennsylvania,1,2015,1567442,45.1,77.9,12.7,741270,826172,657151,664062,113162,5701,1403,1348404,219038
42,61000,4261000,Pittsburgh city, Pennsylvania,1,2015,304385,50.7,84.8,14.6,149690,154695,198438,73962,18101,145,79,295119,9266
42,63624,4263624,Reading city, Pennsylvania,1,2015,87873,44.4,70.6,9.9,43668,44205,51294,9447,861,4149,76,30841,57032
42,69000,4269000,Scranton city, Pennsylvania,1,2015,77112,41.1,80.1,17.5,37975,39137,64728,4746,3855,14,0,65811,11301
44,19180,4419180,Cranston city, Rhode Island,1,2015,81077,39.6,79.3,16.6,38365,42712,62309,5698,5187,364,0,70659,10418
44,54640,4454640,Pawtucket city, Rhode Island,1,2015,71583,40.8,80,14.6,36072,35511,45449,13656,1554,474,0,55466,16117
44,59000,4459000,Providence city, Rhode Island,1,2015,179204,51.1,76.7,9.6,89090,90114,92348,25498,10922,1646,211,101236,77968
44,74300,4474300,Warwick city, Rhode Island,1,2015,81698,37.8,81.6,19.1,39289,42409,74943,746,1868,0,0,76975,4723
45,13330,4513330,Charleston city, South Carolina,1,2015,135524,49.2,84,14.1,63956,71568,102039,29186,1721,81,0,131595,3929
45,16000,4516000,Columbia city, South Carolina,1,2015,133393,57.2,83,9.5,67686,65707,70223,55213,2482,0,368,125848,7545
45,48535,4548535,Mount Pleasant town, South Carolina,1,2015,81309,35.3,74.8,15.2,39429,41880,-998,-998,-998,-998,-998,78740,2569
45,50875,4550875,North Charleston city, South Carolina,1,2015,111864,46.9,74.3,9,56549,55315,47275,55160,3624,330,166,98889,12975
45,61405,4561405,Rock Hill city, South Carolina,1,2015,71567,45.5,77.5,12.5,33324,38243,40447,27622,1029,0,0,68722,2845
46,52980,4652980,Rapid City city, South Dakota,1,2015,73568,37.1,77.9,18.2,36122,37446,60421,456,1792,5974,0,70597,2971
46,59020,4659020,Sioux Falls city, South Dakota,1,2015,171530,43.9,75.8,12.2,86596,84934,145668,9251,3347,3808,11,162142,9388
47,14000,4714000,Chattanooga city, Tennessee,1,2015,176597,41.3,79.1,15.6,83640,92957,109636,56353,4027,534,63,165679,10918
47,15160,4715160,Clarksville city, Tennessee,1,2015,149190,50.6,73.9,7.5,75029,74161,98827,36178,4150,1101,659,133186,16004
47,27740,4727740,Franklin city, Tennessee,0,2015,72635,38.7,72.6,11.1,34991,37644,60352,7446,3344,0,0,67719,4916
47,37640,4737640,Jackson city, Tennessee,0,2015,66980,42.7,76.6,12.9,30007,36973,34538,29411,833,0,0,63597,3383
47,38320,4738320,Johnson City city, Tennessee,0,2015,65369,43.3,81.7,17.4,31019,34350,56679,4064,1557,73,0,64255,1114
47,40000,4740000,Knoxville city, Tennessee,1,2015,185312,49.8,82,12.4,89978,95334,140724,31513,3214,306,538,176672,8640
47,48000,4748000,Memphis city, Tennessee,1,2015,655760,42.2,75.1,12,312237,343523,194557,415300,13630,317,492,609139,46621
47,51560,4751560,Murfreesboro city, Tennessee,1,2015,126121,51.8,78.1,8.6,60704,65417,91738,18962,5814,128,0,117281,8840
47,52006,4752006,Nashville-Davidson metropolitan government (balance), Tennessee,1,2015,654596,46.7,78.7,10.9,314231,340365,415672,178975,20631,2694,76,587070,67526
48,1000,4801000,Abilene city, Texas,1,2015,125876,47.1,76.9,12.9,65212,60664,91254,12829,1695,959,0,92654,33222
48,1924,4801924,Allen city, Texas,1,2015,98138,40.2,71.4,7.9,51324,46814,67438,12163,14781,190,0,87523,10615
48,3000,4803000,Amarillo city, Texas,1,2015,199651,41.2,72.3,11.7,99391,100260,167592,10781,8037,1051,500,134259,65392
48,4000,4804000,Arlington city, Texas,1,2015,388122,45.8,73.7,9.3,191060,197062,242968,88887,28200,1499,523,276044,112078
48,4462,4804462,Atascocita CDP, Texas,0,2015,78240,42.1,70.5,10.4,37424,40816,49107,20990,1976,378,0,57799,20441
48,5000,4805000,Austin city, Texas,1,2015,931840,52.6,79.1,8.1,475718,456122,683349,70992,69994,2832,296,604160,327680
48,6128,4806128,Baytown city, Texas,1,2015,75485,41,74.9,12.1,37977,37508,45964,15622,2425,422,0,43813,31672
48,7000,4807000,Beaumont city, Texas,1,2015,118110,42.3,73.3,13.5,57326,60784,52665,57553,3474,586,0,99295,18815
48,10768,4810768,Brownsville city, Texas,1,2015,183888,42.7,68.3,11.2,87689,96199,173090,1018,593,991,35,13847,170041
48,10912,4810912,Bryan city, Texas,1,2015,82106,51.8,76.7,9.1,41761,40345,56109,10411,2388,439,27,52459,29647
48,13024,4813024,Carrollton city, Texas,1,2015,133146,41.8,75.2,10.1,66928,66218,99984,9634,17309,157,0,86296,46850
48,13552,4813552,Cedar Park city, Texas,0,2015,64837,43.4,67.6,7.2,31248,33589,54292,2767,4196,124,0,52965,11872
48,15976,4815976,College Station city, Texas,1,2015,107899,66.3,83.7,6.4,54125,53774,83071,10730,9948,37,27,90115,17784
48,16432,4816432,Conroe city, Texas,0,2015,68592,48.1,74,11.2,34907,33685,56980,6471,2099,535,0,44729,23863
48,17000,4817000,Corpus Christi city, Texas,1,2015,324082,42.4,75.3,12.9,160488,163594,288216,13773,7270,1665,84,123345,200737
48,19000,4819000,Dallas city, Texas,1,2015,1300082,45.6,74.2,9.6,639019,661063,813829,308787,40626,3756,141,750116,549966
48,19972,4819972,Denton city, Texas,1,2015,131047,52.4,80.2,11.9,62478,68569,103643,15181,6013,470,0,101697,29350
48,22660,4822660,Edinburg city, Texas,1,2015,84501,45.4,67.3,8,39422,45079,-998,-998,-998,-998,-998,9803,74698
48,24000,4824000,El Paso city, Texas,1,2015,681136,42.5,73.1,12.5,332797,348339,576280,29588,10041,4436,75,139119,542017
48,26232,4826232,Flower Mound town, Texas,0,2015,71024,36.6,72.2,7.5,35200,35824,59075,3009,5807,296,0,64875,6149
48,27000,4827000,Fort Worth city, Texas,1,2015,836969,43.7,71.8,9.2,414126,422843,554453,158652,34353,3379,296,540836,296133
48,27684,4827684,Frisco city, Texas,1,2015,154388,40.3,67.4,7.9,73989,80399,107397,8918,28379,1128,0,137295,17093
48,29000,4829000,Garland city, Texas,1,2015,236836,41.1,73.1,11,116406,120430,148892,36681,24141,1149,148,145847,90989
48,30464,4830464,Grand Prairie city, Texas,1,2015,187755,46.1,72.1,8.2,90811,96944,110643,51680,10541,705,99,102212,85543
48,32372,4832372,Harlingen city, Texas,0,2015,65769,39.7,67.6,13,32404,33365,-998,-998,-998,-998,-998,14042,51727
48,35000,4835000,Houston city, Texas,1,2015,2298628,46.6,74.4,9.6,1149686,1148942,1351048,512039,159292,6484,901,1270480,1028148
48,37000,4837000,Irving city, Texas,1,2015,236617,48.8,73.2,6.7,117189,119428,127979,27907,46414,1416,1000,138755,97862
48,39148,4839148,Killeen city, Texas,1,2015,140809,49.1,69.3,6.4,69442,71367,68172,49263,5210,574,2164,108209,32600
48,41464,4841464,Laredo city, Texas,1,2015,255789,43.7,66.7,8.9,124305,131484,244622,590,1884,736,0,12599,243190
48,41980,4841980,League City city, Texas,1,2015,98350,43,76.6,11.3,49354,48996,84120,3597,4206,148,0,83482,14868
48,42508,4842508,Lewisville city, Texas,1,2015,104808,48.6,72.6,7.4,52776,52032,67334,15414,11847,435,0,73051,31757
48,43888,4843888,Longview city, Texas,1,2015,81590,40.1,75.8,14.7,40065,41525,59285,18477,1418,0,0,63976,17614
48,45000,4845000,Lubbock city, Texas,1,2015,249051,48.9,76.3,11.5,122320,126731,200625,18389,6407,3798,40,158345,90706
48,45384,4845384,McAllen city, Texas,1,2015,140253,42.6,71.6,13.5,68332,71921,106149,3024,5252,176,200,26424,113829
48,45744,4845744,McKinney city, Texas,1,2015,162887,43.5,70.4,9.3,77339,85548,126288,15805,12056,1403,87,131182,31705
48,47892,4847892,Mesquite city, Texas,1,2015,145124,40.7,72.8,12.2,69240,75884,94717,35601,3654,1737,0,88371,56753
48,48072,4848072,Midland city, Texas,1,2015,132950,44.8,73.3,10.2,66595,66355,113150,9037,2455,267,58,74273,58677
48,48768,4848768,Mission city, Texas,1,2015,83307,41.4,66.7,10.6,40530,42777,-998,-998,-998,-998,-998,9940,73367
48,48804,4848804,Missouri City city, Texas,1,2015,71778,42.3,76.1,9.8,34932,36846,19531,27835,17013,82,453,61771,10007
48,50820,4850820,New Braunfels city, Texas,0,2015,69923,42.3,74.1,14.9,33071,36852,61830,2687,1021,202,0,47401,22522
48,52356,4852356,North Richland Hills city, Texas,0,2015,69205,34.7,77.2,16.5,35257,33948,56554,4471,4702,426,953,59010,10195
48,53388,4853388,Odessa city, Texas,1,2015,118980,44.8,71.2,10.7,61119,57861,103422,5350,1791,206,0,55394,63586
48,56000,4856000,Pasadena city, Texas,1,2015,153786,41.5,69.4,10,78827,74959,138320,5135,1512,1510,54,47915,105871
48,56348,4856348,Pearland city, Texas,1,2015,111665,44.4,72.2,8.3,52336,59329,70772,22385,13255,753,0,85205,26460
48,57200,4857200,Pharr city, Texas,1,2015,76535,41.8,62.6,11,35242,41293,-998,-998,-998,-998,-998,3540,72995
48,58016,4858016,Plano city, Texas,1,2015,283619,40.6,76.8,11.2,138565,145054,189774,22521,57564,2413,407,240660,42959
48,61796,4861796,Richardson city, Texas,1,2015,110827,42.8,77.7,13.9,54676,56151,73495,12458,19266,442,0,95065,15762
48,63500,4863500,Round Rock city, Texas,1,2015,115839,45.1,72.6,7.7,56646,59193,87312,10946,8258,546,0,78688,37151
48,64472,4864472,San Angelo city, Texas,1,2015,100413,44.5,76.6,13.8,49669,50744,85141,5718,1585,235,242,57919,42494
48,65000,4865000,San Antonio city, Texas,1,2015,1469824,44.5,74.6,11.6,721405,748419,1203964,106383,43236,12233,1754,532217,937607
48,70808,4870808,Sugar Land city, Texas,1,2015,88129,36,78.2,13.7,43889,44240,43575,8522,33081,47,0,80294,7835
48,72176,4872176,Temple city, Texas,0,2015,72297,41.4,73.5,13.8,33512,38785,51316,13403,1164,145,54,50925,21372
48,72656,4872656,The Woodlands CDP, Texas,0,2015,119144,35.8,69.9,11.2,56083,63061,101472,4945,6384,176,0,99570,19574
48,74144,4874144,Tyler city, Texas,1,2015,103705,42.8,77.5,15.3,50422,53283,71429,25271,2175,525,5,82169,21536
48,75428,4875428,Victoria city, Texas,0,2015,67581,40.3,75.3,15.3,32290,35291,57079,4517,1102,40,0,33172,34409
48,76000,4876000,Waco city, Texas,1,2015,132342,46.9,76.1,12.8,63452,68890,94181,28650,3807,260,0,91757,40585
48,79000,4879000,Wichita Falls city, Texas,1,2015,104709,46.1,78.6,11.9,55775,48934,79758,12717,3263,829,27,81648,23061
49,43660,4943660,Layton city, Utah,1,2015,74142,46.5,68.5,7.9,37748,36394,62196,1135,1646,138,809,64019,10123
49,55980,4955980,Ogden city, Utah,1,2015,85450,46.3,74.3,9.9,44323,41127,71725,1502,1230,618,111,57175,28275
49,57300,4957300,Orem city, Utah,1,2015,94457,48.2,70.4,10,48695,45762,82523,735,2162,282,1172,76115,18342
49,62470,4962470,Provo city, Utah,1,2015,115258,64.9,77,5.4,56231,59027,103725,436,1983,614,1166,98590,16668
49,65330,4965330,St. George city, Utah,1,2015,80207,38.6,75.8,21,38732,41475,69691,1198,601,1349,676,69378,10829
49,67000,4967000,Salt Lake City city, Utah,1,2015,192660,50.7,80.2,11.6,98364,94296,145243,4558,10374,2026,2757,152101,40559
49,67440,4967440,Sandy city, Utah,1,2015,93612,40.9,71.6,10,46923,46689,82310,331,4046,225,390,86780,6832
49,70850,4970850,South Jordan city, Utah,0,2015,66639,40.3,67.1,9.8,33669,32970,-998,-998,-998,-998,-998,61967,4672
49,82950,4982950,West Jordan city, Utah,1,2015,111942,44.8,67.8,5.8,57898,54044,97241,2565,2815,544,363,90627,21315
49,83470,4983470,West Valley City city, Utah,1,2015,136224,45.6,70.3,8.8,68235,67989,84514,2851,8767,3142,5863,92144,44080
51,1000,5101000,Alexandria city, Virginia,1,2015,153511,49.2,82.1,10.4,74989,78522,97333,31470,10137,280,0,127938,25573
51,3000,5103000,Arlington CDP, Virginia,0,2015,229164,53,82.5,9.5,113981,115183,165282,20354,24290,160,202,193253,35911
51,14440,5114440,Centreville CDP, Virginia,0,2015,71782,44.7,78.2,8.2,34749,37033,36167,5462,22402,0,0,62169,9613
51,16000,5116000,Chesapeake city, Virginia,1,2015,235429,41.1,75.8,12.3,114964,120465,144648,70444,8441,506,294,222470,12959
51,21088,5121088,Dale City CDP, Virginia,0,2015,71399,46,72.6,7.6,35984,35415,31626,16235,7836,454,215,47531,23868
51,35000,5135000,Hampton city, Virginia,1,2015,136454,42.4,78.9,14.2,66214,70240,58494,67048,3407,817,167,128941,7513
51,47672,5147672,Lynchburg city, Virginia,1,2015,79812,50.1,80.6,13.9,38614,41198,52055,22715,2339,219,0,77123,2689
51,56000,5156000,Newport News city, Virginia,1,2015,182385,44.9,76.6,12,88385,94000,88771,73574,6629,346,308,166605,15780
51,57000,5157000,Norfolk city, Virginia,1,2015,246393,51,79.8,10.2,128917,117476,120510,102513,9488,1425,159,227633,18760
51,64000,5164000,Portsmouth city, Virginia,1,2015,96201,42.3,76,13.8,45900,50301,39779,50543,530,471,0,92305,3896
51,67000,5167000,Richmond city, Virginia,1,2015,220289,48.8,81.8,11.5,104793,115496,98864,104583,4866,2276,112,206030,14259
51,68000,5168000,Roanoke city, Virginia,1,2015,99897,40.1,78.3,15.3,47252,52645,64887,27458,2673,27,0,93806,6091
51,76432,5176432,Suffolk city, Virginia,1,2015,88161,38.8,75.4,13.6,43048,45113,45880,37780,1880,454,0,84622,3539
51,82000,5182000,Virginia Beach city, Virginia,1,2015,452745,43.5,77.4,12.6,222684,230061,304039,88810,28670,1096,252,416436,36309
53,3180,5303180,Auburn city, Washington,1,2015,76580,40.8,78.1,12.8,36837,39743,52577,2213,9115,988,572,65744,10836
53,5210,5305210,Bellevue city, Washington,1,2015,139814,43,79.8,14.4,70763,69051,75920,3120,47900,468,270,127599,12215
53,5280,5305280,Bellingham city, Washington,1,2015,85143,53.2,84.6,15.2,41286,43857,70213,934,5927,1499,456,78177,6966
53,22640,5322640,Everett city, Washington,1,2015,108012,44.4,79.2,13.5,56212,51800,81436,4252,8073,1091,1987,92123,15889
53,23515,5323515,Federal Way city, Washington,1,2015,95188,41.6,77.2,13.3,49151,46037,54131,12783,13105,415,3490,81139,14049
53,35275,5335275,Kennewick city, Washington,1,2015,78903,43.9,71.4,11.2,38492,40411,59473,232,1347,344,84,59508,19395
53,35415,5335415,Kent city, Washington,1,2015,126962,46.9,75.3,10,61825,65137,62959,16852,23958,1681,1461,105034,21928
53,35940,5335940,Kirkland city, Washington,0,2015,87267,42.1,81.6,15,42159,45108,67073,761,12655,207,294,80547,6720
53,43955,5343955,Marysville city, Washington,0,2015,66773,45.5,75.2,9.8,33436,33337,54367,618,4114,453,172,59631,7142
53,53545,5353545,Pasco city, Washington,0,2015,68097,44.6,65.5,7.2,35298,32799,52859,1540,1662,95,30,29214,38883
53,57745,5357745,Renton city, Washington,1,2015,100247,43.3,74.8,10.3,52779,47468,53268,10026,19417,412,1133,84855,15392
53,63000,5363000,Seattle city, Washington,1,2015,684443,51.9,85.4,11.3,345659,338784,473045,50190,96669,4165,1098,641383,43060
53,67000,5367000,Spokane city, Washington,1,2015,213267,42,78.5,15.3,102756,110511,182906,4564,5463,3420,1810,199902,13365
53,67167,5367167,Spokane Valley city, Washington,1,2015,94908,38.3,75.6,15.2,49933,44975,88181,676,853,988,285,89798,5110
53,70000,5370000,Tacoma city, Washington,1,2015,207950,42.6,79.8,14.4,100914,107036,135512,22326,20997,1217,1767,182186,25764
53,74060,5374060,Vancouver city, Washington,1,2015,172853,40.8,76,14.7,82958,89895,141157,4312,7864,1149,1202,149669,23184
53,80010,5380010,Yakima city, Washington,1,2015,93700,39.4,72.6,15.1,45147,48553,76610,717,1202,1360,0,49528,44172
55,2375,5502375,Appleton city, Wisconsin,1,2015,75255,42.4,76.2,13.6,37217,38038,63023,2390,5076,665,39,70116,5139
55,22300,5522300,Eau Claire city, Wisconsin,0,2015,67433,49.8,81.9,13.3,32327,35106,61486,503,4157,495,36,65945,1488
55,31000,5531000,Green Bay city, Wisconsin,1,2015,105221,43.7,75.2,12.9,52517,52704,77681,3660,4459,4319,28,88435,16786
55,39225,5539225,Kenosha city, Wisconsin,1,2015,99856,40.6,74.4,12.4,49349,50507,82287,10199,2006,604,0,81084,18772
55,48000,5548000,Madison city, Wisconsin,1,2015,248956,55.2,82.8,11,122596,126360,195502,16770,20560,809,83,229259,19697
55,53000,5553000,Milwaukee city, Wisconsin,1,2015,600154,45.9,74,10,286315,313839,276965,233019,22748,3351,274,489819,110335
55,60500,5560500,Oshkosh city, Wisconsin,0,2015,66557,50,80.8,13.6,32905,33652,59764,2555,3182,149,0,64585,1972
55,66000,5566000,Racine city, Wisconsin,1,2015,77737,39.5,72.6,11.6,39314,38423,48605,17738,690,73,0,59522,18215
55,84250,5584250,Waukesha city, Wisconsin,1,2015,71976,45.5,79,11.9,36263,35713,64380,1197,1758,169,132,62263,9713
72,10334,7210334,Caguas zona urbana, Puerto Rico,0,2015,77008,39,80.1,21,34743,42265,56613,8251,110,165,0,659,76349
72,14290,7214290,Carolina zona urbana, Puerto Rico,0,2015,142066,38.9,80.3,20.4,64758,77308,84326,25590,197,2015,0,2099,139967
72,32522,7232522,Guaynabo zona urbana, Puerto Rico,0,2015,70492,38,80.5,18.9,33066,37426,56571,3511,0,383,0,556,69936
72,63820,7263820,Ponce zona urbana, Puerto Rico,0,2015,121583,37.1,78.1,20.3,56968,64615,94213,6500,169,0,0,878,120705
72,76770,7276770,San Juan zona urbana, Puerto Rico,0,2015,342237,38.6,80.6,20.3,155408,186829,250387,34921,2329,2994,0,6678,335559
6,62938,662938,Roseville city, California,1,2015,130282,40.3,77,15.6,62591,67691,97065,3012,14306,622,573,106783,23499
6,64000,664000,Sacramento city, California,1,2015,490715,44.6,75.4,12.7,237724,252991,243803,64416,89843,3663,5427,340562,150153
6,64224,664224,Salinas city, California,1,2015,157386,43.1,68.8,8.8,77765,79621,91528,1387,8974,1736,124,36190,121196
6,65000,665000,San Bernardino city, California,1,2015,216137,44.5,69.3,8.4,108671,107466,115593,30844,11001,1902,1173,79923,136214
6,65042,665042,San Buenaventura (Ventura) city, California,1,2015,109717,39.1,78.3,15.4,53932,55785,91617,558,4144,838,481,71254,38463
6,65084,665084,San Clemente city, California,0,2015,65532,34.4,81.4,19.1,34076,31456,56224,71,2388,0,0,55111,10421
6,66000,666000,San Diego city, California,1,2015,1394907,47.4,79.6,11.8,693826,701081,890706,94235,225120,3780,6495,969493,425414
6,67000,667000,San Francisco city, California,1,2015,864816,48.3,86.6,14.6,439752,425064,409361,44843,301034,2945,3769,732702,132114
6,68000,668000,San Jose city, California,1,2015,1026919,42.6,77,11.8,518317,508602,401920,31414,358104,5454,3153,695687,331232
6,68084,668084,San Leandro city, California,1,2015,90711,38.8,80.6,16.6,43032,47679,35537,9004,32026,533,354,63817,26894
6,68196,668196,San Marcos city, California,1,2015,92934,43.7,74,11,45246,47688,69040,3983,9666,211,811,57770,35164
6,68252,668252,San Mateo city, California,1,2015,103524,41.1,79.4,14.2,50966,52558,58158,1994,26126,279,2548,80373,23151
6,68378,668378,San Ramon city, California,1,2015,76132,37.3,69.5,10.2,39221,36911,33159,1957,35289,435,191,70683,5449
6,69000,669000,Santa Ana city, California,1,2015,335423,46.5,71,8.3,167503,167920,158061,4801,36204,2868,1184,72987,262436
6,69070,669070,Santa Barbara city, California,1,2015,91852,45.1,84,18.7,45068,46784,71244,1553,4386,457,0,60750,31102
6,69084,669084,Santa Clara city, California,1,2015,126216,49.8,81.1,11.1,63278,62938,51802,3654,54774,669,2824,103814,22402
6,69088,669088,Santa Clarita city, California,1,2015,182367,40.2,77.4,13.3,90192,92175,135625,6821,19860,989,73,125423,56944
6,69196,669196,Santa Maria city, California,1,2015,105082,45.3,67.2,9.4,53320,51762,88586,813,4778,433,0,23531,81551
6,70000,670000,Santa Monica city, California,1,2015,93219,46.6,85.5,16.2,46732,46487,65561,8727,10972,227,53,78246,14973
6,70098,670098,Santa Rosa city, California,1,2015,174989,39.8,77.7,15.9,86840,88149,126671,3901,8973,2329,620,120411,54578
6,72016,672016,Simi Valley city, California,1,2015,126766,40.1,77,11.8,63243,63523,102117,1217,12063,533,0,92734,34032
6,73080,673080,South Gate city, California,1,2015,96399,46.2,73.1,8.8,47758,48641,54464,1163,566,233,279,5087,91312
6,73262,673262,South San Francisco city, California,0,2015,67271,40.4,79.6,16.5,34177,33094,25141,1658,21420,0,1154,38098,29173
6,75000,675000,Stockton city, California,1,2015,305650,42.1,72.6,12.7,150976,154674,140690,32533,66745,1604,1265,177434,128216
6,77000,677000,Sunnyvale city, California,1,2015,151760,47.2,78.2,12.6,79480,72280,65940,3391,64936,39,2247,126122,25638
6,78120,678120,Temecula city, California,1,2015,112026,40.5,72,11,54407,57619,78958,4245,10602,1054,229,75780,36246
6,78582,678582,Thousand Oaks city, California,1,2015,129329,32.8,78,18.6,65113,64216,103536,3229,13483,549,5,102575,26754
6,80000,680000,Torrance city, California,1,2015,148468,37.7,79.8,16.1,73209,75259,72417,4596,48727,1282,1469,122769,25699
6,80238,680238,Tracy city, California,1,2015,87093,43,73.7,8.8,43156,43937,52157,3884,14495,402,394,54283,32810
6,80812,680812,Turlock city, California,1,2015,72293,42.3,72.5,14.7,33190,39103,56599,1739,3976,520,0,48734,23559
6,80854,680854,Tustin city, California,1,2015,80563,43.9,74.3,9.5,39511,41052,36003,1812,13813,40,97,46565,33998
6,81204,681204,Union City city, California,1,2015,74510,41.6,81.2,15,38599,35911,14762,4924,42037,34,1653,61303,13207
6,81344,681344,Upland city, California,1,2015,76447,38.2,79.7,16.2,36226,40221,43368,4846,7442,207,0,45660,30787
6,81554,681554,Vacaville city, California,1,2015,96794,42.7,76,12.4,50091,46703,59975,14032,6100,728,127,73399,23395
6,81666,681666,Vallejo city, California,1,2015,121269,40.7,80.2,15.5,58379,62890,50511,23995,30069,437,1839,92292,28977
6,82590,682590,Victorville city, California,1,2015,122236,44.1,68.5,10.2,60989,61247,79737,20295,5017,669,45,61667,60569
6,82954,682954,Visalia city, California,1,2015,130094,40.9,71.5,11.8,63695,66399,102875,1485,8819,768,221,66612,63482
6,82996,682996,Vista city, California,1,2015,100884,43.6,71.5,10.3,50680,50204,79998,4369,5780,70,35,51360,49524
6,83346,683346,Walnut Creek city, California,0,2015,68906,31.3,80.9,27.8,31994,36912,55283,1427,9338,0,139,63694,5212
6,84200,684200,West Covina city, California,1,2015,108489,41.2,79.4,15,51629,56860,44103,2929,29485,255,268,49582,58907
6,84550,684550,Westminster city, California,1,2015,92111,39,81.7,17.3,45538,46573,34249,1365,44685,420,100,73000,19111
6,85292,685292,Whittier city, California,1,2015,87436,44,78.7,12.8,44397,43039,46699,1161,2880,451,83,26187,61249
6,86832,686832,Yorba Linda city, California,0,2015,67966,32.6,77.4,16.5,31960,36006,-998,-998,-998,-998,-998,57367,10599
6,86972,686972,Yuba City city, California,0,2015,66944,40.4,72.6,15.2,33654,33290,44313,923,12948,404,336,46054,20890
8,3455,803455,Arvada city, Colorado,1,2015,115035,36.8,78.3,15.3,54870,60165,104375,2227,1837,1451,0,98616,16419
8,4000,804000,Aurora city, Colorado,1,2015,358870,43.7,74.2,10.4,177899,180971,222860,53055,17277,2842,1311,249474,109396
8,7850,807850,Boulder city, Colorado,1,2015,107342,59.9,88.5,12.1,56342,51000,94743,1145,6635,238,92,97547,9795
8,9280,809280,Broomfield city, Colorado,0,2015,65065,41.5,75.6,12.4,31755,33310,56289,564,4476,43,0,57000,8065
8,12815,812815,Centennial city, Colorado,1,2015,109726,36.2,77.7,16.2,53222,56504,95222,3427,5459,496,60,101640,8086
8,16000,816000,Colorado Springs city, Colorado,1,2015,456562,43.5,76.4,13.3,225544,231018,355816,30144,14885,3128,1266,377851,78711
8,20000,820000,Denver city, Colorado,1,2015,682545,49.1,79.4,11.1,341137,341408,526428,64692,23327,6897,474,474698,207847
8,27425,827425,Fort Collins city, Colorado,1,2015,161181,54.7,81.7,10,80893,80288,144423,2184,5283,832,43,145660,15521
8,32155,832155,Greeley city, Colorado,1,2015,100883,46.3,73.5,12.9,50792,50091,90728,1941,1832,1433,61,61612,39271
8,36410,836410,Highlands Ranch CDP, Colorado,0,2015,102467,36.7,71.3,10.2,49186,53281,91815,822,4551,67,100,94074,8393
8,43000,843000,Lakewood city, Colorado,1,2015,152589,42.8,80.5,15.3,76013,76576,134398,1894,5774,753,0,118959,33630
8,45970,845970,Longmont city, Colorado,1,2015,92221,38.2,74.2,13.4,43941,48280,83590,808,1767,788,0,67375,24846
8,46465,846465,Loveland city, Colorado,1,2015,75188,38,74.9,17.7,37042,38146,69889,795,878,68,306,61621,13567
8,62000,862000,Pueblo city, Colorado,1,2015,109419,39.2,77.3,17.5,55635,53784,81692,2983,1099,6397,0,51840,57579
8,77290,877290,Thornton city, Colorado,1,2015,133459,43.7,70.2,8.6,65482,67977,115872,2776,5837,1810,83,84218,49241
8,83835,883835,Westminster city, Colorado,1,2015,113117,42.7,80,14,54866,58251,96987,2198,7342,346,228,89762,23355
9,8000,908000,Bridgeport city, Connecticut,1,2015,147619,45.5,76.6,10.3,71509,76110,62424,48203,5897,221,71,88583,59036
9,18430,918430,Danbury city, Connecticut,1,2015,84662,46.6,81.5,13.7,43435,41227,52407,7058,6007,227,130,59517,25145
9,37000,937000,Hartford city, Connecticut,1,2015,124014,48.8,76.2,10,58042,65972,42789,47143,3776,976,0,68055,55959
9,50370,950370,New Britain city, Connecticut,1,2015,72809,43.7,75.2,11.5,37350,35459,53698,8255,1818,0,0,42621,30188
9,52000,952000,New Haven city, Connecticut,1,2015,130310,54,77.1,8.9,63765,66545,53861,40251,6855,537,0,86747,43563
9,55990,955990,Norwalk city, Connecticut,1,2015,88483,38.7,81.5,14.8,40880,47603,66738,14667,2583,48,0,63801,24682
9,73000,973000,Stamford city, Connecticut,1,2015,128877,45.8,78.9,12.3,64941,63936,83375,21738,9889,0,0,95680,33197
9,80000,980000,Waterbury city, Connecticut,1,2015,108807,42.3,75.7,12.3,52235,56572,66997,25345,3719,223,0,70585,38222
10,77580,1077580,Wilmington city, Delaware,1,2015,71957,41.7,76.8,12.9,32680,39277,22849,43346,1107,177,0,66441,5516
11,50000,1150000,Washington city, District of Columbia,1,2015,672228,51.5,82.5,11.4,319705,352523,269143,318831,25944,1661,475,601099,71129
12,410,1200410,Alafaya CDP, Florida,0,2015,85264,49.6,74.5,10.6,39504,45760,62633,5979,9545,0,0,50367,34897
12,7300,1207300,Boca Raton city, Florida,1,2015,93226,35,84.1,23.8,44760,48466,78273,3915,1872,0,0,78491,14735
12,7875,1207875,Boynton Beach city, Florida,1,2015,73972,33.4,81.9,23.8,33701,40271,48986,19444,1886,42,0,61419,12553
12,8150,1208150,Brandon CDP, Florida,0,2015,113968,44.2,79.2,12.2,55679,58289,77700,21873,8661,221,0,87744,26224
12,10275,1210275,Cape Coral city, Florida,1,2015,175230,35.3,80.8,20.7,85626,89604,160971,6834,2313,134,0,142214,33016
12,12875,1212875,Clearwater city, Florida,1,2015,112979,34.5,83.1,23.4,55225,57754,95058,11469,2156,19,455,95768,17211
12,14400,1214400,Coral Springs city, Florida,1,2015,129502,41.3,72.6,10.1,63316,66186,87562,25860,5359,146,125,88685,40817
12,16475,1216475,Davie town, Florida,1,2015,100894,43.1,82.3,12,48754,52140,78456,10313,3912,247,341,65583,35311
12,16725,1216725,Deerfield Beach city, Florida,1,2015,79769,41.9,83.5,22.1,37155,42614,50932,23792,1073,52,54,67040,12729
12,17100,1217100,Delray Beach city, Florida,0,2015,66261,35.3,86.5,28.2,32219,34042,39939,20422,926,56,297,59864,6397
12,17200,1217200,Deltona city, Florida,1,2015,88474,37.4,77,16.7,44853,43621,72517,10597,390,0,0,57117,31357
12,24000,1224000,Fort Lauderdale city, Florida,1,2015,178587,36.4,80.1,17.1,93948,84639,106090,60732,3251,218,97,150439,28148
12,24125,1224125,Fort Myers city, Florida,0,2015,74015,40.4,80.8,18.4,36850,37165,48937,16783,3216,0,0,56149,17866
12,25175,1225175,Gainesville city, Florida,1,2015,130133,60.8,85.9,10.7,60803,69330,83842,29840,11202,466,119,117925,12208
12,30000,1230000,Hialeah city, Florida,1,2015,237082,38,81.6,19.7,111530,125552,219076,5100,1012,71,0,9574,227508
12,32000,1232000,Hollywood city, Florida,1,2015,149721,37.1,79.3,16.1,75358,74363,101663,29681,3555,371,108,96474,53247
12,32275,1232275,Homestead city, Florida,0,2015,66500,42.5,69,7.8,31401,35099,46807,16199,109,0,0,24590,41910
12,35000,1235000,Jacksonville city, Florida,1,2015,868031,42,76.7,12.7,419203,448828,518114,268763,39933,1220,1121,787967,80064
12,36100,1236100,Kendall CDP, Florida,0,2015,76466,43.9,82.7,16.5,36658,39808,69695,2429,3364,0,0,28945,47521
12,36950,1236950,Kissimmee city, Florida,0,2015,69152,45.2,77.7,11.7,33283,35869,49689,5684,2571,0,0,25032,44120
12,38250,1238250,Lakeland city, Florida,1,2015,104410,38.7,78,19.1,47840,56570,74187,23980,2872,216,0,87909,16501
12,39425,1239425,Largo city, Florida,1,2015,81007,33.7,82.4,22.8,38166,42841,70728,4406,2106,602,0,71446,9561
12,39550,1239550,Lauderhill city, Florida,1,2015,71574,41.6,76.8,14.4,32813,38761,9297,56591,998,179,0,65485,6089
12,39925,1239925,Lehigh Acres CDP, Florida,0,2015,119480,39.4,71.7,12.9,57856,61624,82392,27683,888,68,0,77388,42092
12,43975,1243975,Melbourne city, Florida,1,2015,80136,36.7,81.7,22,39180,40956,62581,9874,4145,34,0,74076,6060
12,45000,1245000,Miami city, Florida,1,2015,440989,42,82.9,17,215840,225149,331087,83318,2631,216,224,121047,319942
12,45025,1245025,Miami Beach city, Florida,1,2015,92311,41.9,85.7,17.3,48090,44221,70792,3503,2555,46,0,44865,47446
12,45060,1245060,Miami Gardens city, Florida,1,2015,113199,41.1,75.2,14.1,50719,62480,-998,-998,-998,-998,-998,89912,23287
12,45975,1245975,Miramar city, Florida,1,2015,137115,42.8,74.9,10.6,66157,70958,56441,63399,10844,72,0,90348,46767
12,53000,1253000,Orlando city, Florida,1,2015,270917,50.4,79.7,10.2,130940,139977,172492,63894,8734,929,0,181611,89306
12,54000,1254000,Palm Bay city, Florida,1,2015,107895,34.8,76.4,19.5,51767,56128,81888,19093,656,923,0,91054,16841
12,54200,1254200,Palm Coast city, Florida,1,2015,82121,30.3,80.7,29.1,39489,42632,65209,10183,2058,325,0,73415,8706
12,55775,1255775,Pembroke Pines city, Florida,1,2015,166624,39.9,79.2,15.7,77050,89574,110866,31573,11620,471,27,106105,60519
12,56825,1256825,Pine Hills CDP, Florida,0,2015,76081,46.2,69.9,9.2,35344,40737,9264,55689,2032,253,0,65585,10496
12,57425,1257425,Plantation city, Florida,1,2015,92555,35.6,78.4,16,42881,49674,65097,17927,2883,100,0,66154,26401
12,57900,1257900,Poinciana CDP, Florida,0,2015,73943,44.9,76.1,13.5,38142,35801,42780,23569,796,1187,0,36561,37382
12,58050,1258050,Pompano Beach city, Florida,1,2015,107771,36.7,80.2,21.2,56569,51202,64605,36879,1089,446,0,84546,23225
12,58715,1258715,Port St. Lucie city, Florida,1,2015,179410,36.3,77.8,20.1,84069,95341,132849,28856,4831,1254,0,145170,34240
12,60950,1260950,Riverview CDP, Florida,0,2015,89746,45.2,70.8,9.2,44210,45536,58136,14105,2241,152,0,66429,23317
12,63000,1263000,St. Petersburg city, Florida,1,2015,257088,39.2,81.2,17.6,123524,133564,173419,63792,9671,719,128,236605,20483
12,68350,1268350,Spring Hill CDP, Florida,0,2015,103197,33.7,80.2,23.8,48295,54902,89482,6813,1866,49,78,87359,15838
12,69700,1269700,Sunrise city, Florida,1,2015,92706,41.8,78.5,15,41471,51235,52759,32714,2929,0,0,63543,29163
12,70600,1270600,Tallahassee city, Florida,1,2015,189894,59.6,83.7,9.2,89390,100504,108384,65887,8354,204,101,176356,13538
12,71000,1271000,Tampa city, Florida,1,2015,369028,45.3,78.2,11.5,175517,193511,249668,86460,12609,855,0,273874,95154
12,71625,1271625,The Villages CDP, Florida,0,2015,-998,-999999999,-999999999,-999999999,-998,-998,-998,-998,-998,-998,-998,71524,1066
12,72145,1272145,Town 'n' Country CDP, Florida,0,2015,78996,43.3,79.8,14.2,39410,39586,62046,7477,3154,537,0,41052,37944
12,76582,1276582,Weston city, Florida,0,2015,69947,35.5,69.7,12.2,32956,36991,59988,3305,3843,83,38,33260,36687
12,76600,1276600,West Palm Beach city, Florida,1,2015,106782,41.9,81.8,17,49262,57520,59541,38472,2986,0,0,80650,26132
13,1052,1301052,Albany city, Georgia,1,2015,71109,41.7,75.6,12.8,31695,39414,16714,52909,461,340,4,69326,1783
13,3440,1303440,Athens-Clarke County unified government (balance), Georgia,1,2015,122563,57.7,82.6,9.7,57415,65148,77353,33239,4998,58,257,109404,13159
13,4000,1304000,Atlanta city, Georgia,1,2015,463875,51.2,82.1,11.8,223960,239915,189153,240599,20416,1303,463,445222,18653
13,4204,1304204,Augusta-Richmond County consolidated government (balance), Georgia,1,2015,196579,42.9,76.7,13.1,94662,101917,74229,110075,3770,469,0,187511,9068
13,19000,1319000,Columbus city, Georgia,1,2015,200579,44.3,75.8,12.3,98785,101794,90995,90408,4487,676,665,185399,15180
13,42425,1342425,Johns Creek city, Georgia,1,2015,83339,39.2,71.8,9.3,40282,43057,46676,10477,22769,531,0,77415,5924
13,49008,1349008,Macon-Bibb County, Georgia,0,2015,153459,39.4,75.1,14.4,71833,81626,63165,84206,2898,195,0,148562,4897
13,67284,1367284,Roswell city, Georgia,1,2015,94496,37.9,73.3,9.9,48637,45859,67622,14020,6440,462,0,77576,16920
13,68516,1368516,Sandy Springs city, Georgia,1,2015,105347,44.2,76.9,14,48570,56777,77402,14298,7298,1073,0,91677,13670
13,69000,1369000,Savannah city, Georgia,1,2015,145684,48.8,78.7,11.7,69389,76295,53948,79319,4881,848,0,135950,9734
13,80508,1380508,Warner Robins city, Georgia,1,2015,74002,43.7,72.5,10.6,35093,38909,39114,27651,2166,170,0,68624,5378
15,71550,1571550,Urban Honolulu CDP, Hawaii,0,2015,352766,41,83.9,19.1,176807,175959,67139,6660,193580,358,22750,328180,24586
16,8830,1608830,Boise City city, Idaho,1,2015,218280,44.9,76.2,11.8,110099,108181,197253,3227,6733,1375,124,198800,19480
16,52120,1652120,Meridian city, Idaho,1,2015,90753,35.5,72.5,16.7,43353,47400,83313,1809,2166,492,336,84157,6596
16,56260,1656260,Nampa city, Idaho,1,2015,89850,42.5,68.9,10.7,45651,44199,76866,238,721,676,694,67784,22066
17,2154,1702154,Arlington Heights village, Illinois,1,2015,76996,31.8,80.1,20.8,37627,39369,65211,1127,9019,46,117,74254,2742
17,3012,1703012,Aurora city, Illinois,1,2015,203715,44.8,69.4,7.7,101964,101751,112341,20846,15900,633,0,117062,86653
17,6613,1706613,Bloomington city, Illinois,1,2015,78295,45.2,77.9,12.5,37972,40323,59378,10421,5673,77,0,74834,3461
17,7133,1707133,Bolingbrook village, Illinois,1,2015,72096,44.1,72.8,9,36295,35801,38698,11770,8636,67,0,55192,16904
17,12385,1712385,Champaign city, Illinois,1,2015,86086,56,85.2,9.4,43326,42760,56335,15141,10804,55,0,82071,4015
1,7000,107000,Birmingham city, Alabama,1,2016,213434,43.4,78.8,14.1,100602,112832,52557,152114,1429,490,0,205831,7603
1,21184,121184,Dothan city, Alabama,0,2016,67714,37.8,76.5,16.9,32089,35625,41231,23682,977,201,0,65770,1944
1,35896,135896,Hoover city, Alabama,1,2016,84943,41,74.5,14.8,40646,44297,60222,14217,5477,381,69,78520,6423
1,37000,137000,Huntsville city, Alabama,1,2016,196225,41.6,76.5,14.6,96482,99743,118960,61834,5452,1148,250,183834,12391
1,50000,150000,Mobile city, Alabama,1,2016,192895,43,79.9,16.6,92787,100108,89571,96103,3555,289,20,188007,4888
1,51000,151000,Montgomery city, Alabama,1,2016,200024,42,76.5,13.6,94034,105990,66047,120280,5469,339,0,192750,7274
1,77256,177256,Tuscaloosa city, Alabama,1,2016,99556,53,81.7,11.2,46721,52835,50247,45012,2518,34,0,97119,2437
2,3000,203000,Anchorage municipality, Alaska,1,2016,298192,45.3,75.2,9.8,152882,145310,184841,16102,27142,23916,7669,271285,26907
4,4720,404720,Avondale city, Arizona,1,2016,82875,44.7,71.9,9.9,41915,40960,52485,8007,3049,2811,142,40966,41909
4,10670,410670,Casas Adobes CDP, Arizona,0,2016,70589,38.2,82.5,19.7,33958,36631,56299,1887,1930,949,0,48369,22220
4,12000,412000,Chandler city, Arizona,1,2016,247459,43.7,74.5,10.5,123184,124275,192384,13397,21216,4798,93,196944,50515
4,23620,423620,Flagstaff city, Arizona,0,2016,71455,60.1,83.1,8.3,35760,35695,56854,1804,2217,6074,163,57742,13713
4,27400,427400,Gilbert town, Arizona,1,2016,237120,42,68.6,9.2,115040,122080,200099,9482,12422,1284,945,199843,37277
4,27820,427820,Glendale city, Arizona,1,2016,245849,42.3,76.2,12,121450,124399,191090,18925,9289,3923,0,154977,90872
4,28380,428380,Goodyear city, Arizona,0,2016,77266,38.7,73.3,14.1,37699,39567,54820,8683,2706,657,230,56546,20720
4,46000,446000,Mesa city, Arizona,1,2016,484622,40.8,75.5,16.3,238380,246242,394155,18359,9735,16166,3037,353981,130641
4,54050,454050,Peoria city, Arizona,1,2016,164198,35.7,76.3,17.4,80214,83984,139418,6083,7115,537,142,136133,28065
4,55000,455000,Phoenix city, Arizona,1,2016,1615041,43.8,73,10.4,801784,813257,1094662,105572,62518,31693,2728,907949,707092
4,64210,464210,San Tan Valley CDP, Arizona,0,2016,82911,38.3,73.3,15.8,42051,40860,70508,4109,4352,434,117,64818,18093
4,65000,465000,Scottsdale city, Arizona,1,2016,246646,33.5,84.3,24.2,120633,126013,220371,2391,11301,1219,76,222578,24068
4,71510,471510,Surprise city, Arizona,1,2016,132673,33.2,75,23.2,63627,69046,111199,7564,4623,72,399,109170,23503
4,73000,473000,Tempe city, Arizona,1,2016,182499,57.2,86.2,10.4,94223,88276,120498,15599,16777,3728,646,148935,33564
4,77000,477000,Tucson city, Arizona,1,2016,530690,45.6,78.4,13.8,262581,268109,392894,26295,16571,13520,722,300817,229873
4,85540,485540,Yuma city, Arizona,1,2016,94892,42.2,73,14.7,48650,46242,61744,3292,1777,1359,266,39118,55774
5,15190,515190,Conway city, Arkansas,0,2016,65300,53.1,79.7,9.4,31768,33532,48156,10539,1265,121,0,61936,3364
5,23290,523290,Fayetteville city, Arkansas,1,2016,83823,58.2,81.1,7.9,41617,42206,67038,5397,2611,1366,66,75754,8069
5,24550,524550,Fort Smith city, Arkansas,1,2016,88122,38.6,75.7,16.6,42688,45434,57405,8593,5547,764,74,71436,16686
5,35710,535710,Jonesboro city, Arkansas,1,2016,74892,44.2,76.5,13.8,36521,38371,54712,15121,1358,0,0,70634,4258
5,41000,541000,Little Rock city, Arkansas,1,2016,198546,41.4,77.3,14.3,95972,102574,102531,77802,5169,326,0,183219,15327
5,50450,550450,North Little Rock city, Arkansas,0,2016,66273,44.5,74.6,10.5,31569,34704,-998,-998,-998,-998,-998,62618,3655
5,60410,560410,Rogers city, Arkansas,0,2016,65016,39.5,69.5,9.9,32030,32986,59523,1069,1041,356,0,43129,21887
5,66080,566080,Springdale city, Arkansas,1,2016,81799,41,67.9,9.3,42048,39751,47888,3265,2010,471,6207,53406,28393
6,562,600562,Alameda city, California,1,2016,78907,35.7,79.3,15.5,39227,39680,37670,7688,23696,96,29,69143,9764
6,884,600884,Alhambra city, California,1,2016,85465,39.8,81.9,18.1,41638,43827,16749,2515,47433,755,0,57093,28372
6,2000,602000,Anaheim city, California,1,2016,351066,43.2,74.7,11.6,166967,184099,248856,8350,57839,2315,2128,159206,191860
6,2252,602252,Antioch city, California,1,2016,110876,39.8,74.6,11.8,51706,59170,43646,28153,11206,463,79,79662,31214
6,2364,602364,Apple Valley town, California,1,2016,72542,39.5,75.1,16,36258,36284,56214,9088,1470,942,67,44695,27847
6,2553,602553,Arden-Arcade CDP, California,0,2016,106061,38.5,75.7,16.6,49127,56934,64431,11253,7406,164,63,84471,21590
6,3526,603526,Bakersfield city, California,1,2016,376371,44.3,70,9.5,185146,191225,239824,24364,30417,4766,912,186319,190052
6,3666,603666,Baldwin Park city, California,1,2016,76465,45.3,75.1,10.7,40145,36320,20991,1504,15073,1454,0,18283,58182
6,4982,604982,Bellflower city, California,1,2016,77789,41.5,74.8,12,36731,41058,24932,8343,8732,357,37,30306,47483
6,6000,606000,Berkeley city, California,1,2016,121241,55.7,86.2,13.4,57788,63453,72306,11953,24133,362,512,110722,10519
6,8786,608786,Buena Park city, California,1,2016,83148,44,79.7,13.7,40769,42379,40928,2738,21345,1034,838,46174,36974
6,8954,608954,Burbank city, California,1,2016,104451,41.7,80.9,17.7,51931,52520,71897,3676,12783,602,55,82681,21770
6,10046,610046,Camarillo city, California,0,2016,67345,37.2,79.7,19.5,31155,36190,51928,1496,7161,221,0,51220,16125
6,11194,611194,Carlsbad city, California,1,2016,113957,34.8,75.8,14.6,53554,60403,95906,1407,7557,70,547,102319,11638
6,11390,611390,Carmichael CDP, California,0,2016,63064,36.9,78.5,18.2,29193,33871,48970,4276,3548,236,209,56558,6506
6,11530,611530,Carson city, California,1,2016,92821,41.4,78.8,16.5,44748,48073,23205,23764,24058,254,2413,57850,34971
6,11964,611964,Castro Valley CDP, California,0,2016,65153,36.8,78.6,18.1,32024,33129,37216,5965,15544,741,232,56808,8345
6,13014,613014,Chico city, California,1,2016,91545,52.6,80.3,11.9,44558,46987,76753,2661,3313,489,279,76285,15260
6,13210,613210,Chino city, California,1,2016,87771,44.3,80.3,13,52211,35560,44796,5269,10427,229,99,43822,43949
6,13214,613214,Chino Hills city, California,1,2016,78821,42.2,76.7,11,38218,40603,36849,2384,26435,688,85,54773,24048
6,13392,613392,Chula Vista city, California,1,2016,267169,41.5,75.4,13.1,132477,134692,179666,9150,40423,1018,2465,108016,159153
6,13588,613588,Citrus Heights city, California,1,2016,87444,40.7,79.7,15.6,41476,45968,73250,2497,4085,340,0,66475,20969
6,14218,614218,Clovis city, California,1,2016,106587,42.2,72.2,12,54097,52490,72172,3098,11440,467,0,76036,30551
6,15044,615044,Compton city, California,1,2016,97537,42.8,69.9,9.8,47768,49769,36973,26965,930,458,0,29125,68412
6,16000,616000,Concord city, California,1,2016,128728,41.2,78.2,13.9,64231,64497,78768,5744,15504,510,1050,92817,35911
6,16350,616350,Corona city, California,1,2016,166774,45,77.8,10.4,83486,83288,109979,6685,21124,1021,1330,96913,69861
6,16532,616532,Costa Mesa city, California,1,2016,112825,48.3,79.3,9.5,56137,56688,86172,1847,8722,501,959,62783,50042
6,17918,617918,Daly City city, California,1,2016,106484,41.9,83.7,16.3,53497,52987,18424,2283,69028,613,1756,87824,18660
6,18100,618100,Davis city, California,0,2016,68107,58.3,83.7,11,32321,35786,44250,1871,14989,0,388,57998,10109
6,19766,619766,Downey city, California,1,2016,113267,45.6,73.9,10.3,55551,57716,74414,3145,11489,388,62,29995,83272
6,20802,620802,East Los Angeles CDP, California,0,2016,127804,45.7,71.6,9.9,64309,63495,46625,367,1258,501,0,5693,122111
6,21712,621712,El Cajon city, California,1,2016,103769,37.1,70,11.8,51470,52299,68209,6248,2519,1720,130,72266,31503
6,22020,622020,Elk Grove city, California,1,2016,169780,40.7,72.5,11.9,79893,89887,80768,14473,48940,1000,3116,138238,31542
6,22230,622230,El Monte city, California,1,2016,115800,42.2,75.7,12.7,58900,56900,39737,878,35524,993,420,41456,74344
6,22804,622804,Escondido city, California,1,2016,151594,43.9,74.9,10.4,76570,75024,112916,4943,12268,2450,1209,70980,80614
6,23182,623182,Fairfield city, California,1,2016,114757,41.2,75.3,12.8,55719,59038,53856,19644,16835,316,973,78789,35968
6,24477,624477,Florence-Graham CDP, California,0,2016,63582,47.3,68.1,7.4,32692,30890,-998,-998,-998,-998,-998,4947,58635
6,24638,624638,Folsom city, California,1,2016,77278,33.6,73.9,12.8,40958,36320,54490,2047,12476,523,251,66987,10291
6,24680,624680,Fontana city, California,1,2016,209659,45.4,71.6,8.4,101136,108523,92451,14015,14651,1502,1143,64405,145254
6,26000,626000,Fremont city, California,1,2016,233145,43.7,75.6,11.9,115775,117370,53272,8830,136066,853,2245,201250,31895
6,27000,627000,Fresno city, California,1,2016,522021,43.9,71.7,11,253511,268510,313249,39537,76526,5854,982,264562,257459
6,28000,628000,Fullerton city, California,1,2016,140734,44.4,78.9,12.9,70350,70384,76843,3838,35250,395,144,90984,49750
6,29000,629000,Garden Grove city, California,1,2016,174877,42.7,77,11.9,89076,85801,68506,2518,73572,899,233,112490,62387
6,30000,630000,Glendale city, California,1,2016,200826,39.9,81.6,17.1,97089,103737,148856,3623,30555,36,214,165142,35684
6,32548,632548,Hawthorne city, California,1,2016,88032,45.7,73,9.6,42406,45626,25100,19413,5058,376,438,35626,52406
6,33000,633000,Hayward city, California,1,2016,158969,44.6,78.6,11.4,78456,80513,70470,11846,40554,1039,4808,92499,66470
6,33182,633182,Hemet city, California,1,2016,84277,30.2,71.3,22.7,41626,42651,60621,8418,3436,1587,646,52817,31460
6,33434,633434,Hesperia city, California,1,2016,93714,42.9,73.3,10.9,48133,45581,79105,3386,1308,1197,420,38941,54773
6,36000,636000,Huntington Beach city, California,1,2016,200631,35.7,80.7,18.3,101810,98821,145875,4115,22652,789,1319,164034,36597
6,36448,636448,Indio city, California,1,2016,88484,36.4,76.3,20.6,42676,45808,43621,3121,2977,713,0,31355,57129
6,36546,636546,Inglewood city, California,1,2016,110667,43.9,80.1,12.4,52270,58397,23175,50426,2757,1190,317,59819,50848
6,36770,636770,Irvine city, California,1,2016,266117,45.8,77.3,9.9,129927,136190,128156,2985,115156,79,1280,235819,30298
6,37692,637692,Jurupa Valley city, California,0,2016,103543,42.5,74,10.5,51792,51751,55876,2697,3220,562,164,28403,75140
6,39248,639248,Laguna Niguel city, California,0,2016,65328,34.4,79.7,17.3,31542,33786,50567,1038,6464,0,63,53060,12268
6,39496,639496,Lake Forest city, California,1,2016,83236,41.2,79.4,13.4,41675,41561,57897,2422,14035,774,50,66485,16751
6,39892,639892,Lakewood city, California,1,2016,81121,42.5,75,12.2,39022,42099,35226,7879,18132,191,332,53690,27431
6,40130,640130,Lancaster city, California,1,2016,160107,42.2,73.3,9.9,78409,81698,98986,33008,8726,744,144,96941,63166
6,41992,641992,Livermore city, California,1,2016,89118,35.8,77.5,12.5,43739,45379,67091,784,10518,197,697,70354,18764
6,43000,643000,Long Beach city, California,1,2016,470140,45.9,76.6,10.5,230993,239147,236983,59157,58987,3466,4459,260992,209148
6,44000,644000,Los Angeles city, California,1,2016,3976324,45.9,79.2,12.1,1960672,2015652,2079698,350543,452848,26861,5687,2031566,1944758
6,44574,644574,Lynwood city, California,1,2016,71184,49.8,69.9,6.8,34824,36360,46024,5908,440,912,849,8908,62276
6,45484,645484,Manteca city, California,1,2016,76912,39.2,73.3,11.5,36517,40395,53169,3478,5691,951,605,45720,31192
6,46842,646842,Menifee city, California,1,2016,88510,37.8,75.2,19.8,42767,45743,53175,6773,7407,8,24,57846,30664
6,46898,646898,Merced city, California,1,2016,82573,48.1,68.6,8.3,42890,39683,46295,6249,9445,348,0,38674,43899
6,47766,647766,Milpitas city, California,1,2016,77534,43.3,78.8,11.9,39196,38338,7132,2404,57667,179,235,67256,10278
6,48256,648256,Mission Viejo city, California,1,2016,96386,35.9,78.8,18.4,48808,47578,78098,629,10790,117,273,80517,15869
6,48354,648354,Modesto city, California,1,2016,212172,40,72.8,13.4,105436,106736,151280,10282,15051,1315,1326,127910,84262
6,49270,649270,Moreno Valley city, California,1,2016,205516,46.6,70.3,7.4,98619,106897,61766,37136,12067,411,1030,86581,118935
6,49670,649670,Mountain View city, California,1,2016,80459,49.8,79.4,11.1,42117,38342,41580,1620,23434,718,933,64983,15476
6,50076,650076,Murrieta city, California,1,2016,111682,41,71.9,11.4,55717,55965,68812,4585,12427,1550,1093,77562,34120
6,50258,650258,Napa city, California,1,2016,80412,37.8,77,18,38320,42092,67757,333,2504,672,0,49519,30893
55,48000,5548000,Madison city, Wisconsin,1,2016,252557,54.9,84.2,11.6,123627,128930,199966,15656,22813,1852,198,237680,14877
55,53000,5553000,Milwaukee city, Wisconsin,1,2016,595070,46.1,73.7,9.6,286000,309070,259589,229503,26295,2533,35,484034,111036
55,60500,5560500,Oshkosh city, Wisconsin,0,2016,66570,49.8,83.3,12.8,34509,32061,61088,2685,1673,220,0,64415,2155
55,66000,5566000,Racine city, Wisconsin,1,2016,77572,42.5,72.4,13.1,38466,39106,49635,17860,756,398,0,59995,17577
55,84250,5584250,Waukesha city, Wisconsin,1,2016,72358,44.8,77.2,14.2,33576,38782,61904,4394,2502,321,99,65841,6517
72,10334,7210334,Caguas zona urbana, Puerto Rico,0,2016,75619,39.5,80.1,20.5,34391,41228,57610,6044,0,38,0,1188,74431
72,14290,7214290,Carolina zona urbana, Puerto Rico,0,2016,141984,38.8,80.5,21,65138,76846,71270,33944,190,3617,0,1407,140577
72,32522,7232522,Guaynabo zona urbana, Puerto Rico,0,2016,70097,38.1,81.8,19.3,32034,38063,54848,3396,40,0,0,1170,68927
72,63820,7263820,Ponce zona urbana, Puerto Rico,0,2016,117185,37.7,79.4,21.4,55747,61438,92457,5228,0,0,0,1128,116057
72,76770,7276770,San Juan zona urbana, Puerto Rico,0,2016,333149,37.8,81.2,21.3,151706,181443,221408,47300,860,1073,104,7357,325792
6,51182,651182,Newport Beach city, California,1,2016,86683,35.6,82.5,22.6,40251,46432,74633,632,8327,81,0,80319,6364
6,52526,652526,Norwalk city, California,1,2016,106161,42.8,75.5,12.2,52947,53214,41530,7134,13786,363,92,36452,69709
6,53000,653000,Oakland city, California,1,2016,419987,46.6,80.3,12.7,207048,212939,145374,98666,69038,4168,2201,310225,109762
6,53322,653322,Oceanside city, California,1,2016,175441,39.3,77.8,16.7,85108,90333,136832,7395,12334,525,1685,110905,64536
6,53896,653896,Ontario city, California,1,2016,173211,45,73.5,9.3,82758,90453,83833,12635,9731,1099,407,51199,122012
6,53980,653980,Orange city, California,1,2016,140507,43.9,77.6,12,70235,70272,102293,2424,15032,943,385,85397,55110
6,54652,654652,Oxnard city, California,1,2016,207911,43.6,71.5,10,103872,104039,158819,5260,13889,2201,267,53750,154161
6,55156,655156,Palmdale city, California,1,2016,157349,40.6,68.7,8.8,76867,80482,71900,15724,6942,942,105,63102,94247
6,55282,655282,Palo Alto city, California,0,2016,67021,33.8,79.9,21,33449,33572,43085,450,19438,442,61,63167,3854
6,56000,656000,Pasadena city, California,1,2016,142052,43.5,82.5,15.5,67415,74637,75089,14552,24071,1725,615,92299,49753
6,56700,656700,Perris city, California,1,2016,76330,48.9,67.8,6.1,36119,40211,23023,8299,3460,1224,0,17767,58563
6,57456,657456,Pittsburg city, California,0,2016,70677,41.7,73.1,10.8,35895,34782,29015,8648,11345,5,174,37472,33205
6,57792,657792,Pleasanton city, California,1,2016,82267,32.8,74.3,14.4,39515,42752,46131,2266,30105,162,0,75083,7184
6,58072,658072,Pomona city, California,1,2016,152476,47.5,74.2,8,77504,74972,69891,8562,14262,5099,140,40273,112203
6,59444,659444,Rancho Cordova city, California,0,2016,72319,43.5,75.2,12.5,37148,35171,45383,6107,8372,142,761,56799,15520
6,59451,659451,Rancho Cucamonga city, California,1,2016,176540,44.8,77.1,10.5,88004,88536,107626,19228,22079,809,1130,112093,64447
6,59920,659920,Redding city, California,1,2016,91797,39.1,78.1,18.8,45187,46610,77609,1213,5169,1752,9,83141,8656
6,59962,659962,Redlands city, California,1,2016,71288,43.6,77.1,15.9,31218,40070,53425,1939,5014,414,134,45899,25389
6,60018,660018,Redondo Beach city, California,1,2016,67863,35.6,81.6,15,34330,33533,50007,2764,8945,486,3,58536,9327
6,60102,660102,Redwood City city, California,1,2016,84965,45.2,79.5,11.4,42616,42349,50107,690,12462,965,700,49929,35036
6,60466,660466,Rialto city, California,1,2016,103300,46.7,70.6,8.2,53405,49895,61274,10387,1672,597,0,22954,80346
6,60620,660620,Richmond city, California,1,2016,109814,43.8,77.4,13.3,53965,55849,53631,19122,17538,85,76,60424,49390
6,62000,662000,Riverside city, California,1,2016,324727,47.6,75.7,10.4,160990,163737,181923,23186,20389,2330,259,158963,165764
6,62938,662938,Roseville city, California,1,2016,132683,37.5,76.3,17.4,62589,70094,102160,1954,12815,1250,260,112823,19860
6,64000,664000,Sacramento city, California,1,2016,495200,44.8,77.5,13.3,245235,249965,244964,66288,91000,4388,7963,353649,141551
6,64224,664224,Salinas city, California,1,2016,157224,47.5,70,8.6,77670,79554,54427,2747,11606,909,102,34021,123203
6,65000,665000,San Bernardino city, California,1,2016,216242,45,68.6,8.4,106167,110075,121909,32249,10983,1708,206,74415,141827
6,65042,665042,San Buenaventura (Ventura) city, California,1,2016,109591,39.2,79.5,17,55721,53870,89654,1394,4480,1684,40,68312,41279
6,65084,665084,San Clemente city, California,0,2016,65304,32,78.1,18.3,30637,34667,52091,573,2416,643,291,54229,11075
6,66000,666000,San Diego city, California,1,2016,1406622,48.1,80.2,12.3,711531,695091,935881,89910,240027,5664,5072,984657,421965
6,67000,667000,San Francisco city, California,1,2016,870887,48.4,86.5,14.9,443777,427110,404410,43468,300409,3054,1967,738349,132538
6,68000,668000,San Jose city, California,1,2016,1025373,43.4,77,11.5,520732,504641,400984,30624,357891,4424,6628,696394,328979
6,68084,668084,San Leandro city, California,1,2016,90460,35.1,80.7,17.7,42568,47892,35510,9636,29463,1089,508,66242,24218
6,68196,668196,San Marcos city, California,1,2016,95268,40.1,70.6,11.7,47655,47613,67422,3962,9620,1915,867,61516,33752
6,68252,668252,San Mateo city, California,1,2016,103959,42.8,79.5,16,51405,52554,55915,2147,22635,599,2076,77660,26299
6,68378,668378,San Ramon city, California,1,2016,75643,39.4,73.5,9.8,38178,37465,35078,2026,34798,401,0,70261,5382
6,69000,669000,Santa Ana city, California,1,2016,334236,47.3,73,8.4,171235,163001,149298,2913,39981,1598,549,75981,258255
6,69070,669070,Santa Barbara city, California,1,2016,91940,41.8,81.7,19.1,45690,46250,74892,1298,3486,1169,0,59043,32897
6,69084,669084,Santa Clara city, California,1,2016,125938,51.5,79.1,10.9,64954,60984,53870,4430,49727,289,238,104640,21298
6,69088,669088,Santa Clarita city, California,1,2016,181960,39,78.3,13.1,91373,90587,130934,6494,18572,1948,20,126213,55747
6,69196,669196,Santa Maria city, California,1,2016,106286,44.5,69.8,11.1,52194,54092,83479,1286,7730,279,0,28987,77299
6,70000,670000,Santa Monica city, California,1,2016,92478,44,86.4,17.7,46235,46243,73477,2250,8219,440,86,75778,16700
6,70098,670098,Santa Rosa city, California,1,2016,175143,38.4,77.6,17,84354,90789,114932,5279,10484,2404,1270,121831,53312
6,72016,672016,Simi Valley city, California,1,2016,126327,38.8,78.6,14.3,61516,64811,97981,2096,12600,633,144,94639,31688
6,73080,673080,South Gate city, California,1,2016,95537,45,72,10,46708,48829,64017,410,284,586,142,4321,91216
6,73262,673262,South San Francisco city, California,0,2016,66989,42.8,79.9,14.4,33567,33422,24223,1075,24498,23,1051,43680,23309
6,75000,675000,Stockton city, California,1,2016,307057,41.6,71.9,12.4,151495,155562,136363,39316,66560,3022,2151,181435,125622
6,77000,677000,Sunnyvale city, California,1,2016,152762,46.2,77.8,11.7,78330,74432,63833,2494,66240,953,285,122136,30626
6,78120,678120,Temecula city, California,1,2016,113062,40.1,71.1,9.5,55913,57149,71438,8304,9455,365,337,80543,32519
6,78582,678582,Thousand Oaks city, California,1,2016,128915,34.5,79.7,17.8,63203,65712,106089,1101,14777,474,286,108347,20568
6,80000,680000,Torrance city, California,1,2016,147185,38.9,78.8,15.3,70849,76336,69906,4948,54364,319,653,120904,26281
6,80238,680238,Tracy city, California,1,2016,89263,42.5,72.1,10,43458,45805,51226,3765,15052,503,1339,55479,33784
6,80812,680812,Turlock city, California,1,2016,72808,41.2,76.7,15.4,34547,38261,57912,1407,4196,1125,158,47230,25578
6,80854,680854,Tustin city, California,1,2016,80379,47.7,76.6,10.2,41576,38803,35186,1472,19695,169,1162,51089,29290
6,81204,681204,Union City city, California,1,2016,75316,46.1,81.5,14.1,38735,36581,16836,2778,39650,230,1419,60143,15173
6,81344,681344,Upland city, California,1,2016,76691,39.5,80.5,16.4,37065,39626,53042,5090,6363,472,207,47180,29511
6,81554,681554,Vacaville city, California,1,2016,98308,40.1,76.5,13.4,50995,47313,60740,10155,8846,603,360,76309,21999
6,81666,681666,Vallejo city, California,1,2016,121316,40,79.1,15.4,59409,61907,40261,26114,29449,317,2153,90145,31171
6,82590,682590,Victorville city, California,1,2016,122283,42.5,67.9,9.5,60420,61863,78220,24650,3893,546,0,59176,63107
6,82954,682954,Visalia city, California,1,2016,131069,39,68.7,11.9,61182,69887,103706,1665,12008,2453,295,61190,69879
6,82996,682996,Vista city, California,1,2016,101665,45.8,74.5,8.1,52999,48666,85006,2289,4431,332,69,46008,55657
6,83346,683346,Walnut Creek city, California,0,2016,69127,36,83.8,28.3,31694,37433,53933,577,9241,91,48,61770,7357
6,84200,684200,West Covina city, California,1,2016,107840,41.3,76.3,13.5,53779,54061,30418,4681,30627,380,559,49984,57856
6,84550,684550,Westminster city, California,1,2016,91565,36.5,79.4,17.1,45740,45825,35773,853,42497,299,469,67953,23612
6,85292,685292,Whittier city, California,1,2016,86892,41.1,74.9,13.4,42597,44295,44813,1695,4932,312,0,29298,57594
6,86832,686832,Yorba Linda city, California,0,2016,68236,34.2,73.6,17.4,33150,35086,46904,640,14797,51,0,53980,14256
6,86972,686972,Yuba City city, California,0,2016,66837,41.2,74.2,14.1,33083,33754,43391,1492,13501,495,331,49579,17258
8,3455,803455,Arvada city, Colorado,1,2016,117308,40.2,78.4,15.8,58445,58863,106813,1123,2928,1249,59,100295,17013
8,4000,804000,Aurora city, Colorado,1,2016,362249,44.7,74.4,10.6,178536,183713,213117,55030,22319,2724,1540,258290,103959
8,7850,807850,Boulder city, Colorado,1,2016,108108,59.1,87.4,9.8,55989,52119,95279,1316,5517,206,86,96085,12023
8,9280,809280,Broomfield city, Colorado,0,2016,66529,41.5,76.5,12.9,32659,33870,57480,727,3943,316,0,58387,8142
8,12815,812815,Centennial city, Colorado,1,2016,109935,34.5,78.2,16.8,55779,54156,95313,3127,4447,743,198,99762,10173
8,16000,816000,Colorado Springs city, Colorado,1,2016,465084,43.7,75.8,12.8,234287,230797,366682,31193,12345,2488,1567,383920,81164
8,20000,820000,Denver city, Colorado,1,2016,693060,49.3,79.7,11.2,347500,345560,522284,68262,25721,5462,410,483719,209341
8,27425,827425,Fort Collins city, Colorado,1,2016,164196,54.8,80.1,10.1,81237,82959,143235,3026,5131,1333,292,142098,22098
8,32155,832155,Greeley city, Colorado,1,2016,104003,46,75.7,11.5,51415,52588,94714,1707,2340,455,0,64711,39292
8,36410,836410,Highlands Ranch CDP, Colorado,0,2016,112436,38.4,72.4,10.1,56007,56429,95886,1129,9537,773,89,103688,8748
8,43000,843000,Lakewood city, Colorado,1,2016,154368,42.1,80.9,15.5,75011,79357,138065,2540,5603,1004,100,118846,35522
8,45970,845970,Longmont city, Colorado,1,2016,92813,39.3,75.5,14.7,43455,49358,84206,816,3569,604,123,67253,25560
8,46465,846465,Loveland city, Colorado,1,2016,76906,35.8,79.2,17.9,39208,37698,71344,291,733,916,81,68995,7911
8,62000,862000,Pueblo city, Colorado,1,2016,110295,39.3,77.7,17,55276,55019,83387,3517,1014,6608,127,52331,57964
8,77290,877290,Thornton city, Colorado,1,2016,136690,43.4,73.4,8.9,68659,68031,118495,2599,6417,1015,0,94229,42461
8,83835,883835,Westminster city, Colorado,1,2016,113865,40.1,74.7,12.7,56405,57460,92803,3927,7283,1601,88,84891,28974
9,8000,908000,Bridgeport city, Connecticut,1,2016,145934,46,77,10.7,71174,74760,63324,51009,3536,1202,0,88385,57549
9,18430,918430,Danbury city, Connecticut,1,2016,85008,40.1,78.2,14.8,43845,41163,54757,8452,6202,332,116,60728,24280
9,37000,937000,Hartford city, Connecticut,1,2016,123287,47.1,74.5,10,60325,62962,42525,42736,2764,247,0,63827,59460
9,50370,950370,New Britain city, Connecticut,1,2016,72570,41.4,78.2,15,36344,36226,52632,7720,1696,44,0,40821,31749
9,52000,952000,New Haven city, Connecticut,1,2016,129939,49,77.5,10,60037,69902,60133,40573,6652,510,41,87832,42107
9,55990,955990,Norwalk city, Connecticut,1,2016,88440,40,77.8,14.6,41002,47438,64977,11342,6834,443,208,68429,20011
9,73000,973000,Stamford city, Connecticut,1,2016,129105,43.5,79.3,13.2,65050,64055,80424,22345,10017,460,0,90187,38918
9,80000,980000,Waterbury city, Connecticut,1,2016,108269,42.7,74.6,11.6,49818,58451,68233,21850,3188,155,118,67615,40654
10,77580,1077580,Wilmington city, Delaware,1,2016,71455,41.8,76,13,33567,37888,22212,43011,1310,63,0,62501,8954
11,50000,1150000,Washington city, District of Columbia,1,2016,681170,51.3,82.3,11.6,323591,357579,277268,320554,26436,2004,41,606748,74422
12,410,1200410,Alafaya CDP, Florida,0,2016,91779,44.7,72,7.9,43731,48048,66206,13485,5288,0,0,60013,31766
12,7300,1207300,Boca Raton city, Florida,1,2016,96115,30.3,85.1,29.2,46552,49563,84286,2914,4035,269,0,85648,10467
12,7875,1207875,Boynton Beach city, Florida,1,2016,75569,36.7,81.9,19.3,32846,42723,49512,21773,1285,79,53,64983,10586
12,8150,1208150,Brandon CDP, Florida,0,2016,109582,43.4,78.1,11.8,54881,54701,81669,14703,4657,138,0,77821,31761
12,10275,1210275,Cape Coral city, Florida,1,2016,179795,31.9,81.5,21.5,88291,91504,162071,5054,3202,175,0,139166,40629
12,12875,1212875,Clearwater city, Florida,1,2016,114351,33.2,79.4,21,55886,58465,92415,10781,2166,280,149,95584,18767
12,14400,1214400,Coral Springs city, Florida,1,2016,130046,39.2,73.5,11.9,62166,67880,85468,28439,6156,311,68,97865,32181
12,16475,1216475,Davie town, Florida,1,2016,101857,41.9,78,13,49872,51985,69740,10194,8685,234,336,64154,37703
12,16525,1216525,Daytona Beach city, Florida,0,2016,66649,40,83.4,22.8,33120,33529,38702,23397,1309,204,0,60175,6474
12,16725,1216725,Deerfield Beach city, Florida,1,2016,79754,35.7,79.6,20.6,36737,43017,46998,26511,1189,391,0,66689,13065
12,17100,1217100,Delray Beach city, Florida,0,2016,67366,34,84.7,25,32199,35167,42475,19339,2913,92,0,60266,7100
12,17200,1217200,Deltona city, Florida,1,2016,90139,39.4,78.5,16.1,41338,48801,72090,10298,1670,0,0,60372,29767
12,24000,1224000,Fort Lauderdale city, Florida,1,2016,178764,40.6,82.1,16.7,93835,84929,108667,57749,2902,1520,0,147924,30840
12,24125,1224125,Fort Myers city, Florida,0,2016,77154,34.1,79.6,21.6,37460,39694,49630,20489,964,76,129,59415,17739
12,25175,1225175,Gainesville city, Florida,1,2016,131593,61.2,87.4,10.9,60991,70602,90494,24746,8732,926,524,114935,16658
12,30000,1230000,Hialeah city, Florida,1,2016,236385,37.3,82.8,20.5,109811,126574,216869,6586,646,0,97,9573,226812
12,32000,1232000,Hollywood city, Florida,1,2016,152007,36,81.7,18.4,74256,77751,108508,25053,2427,36,216,93374,58633
12,32275,1232275,Homestead city, Florida,0,2016,68000,43.3,62.1,7.4,35896,32104,-998,-998,-998,-998,-998,26470,41530
12,35000,1235000,Jacksonville city, Florida,1,2016,880623,42,76.9,13,426712,453911,519739,269312,38812,1804,453,798265,82358
12,36100,1236100,Kendall CDP, Florida,0,2016,77619,36.4,79.9,19.8,38130,39489,67812,2795,3423,0,0,23930,53689
12,36950,1236950,Kissimmee city, Florida,0,2016,69369,48.1,75.3,12,31774,37595,45062,10427,2616,0,0,22977,46392
12,38250,1238250,Lakeland city, Florida,1,2016,106419,37.9,80,22.1,51505,54914,74885,22361,4378,89,126,91198,15221
12,39425,1239425,Largo city, Florida,1,2016,83077,31,85,27,38420,44657,74247,3590,1407,429,278,76788,6289
12,39550,1239550,Lauderhill city, Florida,1,2016,71635,41.4,70.5,10.9,31512,40123,10777,58194,551,117,0,65746,5889
12,39925,1239925,Lehigh Acres CDP, Florida,0,2016,115673,42.6,71.6,10.3,57436,58237,85529,19878,1347,151,0,74615,41058
12,43975,1243975,Melbourne city, Florida,1,2016,81192,36.5,82.5,20.5,40647,40545,66039,6398,2446,418,0,72155,9037
12,45000,1245000,Miami city, Florida,1,2016,453584,42,82.6,17.6,223068,230516,354046,71010,4225,2049,470,119714,333870
12,45025,1245025,Miami Beach city, Florida,1,2016,91905,41,86.2,16.8,50744,41161,61538,3352,2101,0,359,38340,53565
12,45060,1245060,Miami Gardens city, Florida,1,2016,113045,40,78.2,14,54855,58190,27551,80596,643,297,0,85015,28030
12,45975,1245975,Miramar city, Florida,1,2016,138461,46.6,79.8,10.2,66968,71493,59449,63479,6993,105,0,91456,47005
12,53000,1253000,Orlando city, Florida,1,2016,277198,49.9,79.2,9.8,136663,140535,171406,66863,16538,325,0,193345,83853
12,54000,1254000,Palm Bay city, Florida,1,2016,110107,36.9,80.2,19,52709,57398,80018,22943,2169,69,0,95901,14206
12,54200,1254200,Palm Coast city, Florida,1,2016,88337,31,81.5,28.5,42031,46306,71957,11091,2013,0,0,77509,10828
12,55775,1255775,Pembroke Pines city, Florida,1,2016,168587,40.7,81.2,16.5,78280,90307,119719,29914,6724,190,36,90981,77606
12,56825,1256825,Pine Hills CDP, Florida,0,2016,76048,39.3,72.7,12.2,36147,39901,11873,53534,1620,0,0,66411,9637
12,57425,1257425,Plantation city, Florida,1,2016,92717,40.6,80.2,16,43822,48895,61607,20844,4425,106,261,67672,25045
12,58050,1258050,Pompano Beach city, Florida,1,2016,109380,38.2,76.7,17.5,55493,53887,66504,36141,1575,235,0,84613,24767
12,58715,1258715,Port St. Lucie city, Florida,1,2016,185136,36.3,78.9,19.3,89187,95949,140563,32441,4368,982,0,146705,38431
12,60950,1260950,Riverview CDP, Florida,0,2016,88941,43.9,72.1,8.1,45301,43640,59779,14214,2534,165,0,64511,24430
12,63000,1263000,St. Petersburg city, Florida,1,2016,260991,40.4,83.4,17.8,125551,135440,180496,57621,9646,437,28,239510,21481
12,68350,1268350,Spring Hill CDP, Florida,0,2016,111189,33.8,78.3,23,52557,58632,95781,6864,1970,172,0,91710,19479
12,69700,1269700,Sunrise city, Florida,1,2016,93723,37.5,78.1,17.5,44021,49702,54600,31336,2844,347,0,63911,29812
12,70600,1270600,Tallahassee city, Florida,1,2016,190895,59,83.9,10.4,89544,101351,108352,64902,8779,230,256,177966,12929
12,70675,1270675,Tamarac city, Florida,0,2016,65190,30,83.4,27,31699,33491,37053,21365,1756,476,0,48091,17099
12,71000,1271000,Tampa city, Florida,1,2016,377172,43.2,78.3,13.3,180469,196703,243107,93801,18514,1568,321,285954,91218
12,71569,1271569,The Hammocks CDP, Florida,0,2016,65814,43.7,77.4,11.4,29652,36162,55062,2091,1485,49,0,14803,51011
12,71625,1271625,The Villages CDP, Florida,0,2016,-998,-999999999,-999999999,-999999999,-998,-998,-998,-998,-998,-998,-998,69555,1795
12,72145,1272145,Town 'n' Country CDP, Florida,0,2016,87561,42.2,77,12.2,41415,46146,70962,6392,2138,400,501,46487,41074
12,76582,1276582,Weston city, Florida,0,2016,70023,34.1,70,11.2,31201,38822,55982,2035,5173,0,0,39098,30925
12,76600,1276600,West Palm Beach city, Florida,1,2016,108149,42.6,84.1,20.2,52914,55235,65998,36086,2355,359,0,85256,22893
13,1052,1301052,Albany city, Georgia,1,2016,74904,43.4,74.5,13.5,33691,41213,16133,55766,583,258,50,73047,1857
13,1696,1301696,Alpharetta city, Georgia,0,2016,65334,36.6,72.3,10.2,34157,31177,41339,7482,14187,126,0,60428,4906
13,3440,1303440,Athens-Clarke County unified government (balance), Georgia,1,2016,123456,56.7,82.9,10,59489,63967,77831,34730,5209,181,33,110043,13413
13,4000,1304000,Atlanta city, Georgia,1,2016,472506,50.8,80.6,11.1,235065,237441,190892,240202,20450,2895,209,449408,23098
13,4204,1304204,Augusta-Richmond County consolidated government (balance), Georgia,1,2016,196194,43.2,76.8,13.5,94946,101248,73228,112659,4084,584,848,186448,9746
13,19000,1319000,Columbus city, Georgia,1,2016,197485,43.2,75.4,12.7,96919,100566,86603,90127,4160,1159,0,182510,14975
13,42425,1342425,Johns Creek city, Georgia,1,2016,83884,34.9,71.8,9.1,39626,44258,52237,6332,20513,220,0,76605,7279
13,49008,1349008,Macon-Bibb County, Georgia,0,2016,152527,39.4,75,14.7,71586,80941,61167,82447,3089,98,0,147672,4855
13,67284,1367284,Roswell city, Georgia,1,2016,94592,38.1,74.1,11.5,46806,47786,-998,-998,-998,-998,-998,80306,14286
13,68516,1368516,Sandy Springs city, Georgia,1,2016,105720,49.7,82,11.9,50712,55008,62228,24294,7108,5442,0,88018,17702
13,69000,1369000,Savannah city, Georgia,1,2016,146762,48.4,79.4,13.5,71289,75473,56773,78846,3496,374,360,138033,8729
13,80508,1380508,Warner Robins city, Georgia,1,2016,74401,41.3,76.2,13.1,34897,39504,38579,27641,3142,495,0,68639,5762
15,71550,1571550,Urban Honolulu CDP, Hawaii,0,2016,351769,39.4,81.9,19.5,173691,178078,63646,5819,183327,638,34345,326336,25433
16,8830,1608830,Boise City city, Idaho,1,2016,223152,44.4,77,12.9,107555,115597,192811,5055,9096,903,377,201142,22010
16,52120,1652120,Meridian city, Idaho,1,2016,95627,37.6,71.3,14.1,50803,44824,-998,-998,-998,-998,-998,89134,6493
16,56260,1656260,Nampa city, Idaho,1,2016,91375,42.1,66.4,11.6,44119,47256,73424,48,591,1438,652,65866,25509
17,2154,1702154,Arlington Heights village, Illinois,1,2016,74397,32.9,77.1,18.9,36830,37567,-998,-998,-998,-998,-998,70597,3800
17,3012,1703012,Aurora city, Illinois,1,2016,197107,44.2,71,9,97162,99945,113373,20755,14434,689,414,107521,89586
17,6613,1706613,Bloomington city, Illinois,1,2016,78024,45.8,79.8,12.8,38600,39424,59864,7882,6404,185,0,73171,4853
17,7133,1707133,Bolingbrook village, Illinois,1,2016,73367,42.5,74.5,9.5,37933,35434,35288,13239,10160,116,0,54652,18715
17,12385,1712385,Champaign city, Illinois,1,2016,86649,57.6,87.2,10.3,47048,39601,58594,14078,10589,58,0,81082,5567
17,14000,1714000,Chicago city, Illinois,1,2016,2704965,47.3,78.8,11.8,1313049,1391916,1309585,802457,172298,8551,1261,1901489,803476
17,14351,1714351,Cicero town, Illinois,1,2016,82991,47.2,68.7,7.3,42304,40687,-998,-998,-998,-998,-998,9391,73600
17,18823,1718823,Decatur city, Illinois,1,2016,71435,36.7,78.6,19.2,33298,38137,49798,13342,670,211,0,69323,2112
17,23074,1723074,Elgin city, Illinois,1,2016,114521,41.5,73.4,12.5,58238,56283,59780,5576,8098,894,0,59186,55335
17,24582,1724582,Evanston city, Illinois,1,2016,74899,46.1,80.5,14.4,34349,40550,47073,15095,7431,97,0,66007,8892
17,38570,1738570,Joliet city, Illinois,1,2016,146410,43.4,72.4,10.9,71405,75005,96170,22839,6221,1181,0,109950,36460
17,51622,1751622,Naperville city, Illinois,1,2016,148063,38.8,72.8,10.7,73017,75046,105313,7876,27981,407,46,138144,9919
17,57225,1757225,Palatine village, Illinois,1,2016,68725,41.6,75.1,10.7,33742,34983,49708,1338,9280,88,0,60344,8381
17,59000,1759000,Peoria city, Illinois,1,2016,115588,41.6,76.1,14.5,55260,60328,68927,32475,6684,542,0,108345,7243
17,65000,1765000,Rockford city, Illinois,1,2016,147404,38.5,75.5,16.2,72137,75267,99031,31666,5617,103,0,118711,28693
17,68003,1768003,Schaumburg village, Illinois,1,2016,73803,41.4,78.6,15.1,37322,36481,43398,2204,19882,494,0,64693,9110
17,70122,1770122,Skokie village, Illinois,0,2016,64292,34.5,75.2,18.5,30312,33980,36120,6716,16857,627,0,55411,8881
17,72000,1772000,Springfield city, Illinois,1,2016,115511,39.4,78.4,17.1,55778,59733,84336,24183,3078,35,107,112192,3319
17,79293,1779293,Waukegan city, Illinois,1,2016,84467,47.7,72.5,8.9,42281,42186,40852,14079,5346,98,0,36864,47603
18,5860,1805860,Bloomington city, Indiana,1,2016,86654,68.2,88,8,43793,42861,71129,3168,8697,310,0,82974,3680
18,10342,1810342,Carmel city, Indiana,1,2016,90533,37.4,72.4,12.6,44615,45918,74047,2568,10491,97,0,87527,3006
18,22000,1822000,Evansville city, Indiana,1,2016,119407,42.6,77.7,14.3,57965,61442,95744,14647,1138,310,1210,115325,4082
18,23278,1823278,Fishers city, Indiana,1,2016,88930,41.8,71.2,7.4,43375,45555,75152,5027,5216,0,0,84059,4871
18,25000,1825000,Fort Wayne city, Indiana,1,2016,261342,40.6,74.4,13.5,126384,134958,197350,39177,11820,322,102,236493,24849
18,27000,1827000,Gary city, Indiana,1,2016,74186,36.5,76.4,18.4,34029,40157,9357,61511,169,101,53,70193,3993
18,31000,1831000,Hammond city, Indiana,1,2016,77131,43,71.7,9.4,36789,40342,36718,19262,688,24,42,47140,29991
18,36003,1836003,Indianapolis city (balance), Indiana,1,2016,852506,42.9,75.2,11.6,409836,442670,518799,238317,26159,2843,244,763167,89339
18,40788,1840788,Lafayette city, Indiana,1,2016,71311,45.5,78.8,13.5,34193,37118,58419,7599,443,104,0,62963,8348
18,51876,1851876,Muncie city, Indiana,1,2016,68707,51.3,85.2,14.5,33993,34714,55587,8135,1473,226,163,66571,2136
18,71000,1871000,South Bend city, Indiana,1,2016,102442,40.1,71.3,13.5,49114,53328,64131,26796,649,707,125,84961,17481
19,1855,1901855,Ames city, Iowa,0,2016,66190,67.4,88.7,10.1,34238,31952,53860,1342,8289,157,0,63469,2721
19,12000,1912000,Cedar Rapids city, Iowa,1,2016,131118,41.8,76.8,14.7,64618,66500,113375,8301,4837,191,90,126067,5051
19,19000,1919000,Davenport city, Iowa,1,2016,102608,41.3,75.1,13.8,50581,52027,83468,13300,2329,416,0,93947,8661
19,21000,1921000,Des Moines city, Iowa,1,2016,215328,44.9,76,11.5,108057,107271,160964,24403,13071,299,71,186490,28838
19,38595,1938595,Iowa City city, Iowa,1,2016,74384,59.1,85.1,10.4,35713,38671,57711,6352,5634,0,0,68913,5471
19,73335,1973335,Sioux City city, Iowa,1,2016,82105,41.1,73.7,14.3,41223,40882,67712,3720,3013,627,749,66405,15700
19,82425,1982425,Waterloo city, Iowa,1,2016,67940,39.9,76.6,14.8,34814,33126,52068,10609,1849,437,719,63788,4152
20,36000,2036000,Kansas City city, Kansas,1,2016,153893,41.6,71.5,11.2,76722,77171,88976,36001,5963,1134,0,107776,46117
20,38900,2038900,Lawrence city, Kansas,1,2016,95355,57.7,81.9,9.6,47286,48069,76293,4714,5732,1486,10,89232,6123
20,52575,2052575,Olathe city, Kansas,1,2016,135474,41.6,72,11.4,67456,68018,115769,8300,5444,383,0,122855,12619
20,53775,2053775,Overland Park city, Kansas,1,2016,188955,38.7,75.6,14.3,90959,97996,159728,9308,12327,181,0,175723,13232
20,64500,2064500,Shawnee city, Kansas,0,2016,65215,40.5,77.9,11.5,31965,33250,53945,2244,4882,0,0,61657,3558
20,71000,2071000,Topeka city, Kansas,1,2016,126812,39.3,75.9,16.5,60214,66598,94906,14271,1928,1060,127,106429,20383
20,79000,2079000,Wichita city, Kansas,1,2016,389927,40.9,74.3,13.4,191350,198577,290548,40640,18943,3125,0,324046,65881
21,8902,2108902,Bowling Green city, Kentucky,0,2016,65239,54.9,79.4,11.8,31658,33581,47357,10170,3883,58,0,60568,4671
21,46027,2146027,Lexington-Fayette urban county, Kentucky,1,2016,318449,46.2,79,12.1,156230,162219,238917,46097,11699,1080,201,296501,21948
21,48006,2148006,Louisville/Jefferson County metro government (balance), Kentucky,1,2016,616261,40.1,77.7,14.4,298261,318000,432485,146430,16079,907,355,584105,32156
22,5000,2205000,Baton Rouge city, Louisiana,1,2016,227707,46.6,77.5,13.5,108481,119226,84704,127685,8216,156,0,219060,8647
22,8920,2208920,Bossier City city, Louisiana,0,2016,68485,43,75.1,11.8,35806,32679,46170,18259,1173,173,123,63079,5406
22,39475,2239475,Kenner city, Louisiana,1,2016,67094,38.1,74,14.6,32714,34380,39750,19622,1846,183,0,51996,15098
22,40735,2240735,Lafayette city, Louisiana,1,2016,127625,43.2,79.7,14.6,60899,66726,77710,43551,2386,220,0,124335,3290
22,41155,2241155,Lake Charles city, Louisiana,1,2016,76861,41.5,76.1,15.3,37100,39761,34343,38397,796,320,0,73734,3127
22,50115,2250115,Metairie CDP, Louisiana,0,2016,143475,38.8,80.2,19.1,69252,74223,118166,12781,4607,212,0,120153,23322
22,55000,2255000,New Orleans city, Louisiana,1,2016,391495,44.2,79.6,13,186998,204497,133434,233836,11721,434,97,369565,21930
22,70000,2270000,Shreveport city, Louisiana,1,2016,194472,40.8,75.6,14.6,90716,103756,74555,111255,3228,422,0,189055,5417
23,60545,2360545,Portland city, Maine,1,2016,66945,47.5,82.6,14.4,33470,33475,55083,6415,2757,443,0,64067,2878
24,4000,2404000,Baltimore city, Maryland,1,2016,614664,44.5,79,12.9,289086,325578,189260,384465,15149,1800,604,583520,31144
24,19125,2419125,Columbia CDP, Maryland,0,2016,107308,41.3,78.7,15.6,51686,55622,60356,25419,14815,179,56,96119,11189
24,26000,2426000,Ellicott City CDP, Maryland,0,2016,68683,34.5,74.8,15.3,32545,36138,39723,7059,19451,114,0,66959,1724
24,30325,2430325,Frederick city, Maryland,0,2016,70062,43,80.1,13.6,34329,35733,45504,14990,6639,413,58,61278,8784
24,31175,2431175,Gaithersburg city, Maryland,0,2016,67760,46.8,78.4,11.3,32064,35696,35630,13969,10407,555,0,48856,18904
24,32025,2432025,Germantown CDP, Maryland,0,2016,89940,43.1,74.5,8,43391,46549,44676,22214,17495,0,0,68639,21301
24,32650,2432650,Glen Burnie CDP, Maryland,0,2016,69499,41.1,79.9,15.3,34152,35347,42028,16211,4146,164,0,62157,7342
24,67675,2467675,Rockville city, Maryland,0,2016,66927,40.4,77.2,15.9,31322,35605,42281,7271,11610,109,0,55720,11207
24,72450,2472450,Silver Spring CDP, Maryland,0,2016,85988,51.1,77.4,9,42554,43434,34148,28099,7464,0,0,69862,16126
24,81175,2481175,Waldorf CDP, Maryland,0,2016,75448,40.5,73.4,9,35344,40104,21002,46501,3073,193,0,70495,4953
25,7000,2507000,Boston city, Massachusetts,1,2016,672840,54.3,83.9,11,323186,349654,358210,173312,65982,2296,252,544377,128463
25,9000,2509000,Brockton city, Massachusetts,1,2016,95623,39.4,73.7,13.8,45789,49834,37260,38925,866,306,0,83856,11767
25,11000,2511000,Cambridge city, Massachusetts,1,2016,110644,62.3,88.1,12.2,53974,56670,70479,12602,19813,603,54,100005,10639
25,23000,2523000,Fall River city, Massachusetts,1,2016,88929,40.3,78.5,17.9,43076,45853,69825,4468,1544,9,0,78387,10542
25,24960,2524960,Framingham CDP, Massachusetts,0,2016,71583,41.2,79.5,16.7,33223,38360,52862,3933,6419,56,0,63283,8300
25,34550,2534550,Lawrence city, Massachusetts,1,2016,80216,46,72.6,10.1,39769,40447,54819,4582,1564,462,0,17120,63096
25,37000,2537000,Lowell city, Massachusetts,1,2016,110572,46.8,77.1,9.8,54926,55646,66794,8912,25541,708,177,91640,18932
25,37490,2537490,Lynn city, Massachusetts,1,2016,92708,42.7,76.8,13.7,47755,44953,42184,10866,6618,387,169,53885,38823
25,45000,2545000,New Bedford city, Massachusetts,1,2016,95035,41.6,75.6,14,45355,49680,60966,6507,1818,59,65,76719,18316
25,45560,2545560,Newton city, Massachusetts,1,2016,89041,37.5,76.3,18.1,41564,47477,68478,1976,12285,193,27,82812,6229
25,55745,2555745,Quincy city, Massachusetts,1,2016,93686,43.5,83.6,15.3,44812,48874,55449,4817,28905,387,0,90579,3107
25,62535,2562535,Somerville city, Massachusetts,1,2016,81324,66.9,89.1,7.3,40098,41226,59418,5658,8985,236,0,71901,9423
25,67000,2567000,Springfield city, Massachusetts,1,2016,154079,43.8,76.3,12.2,72582,81497,101679,32511,2963,341,0,86795,67284
25,82000,2582000,Worcester city, Massachusetts,1,2016,184509,46.1,81.9,13.4,91316,93193,122478,26775,14312,712,49,146513,37996
26,3000,2603000,Ann Arbor city, Michigan,1,2016,120777,60.1,87.7,11.5,61533,59244,86008,7583,19147,15,179,115129,5648
26,21000,2621000,Dearborn city, Michigan,1,2016,94430,41.5,71.1,12.6,46467,47963,86617,3368,1454,176,0,92201,2229
26,22000,2622000,Detroit city, Michigan,1,2016,672829,41.8,74.3,12.7,320634,352195,91180,531876,12282,2173,69,625546,47283
26,27440,2627440,Farmington Hills city, Michigan,1,2016,81130,33.5,80.7,18.6,38600,42530,54491,16354,8113,30,0,79601,1529
26,29000,2629000,Flint city, Michigan,1,2016,97379,39.4,72.4,11.3,45674,51705,40448,51392,302,245,0,91750,5629
26,34000,2634000,Grand Rapids city, Michigan,1,2016,196458,47.9,76.2,11.4,99579,96879,131297,36737,4295,795,67,166633,29825
26,42160,2642160,Kalamazoo city, Michigan,1,2016,75988,54.6,77.8,9.6,37752,38236,54153,15050,1262,0,0,68503,7485
26,46000,2646000,Lansing city, Michigan,1,2016,117400,46.4,76.8,10.2,56190,61210,71639,26068,4377,704,187,102985,14415
26,49000,2649000,Livonia city, Michigan,1,2016,94044,33.3,79.9,17.8,45486,48558,83902,5150,2916,46,62,91255,2789
26,69035,2669035,Rochester Hills city, Michigan,1,2016,73418,38.4,75.8,16,35384,38034,55002,4961,11280,112,0,68356,5062
26,74900,2674900,Southfield city, Michigan,1,2016,73093,37.9,81,20.2,34589,38504,14906,51660,1870,193,0,71372,1721
26,76460,2676460,Sterling Heights city, Michigan,1,2016,132442,39.6,78.5,15.7,64059,68383,111033,7902,9448,416,0,129117,3325
26,80700,2680700,Troy city, Michigan,1,2016,83651,36.1,79.9,17.8,41138,42513,60510,2082,18926,149,0,81938,1713
26,84000,2684000,Warren city, Michigan,1,2016,135121,39.3,76.5,16.1,67399,67722,97309,23298,11198,163,0,131643,3478
26,86000,2686000,Westland city, Michigan,1,2016,81543,38.7,80.7,16.1,38969,42574,61033,14778,2186,605,81,78411,3132
26,88940,2688940,Wyoming city, Michigan,1,2016,75560,44.5,76.6,10.4,37609,37951,58050,6068,1326,645,0,59391,16169
27,6616,2706616,Bloomington city, Minnesota,1,2016,85337,37,81.3,22.6,41737,43600,63158,8460,3280,440,70,76501,8836
27,7966,2707966,Brooklyn Park city, Minnesota,1,2016,79708,40.7,70.5,10.1,36903,42805,37162,25670,12079,502,252,74987,4721
27,17000,2717000,Duluth city, Minnesota,1,2016,86300,46.5,80.9,14.3,42552,43748,76930,2365,1686,2877,35,84735,1565
27,17288,2717288,Eagan city, Minnesota,0,2016,66431,38,79,12.2,32889,33542,53795,5911,3577,510,0,62766,3665
27,40166,2740166,Maple Grove city, Minnesota,0,2016,69569,36.9,71.5,10.7,34293,35276,58432,3867,4833,40,0,69092,477
27,43000,2743000,Minneapolis city, Minnesota,1,2016,413645,52.1,80.4,9.3,213568,200077,265776,74766,27385,6083,39,377210,36435
27,51730,2751730,Plymouth city, Minnesota,1,2016,77231,36.8,76.5,14.5,38690,38541,62217,2290,9482,503,0,73488,3743
27,54880,2754880,Rochester city, Minnesota,1,2016,114008,42.2,76.1,14.4,55524,58484,90714,8806,8682,900,0,107106,6902
27,56896,2756896,St. Cloud city, Minnesota,0,2016,67396,50.8,81.9,12.9,35868,31528,52486,10786,2003,208,0,65995,1401
27,58000,2758000,St. Paul city, Minnesota,1,2016,302403,45.9,74.6,10.2,149460,152943,172623,45923,55056,2283,114,273175,29228
27,71428,2771428,Woodbury city, Minnesota,0,2016,68824,40.6,69.9,9.5,34055,34769,52205,5341,6347,143,66,64573,4251
28,29700,2829700,Gulfport city, Mississippi,1,2016,72077,40,77.1,13.7,34662,37415,42464,25043,1559,981,0,66026,6051
28,36000,2836000,Jackson city, Mississippi,1,2016,169141,44,74.5,11.6,77607,91534,-998,-998,-998,-998,-998,166884,2257
29,15670,2915670,Columbia city, Missouri,1,2016,120606,55.3,81.7,11.6,58198,62408,90760,14038,8900,775,0,117106,3500
29,35000,2935000,Independence city, Missouri,1,2016,117031,37,76.8,17.2,55920,61111,93723,8276,2579,488,1999,106454,10577
29,38000,2938000,Kansas City city, Missouri,1,2016,481360,42.8,76.7,12.4,234706,246654,296737,137333,14876,1368,1010,429130,52230
29,41348,2941348,Lee's Summit city, Missouri,1,2016,95782,35.1,71.8,14.9,45586,50196,81770,7660,1049,389,0,91510,4272
29,54074,2954074,O'Fallon city, Missouri,1,2016,86276,39.8,74.8,11.5,41243,45033,-998,-998,-998,-998,-998,84157,2119
29,64082,2964082,St. Charles city, Missouri,0,2016,69293,44,81,15.7,33080,36213,58544,3824,3560,294,0,65086,4207
29,64550,2964550,St. Joseph city, Missouri,1,2016,76506,41.2,78.1,13.9,39027,37479,66049,4448,1048,336,0,71196,5310
29,65000,2965000,St. Louis city, Missouri,1,2016,311404,45.8,80.2,11.8,150976,160428,144752,145886,10264,762,88,298857,12547
29,70000,2970000,Springfield city, Missouri,1,2016,167313,47.8,82.2,14.5,79502,87811,144488,8173,2659,1498,110,160168,7145
30,6550,3006550,Billings city, Montana,1,2016,110314,38.4,77.1,15.9,54579,55735,99661,823,934,4856,0,104006,6308
30,50200,3050200,Missoula city, Montana,1,2016,72362,50.7,82.8,11.8,37203,35159,66023,690,1298,2037,0,69579,2783
31,28000,3128000,Lincoln city, Nebraska,1,2016,280369,46.2,77.5,12.8,140163,140206,239577,12309,12093,1863,3,259666,20703
31,37000,3137000,Omaha city, Nebraska,1,2016,446956,42.6,75.6,12.7,220500,226456,349668,54432,16599,1316,284,384620,62336
32,23770,3223770,Enterprise CDP, Nevada,0,2016,139509,45,76.1,10.1,67103,72406,73283,11682,33565,527,1641,111258,28251
32,31900,3231900,Henderson city, Nevada,1,2016,292977,36.3,78.1,19.5,145091,147886,227367,15739,19841,2274,2751,246284,46693
32,40000,3240000,Las Vegas city, Nevada,1,2016,632916,40.1,76.1,14.7,315737,317179,397592,87268,40180,3233,3947,429866,203050
32,51800,3251800,North Las Vegas city, Nevada,1,2016,238689,44.1,72.1,9.6,119210,119479,138581,46263,14661,2133,1632,141455,97234
32,54600,3254600,Paradise CDP, Nevada,0,2016,242013,44.4,80.1,13.9,127736,114277,147322,21728,30095,969,2794,160844,81169
32,60600,3260600,Reno city, Nevada,1,2016,245251,43.9,78.6,14.3,124768,120483,186547,6881,15733,3211,1637,182474,62777
32,68400,3268400,Sparks city, Nevada,1,2016,98346,37.5,76.6,14.9,48922,49424,75152,1527,6995,509,457,71208,27138
32,68585,3268585,Spring Valley CDP, Nevada,0,2016,205933,43.8,79.1,13,100357,105576,102742,23948,43110,1228,2477,159275,46658
32,71400,3271400,Sunrise Manor CDP, Nevada,0,2016,193357,42,72.5,9.8,93238,100119,99257,23391,10593,2333,921,81871,111486
33,45140,3345140,Manchester city, New Hampshire,1,2016,110499,44.8,80.6,13.6,58548,51951,94304,5058,6062,234,0,98872,11627
33,50260,3350260,Nashua city, New Hampshire,1,2016,87889,37,81.1,17.5,41978,45911,74604,3104,5392,170,32,77434,10455
34,3580,3403580,Bayonne city, New Jersey,0,2016,66224,39.9,76.2,15.3,33479,32745,40253,5665,6941,67,202,44781,21443
34,10000,3410000,Camden city, New Jersey,1,2016,74417,43,71.1,9.7,36767,37650,19692,28699,2230,743,0,39298,35119
34,13690,3413690,Clifton city, New Jersey,1,2016,85847,40,80,15.5,40510,45337,58072,4920,9904,22,180,55925,29922
34,19390,3419390,East Orange city, New Jersey,0,2016,64797,40.5,74.7,11.5,31587,33210,2425,54171,498,384,0,56379,8418
34,21000,3421000,Elizabeth city, New Jersey,1,2016,128638,44.2,72.6,9.2,62266,66372,51210,25183,2157,431,0,51069,77569
34,36000,3436000,Jersey City city, New Jersey,1,2016,264161,51.3,79.3,9.6,131030,133131,88979,61338,67062,1040,195,190153,74008
34,51000,3451000,Newark city, New Jersey,1,2016,281770,46.3,76.7,10,137771,143999,85918,140673,5556,767,0,184752,97018
34,56550,3456550,Passaic city, New Jersey,1,2016,70646,42.8,66.7,8.5,34688,35958,50865,8124,1310,426,0,17023,53623
34,57000,3457000,Paterson city, New Jersey,1,2016,147011,42.6,75.1,12.2,71201,75810,50202,38447,4954,119,0,57766,89245
34,73110,3473110,Toms River CDP, New Jersey,0,2016,88283,33.9,79.7,19.4,42104,46179,78571,2032,3188,84,71,80871,7412
34,74000,3474000,Trenton city, New Jersey,1,2016,84065,43.2,74.1,11,43472,40593,38904,41065,1138,274,0,52685,31380
34,74630,3474630,Union City city, New Jersey,1,2016,69298,43.5,79.3,11.5,33843,35455,51525,4333,3079,70,279,20163,49135
35,2000,3502000,Albuquerque city, New Mexico,1,2016,559270,41.5,77,14.7,273023,286247,395010,17927,16427,27901,498,292852,266418
35,39380,3539380,Las Cruces city, New Mexico,1,2016,101760,43.4,77.3,16,50333,51427,91988,2831,2095,924,69,41067,60693
35,63460,3563460,Rio Rancho city, New Mexico,1,2016,96022,38.2,76.9,15.6,46528,49494,76335,2909,1271,3133,0,59924,36098
35,70500,3570500,Santa Fe city, New Mexico,1,2016,83881,35.5,81.2,21.1,40020,43861,74454,904,404,1952,20,38932,44949
36,1000,3601000,Albany city, New York,1,2016,98106,51.7,82.3,12.1,47513,50593,51681,30354,6418,224,0,88353,9753
36,8026,3608026,Brentwood CDP, New York,0,2016,62132,45.7,74.6,8.1,29094,33038,38085,8268,690,268,0,21401,40731
36,11000,3611000,Buffalo city, New York,1,2016,256908,45.7,77.4,12,123296,133612,120967,94657,16617,1281,240,229304,27604
36,15000,3615000,Cheektowaga CDP, New York,0,2016,73199,37.4,80.9,17.7,33802,39397,60001,9361,2122,68,0,71593,1606
36,49121,3649121,Mount Vernon city, New York,1,2016,68348,35.9,78.5,15.8,30724,37624,18891,40981,1682,246,0,54723,13625
36,50617,3650617,New Rochelle city, New York,1,2016,79558,43,79.5,14.5,38507,41051,51526,14741,3484,41,0,53487,26071
36,51000,3651000,New York city, New York,1,2016,8537673,44.1,78.9,13.5,4075642,4462031,3627375,2073102,1205911,31806,4940,6048583,2489090
36,63000,3663000,Rochester city, New York,1,2016,208886,47.1,76.9,9.8,101014,107872,99699,85771,4967,1552,61,168491,40395
36,65508,3665508,Schenectady city, New York,1,2016,64907,44.7,78.8,13.2,31051,33856,37382,12691,3291,258,191,57362,7545
36,73000,3673000,Syracuse city, New York,1,2016,143378,47.6,80.1,12.8,68132,75246,78868,41560,8529,959,0,130363,13015
36,84000,3684000,Yonkers city, New York,1,2016,200792,40.4,79.2,17.3,95561,105231,97326,43358,15158,537,76,130564,70228
37,2140,3702140,Asheville city, North Carolina,1,2016,89098,43.8,83.1,17.2,43135,45963,72342,11111,2570,57,0,83454,5644
37,10740,3710740,Cary town, North Carolina,1,2016,164007,36.6,73.2,12.8,81504,82503,113872,11114,28520,951,0,148740,15267
37,12000,3712000,Charlotte city, North Carolina,1,2016,842029,46.3,75.6,9.6,403118,438911,414560,302904,53235,2358,786,726092,115937
37,14100,3714100,Concord city, North Carolina,1,2016,89895,39,74.8,12.5,42625,47270,60717,17296,4079,53,49,81007,8888
37,19000,3719000,Durham city, North Carolina,1,2016,262989,47.6,77.4,10.7,123173,139816,130718,100950,14462,392,267,225417,37572
37,22920,3722920,Fayetteville city, North Carolina,1,2016,204777,46.7,76.2,12.8,100760,104017,91948,88517,5341,2215,510,180824,23953
37,25580,3725580,Gastonia city, North Carolina,1,2016,75537,36.6,75.2,15.8,34378,41159,48137,19907,1885,45,0,67663,7874
37,28000,3728000,Greensboro city, North Carolina,1,2016,287019,44.7,77.6,13.1,133246,153773,139564,115211,14430,1220,295,265176,21843
37,28080,3728080,Greenville city, North Carolina,1,2016,91500,54.8,81.1,9.3,42274,49226,50433,34227,2208,537,64,84903,6597
37,31400,3731400,High Point city, North Carolina,1,2016,115299,40.4,74.1,14,54638,60661,58540,41346,8100,300,0,100186,15113
37,34200,3734200,Jacksonville city, North Carolina,1,2016,67795,60.9,74.3,6.4,38783,29012,48166,9896,1179,376,275,57456,10339
37,55000,3755000,Raleigh city, North Carolina,1,2016,458862,49.8,79.8,10.1,218960,239902,272643,133592,21468,1445,87,412213,46649
37,74440,3774440,Wilmington city, North Carolina,1,2016,117545,46.8,81.4,14.2,57072,60473,89065,21336,1666,453,0,110594,6951
37,75000,3775000,Winston-Salem city, North Carolina,1,2016,242200,40.9,76.1,14.6,113238,128962,138133,84404,5279,825,21,208416,33784
38,7200,3807200,Bismarck city, North Dakota,0,2016,68780,39.1,78.7,17.5,33495,35285,61360,2026,674,3448,131,67163,1617
38,25700,3825700,Fargo city, North Dakota,1,2016,120235,50.3,79.7,12,64231,56004,103380,6237,4151,1367,0,116295,3940
39,1000,3901000,Akron city, Ohio,1,2016,197634,41.1,78.4,14.6,93194,104440,116967,61945,9274,378,0,192725,4909
39,12000,3912000,Canton city, Ohio,1,2016,71329,39.3,76.1,14.6,34016,37313,45306,18226,286,0,0,67457,3872
39,15000,3915000,Cincinnati city, Ohio,1,2016,298802,46.6,77.7,12.1,143760,155042,152794,124696,5095,102,0,286222,12580
39,16000,3916000,Cleveland city, Ohio,1,2016,385810,41,77.7,13.1,189401,196409,154487,191178,8047,1528,135,343415,42395
39,18000,3918000,Columbus city, Ohio,1,2016,862643,48.2,77,9.7,420416,442227,519035,249181,44835,1222,747,812893,49750
39,21000,3921000,Dayton city, Ohio,1,2016,140478,44.6,78.8,13.2,68691,71787,77082,57999,1481,127,270,134657,5821
39,44856,3944856,Lorain city, Ohio,0,2016,63736,41.1,75.6,15,29986,33750,44806,11485,554,362,174,45213,18523
39,61000,3961000,Parma city, Ohio,1,2016,79423,39.3,80.8,17.2,38615,40808,71112,2978,1798,0,0,74797,4626
39,77000,3977000,Toledo city, Ohio,1,2016,278512,41.5,76.6,14,135322,143190,175137,76608,2722,727,146,253968,24544
39,88000,3988000,Youngstown city, Ohio,1,2016,64301,37.3,79.6,16.4,30439,33862,32155,25980,309,122,0,57694,6607
40,9050,4009050,Broken Arrow city, Oklahoma,1,2016,109439,38.9,75,14.7,53158,56281,86693,3966,3507,5688,0,100873,8566
40,23200,4023200,Edmond city, Oklahoma,1,2016,91187,42.5,72.7,12.7,43632,47555,74020,5258,2691,1789,0,85543,5644
40,41850,4041850,Lawton city, Oklahoma,1,2016,94652,46.3,76.2,10.7,49640,45012,56540,21074,2400,3863,170,81065,13587
40,52500,4052500,Norman city, Oklahoma,1,2016,122186,50.8,81.7,13.5,60931,61255,93564,6069,7458,5080,112,112955,9231
40,55000,4055000,Oklahoma City city, Oklahoma,1,2016,638311,42.6,74.2,11.7,312300,326011,433765,92689,25383,21571,986,518876,119435
40,75000,4075000,Tulsa city, Oklahoma,1,2016,403622,41.5,75,13.2,196133,207489,255063,61480,13046,19345,279,338644,64978
41,5350,4105350,Beaverton city, Oregon,1,2016,97602,42.5,82.3,13.7,47965,49637,72296,2177,9606,325,98,80023,17579
41,5800,4105800,Bend city, Oregon,1,2016,91123,41.3,79.3,18.3,44253,46870,86288,538,1102,159,0,83148,7975
41,23850,4123850,Eugene city, Oregon,1,2016,166581,48,83,16.2,82581,84000,141176,2998,7272,2394,490,150119,16462
41,31250,4131250,Gresham city, Oregon,1,2016,111521,38.8,77.1,13.5,55501,56020,90533,5483,4357,1900,318,91802,19719
41,34100,4134100,Hillsboro city, Oregon,1,2016,105171,48.2,73.4,9.6,52078,53093,70620,3134,13785,567,1861,80168,25003
41,47000,4147000,Medford city, Oregon,1,2016,81621,36.1,78.2,19.8,40031,41590,69756,503,1559,1481,404,70902,10719
41,59000,4159000,Portland city, Oregon,1,2016,639635,47.7,81.7,12.4,316918,322717,497999,38807,49174,3558,4329,574581,65054
41,64900,4164900,Salem city, Oregon,1,2016,167421,43.8,77.5,15.3,80020,87401,137347,1449,5528,1611,1992,129572,37849
42,2000,4202000,Allentown city, Pennsylvania,1,2016,120440,44.2,72.2,11.4,57911,62529,74100,16625,2408,0,0,56962,63478
42,6088,4206088,Bethlehem city, Pennsylvania,1,2016,76427,46.2,79.9,14.8,37531,38896,62136,5918,2185,320,0,54787,21640
42,24000,4224000,Erie city, Pennsylvania,1,2016,98601,41.6,76.3,13.3,47527,51074,74635,15557,3468,427,153,90241,8360
42,60000,4260000,Philadelphia city, Pennsylvania,1,2016,1567872,45,77.9,12.9,743380,824492,634111,661032,110733,5521,480,1341552,226320
42,61000,4261000,Pittsburgh city, Pennsylvania,1,2016,303624,49.2,84.7,14.6,149497,154127,205201,69010,17031,338,245,295174,8450
42,63624,4263624,Reading city, Pennsylvania,1,2016,87575,43.7,71.6,10.9,43631,43944,47324,8057,786,3377,0,28136,59439
42,69000,4269000,Scranton city, Pennsylvania,1,2016,77294,41,79.1,17.6,38431,38863,65080,4855,3102,176,0,66416,10878
44,19180,4419180,Cranston city, Rhode Island,1,2016,81025,38.7,82.5,19.7,40454,40571,68119,3943,3904,350,48,67349,13676
44,54640,4454640,Pawtucket city, Rhode Island,1,2016,71434,44,79.3,11.4,36950,34484,46471,10676,2391,937,135,55955,15479
44,59000,4459000,Providence city, Rhode Island,1,2016,179214,52.5,76.8,9.1,86129,93085,94085,23938,10651,3066,175,98864,80350
44,74300,4474300,Warwick city, Rhode Island,1,2016,81576,34.3,83.4,21.5,38823,42753,73326,1557,2691,196,128,77280,4296
45,13330,4513330,Charleston city, South Carolina,1,2016,137539,48.2,83.9,14.4,64687,72852,100430,32447,2724,123,0,134396,3143
45,16000,4516000,Columbia city, South Carolina,1,2016,133972,58.1,84.1,10,69415,64557,70338,53642,3734,42,545,126351,7621
45,30850,4530850,Greenville city, South Carolina,0,2016,67447,47.8,78.9,14,31445,36002,45907,17812,1719,149,0,64234,3213
45,48535,4548535,Mount Pleasant town, South Carolina,1,2016,84177,38.4,73.5,14.4,41966,42211,77894,3142,977,417,0,80805,3372
45,50875,4550875,North Charleston city, South Carolina,1,2016,112147,46.4,76.5,10.1,53150,58997,57640,47074,1919,86,0,100333,11814
45,61405,4561405,Rock Hill city, South Carolina,1,2016,72926,44.5,75.4,13,35118,37808,37188,28992,1979,0,38,67897,5029
46,52980,4652980,Rapid City city, South Dakota,1,2016,74050,37.6,76.6,17.5,37179,36871,58856,660,1149,9240,0,70311,3739
46,59020,4659020,Sioux Falls city, South Dakota,1,2016,174350,43.2,74.4,12.7,86920,87430,147395,9170,5214,3859,39,165209,9141
47,14000,4714000,Chattanooga city, Tennessee,1,2016,177582,43,79.7,15.3,83440,94142,109586,58157,4913,89,0,164897,12685
47,15160,4715160,Clarksville city, Tennessee,1,2016,150280,47.6,73.1,9,73216,77064,100415,34363,4612,1383,1375,132790,17490
47,27740,4727740,Franklin city, Tennessee,0,2016,74788,38.3,74.9,12.7,36173,38615,63519,3459,4923,0,0,67250,7538
47,37640,4737640,Jackson city, Tennessee,0,2016,67006,40.1,77.2,15.7,30223,36783,34444,30599,767,53,0,64809,2197
47,38320,4738320,Johnson City city, Tennessee,0,2016,66976,44.1,81.8,15.5,32437,34539,57820,4234,1601,903,64,63311,3665
47,40000,4740000,Knoxville city, Tennessee,1,2016,186238,49.5,81.8,13.2,89619,96619,139049,32994,4349,1081,261,175254,10984
47,48000,4748000,Memphis city, Tennessee,1,2016,652752,42.6,74.8,12.1,309773,342979,183086,421114,10394,1994,98,606554,46198
47,51560,4751560,Murfreesboro city, Tennessee,1,2016,131939,53,77.2,8.2,65248,66691,99290,22653,4537,0,0,122183,9756
47,52006,4752006,Nashville-Davidson metropolitan government (balance), Tennessee,1,2016,660393,46.9,78.6,11.2,317555,342838,422479,184132,25558,1108,605,591736,68657
48,1000,4801000,Abilene city, Texas,1,2016,128272,46.2,77.2,12.4,66846,61426,93584,13479,3471,1258,8,94261,34011
48,1924,4801924,Allen city, Texas,1,2016,99166,38.7,73,10.1,50564,48602,67115,9165,16807,191,0,88525,10641
48,3000,4803000,Amarillo city, Texas,1,2016,197812,42,73.2,13.2,96597,101215,161939,13360,7837,1071,239,132878,64934
48,4000,4804000,Arlington city, Texas,1,2016,392787,44.9,74.3,10.6,193410,199377,246424,84751,23540,2107,942,276315,116472
48,4462,4804462,Atascocita CDP, Texas,0,2016,72763,40.6,71.9,9.9,35968,36795,52055,14522,2259,75,329,56080,16683
48,5000,4805000,Austin city, Texas,1,2016,947897,52.1,78.5,8.5,480741,467156,706658,72371,66777,4941,783,618413,329484
48,6128,4806128,Baytown city, Texas,1,2016,76834,44.1,71.6,8.6,39541,37293,53202,11090,3008,323,0,39828,37006
48,7000,4807000,Beaumont city, Texas,1,2016,118309,42.9,74.8,13.9,57581,60728,55572,54771,4780,483,32,98377,19932
48,10768,4810768,Brownsville city, Texas,1,2016,183829,41.1,68.5,13.5,88261,95568,178281,980,1779,38,35,12846,170983
48,10912,4810912,Bryan city, Texas,1,2016,83265,47.6,76,11.6,42600,40665,57877,13219,529,0,107,46796,36469
48,13024,4813024,Carrollton city, Texas,1,2016,133351,43,76.3,10.9,63528,69823,90192,12840,19477,754,244,89424,43927
48,13552,4813552,Cedar Park city, Texas,0,2016,70498,43.2,67.9,8.3,33639,36859,56895,1004,7115,346,0,56219,14279
48,15976,4815976,College Station city, Texas,1,2016,112142,67.8,82.8,5.4,56766,55376,87999,8638,12088,235,0,96448,15694
48,16432,4816432,Conroe city, Texas,0,2016,82296,42.2,75.4,12.9,41479,40817,68828,5480,3611,396,0,54430,27866
48,17000,4817000,Corpus Christi city, Texas,1,2016,325734,41.9,75.3,13.7,162179,163555,292170,14774,6628,1403,211,118915,206819
48,19000,4819000,Dallas city, Texas,1,2016,1317942,46,75.1,10,655438,662504,814974,324829,46997,2090,179,772759,545183
48,19972,4819972,Denton city, Texas,1,2016,133803,54.5,79.2,9.5,62917,70886,103969,13659,5920,917,264,99773,34030
48,22660,4822660,Edinburg city, Texas,1,2016,87642,46.1,65.1,6.6,42445,45197,-998,-998,-998,-998,-998,6649,80993
48,24000,4824000,El Paso city, Texas,1,2016,683088,42.6,72.7,12.7,334071,349017,561325,28025,10758,3850,299,131533,551555
48,26232,4826232,Flower Mound town, Texas,0,2016,73289,36.4,69.8,7.3,35882,37407,60475,2657,6443,193,34,66291,6998
48,27000,4827000,Fort Worth city, Texas,1,2016,855897,44.4,71.6,9.4,421697,434200,545285,162955,39260,3337,454,558091,297806
48,27684,4827684,Frisco city, Texas,1,2016,163631,40.2,68.3,7.9,79644,83987,112304,11038,33350,558,35,150810,12821
48,29000,4829000,Garland city, Texas,1,2016,234588,41.1,71.6,10.5,117667,116921,158211,34752,24919,518,0,131650,102938
48,29336,4829336,Georgetown city, Texas,0,2016,67137,34.8,82.8,29,33184,33953,61995,1829,312,0,0,52541,14596
48,30464,4830464,Grand Prairie city, Texas,1,2016,190626,41.6,71.3,9.2,94691,95935,121743,40206,15551,409,0,102158,88468
48,32372,4832372,Harlingen city, Texas,0,2016,65533,39,69.1,15,31935,33598,58336,871,237,303,85,12645,52888
48,35000,4835000,Houston city, Texas,1,2016,2304388,45.8,74.7,10.2,1152283,1152105,1318837,520127,171312,5044,968,1272510,1031878
48,37000,4837000,Irving city, Texas,1,2016,238284,49.3,73.8,8.2,117317,120967,113047,31480,46029,1303,531,134546,103738
48,39148,4839148,Killeen city, Texas,1,2016,143397,50.6,69.1,5.6,69917,73480,62075,59327,4855,1476,2217,107627,35770
48,41464,4841464,Laredo city, Texas,1,2016,257988,43.5,66.1,9,125058,132930,245694,1139,832,358,0,11757,246231
48,41980,4841980,League City city, Texas,1,2016,101619,44.3,74.2,10.8,49050,52569,80612,10912,4686,973,0,78808,22811
48,42508,4842508,Lewisville city, Texas,1,2016,104676,46.8,74.4,9.1,51726,52950,66383,11573,9229,373,315,69599,35077
48,43888,4843888,Longview city, Texas,1,2016,81712,39.5,75.4,15.6,40335,41377,57039,20621,1545,408,0,67156,14556
48,45000,4845000,Lubbock city, Texas,1,2016,252514,49.2,77,12.2,126017,126497,202208,20501,5184,3576,1000,163017,89497
48,45384,4845384,McAllen city, Texas,1,2016,142203,40.1,70.1,13.9,70602,71601,93259,1630,4412,1320,0,22947,119256
48,45744,4845744,McKinney city, Texas,1,2016,172318,41.5,72.1,10.5,85585,86733,129425,18887,13596,679,162,139088,33230
48,46452,4846452,Mansfield city, Texas,0,2016,65205,41.2,69.4,8.5,29873,35332,41470,10686,5950,487,264,53548,11657
48,47892,4847892,Mesquite city, Texas,1,2016,143763,40.5,70.8,9.8,66752,77011,94356,36061,4066,1146,244,87465,56298
48,48072,4848072,Midland city, Texas,1,2016,134613,44.5,72.3,10.7,66313,68300,112486,11052,3386,341,88,73833,60780
48,48768,4848768,Mission city, Texas,1,2016,83556,39.4,66.1,11.1,41732,41824,-998,-998,-998,-998,-998,7210,76346
48,48804,4848804,Missouri City city, Texas,1,2016,74875,37.7,76.8,13.8,33732,41143,27403,33846,8361,220,0,62777,12098
48,50820,4850820,New Braunfels city, Texas,0,2016,70999,39.5,75.5,15.8,33937,37062,64295,2006,1304,73,0,47689,23310
48,52356,4852356,North Richland Hills city, Texas,0,2016,69807,37.6,76.5,15.8,31684,38123,59726,3335,802,0,0,58774,11033
48,53388,4853388,Odessa city, Texas,1,2016,117749,43.6,72.2,10.7,58611,59138,98075,7301,1426,849,0,50650,67099
48,56000,4856000,Pasadena city, Texas,1,2016,153359,42.2,69.8,9.5,72603,80756,136040,5370,2409,1340,0,52916,100443
48,56348,4856348,Pearland city, Texas,1,2016,117367,43.2,73.3,10.3,57380,59987,69095,21685,17246,2460,0,96772,20595
48,57200,4857200,Pharr city, Texas,1,2016,77314,39.1,66.3,14.3,34139,43175,-998,-998,-998,-998,-998,5795,71519
48,58016,4858016,Plano city, Texas,1,2016,286047,42,76.6,11.4,140905,145142,188085,30299,52511,1179,495,241615,44432
48,61796,4861796,Richardson city, Texas,1,2016,113368,41.7,75.1,13.9,56337,57031,74781,14373,16656,225,0,94404,18964
48,63500,4863500,Round Rock city, Texas,1,2016,120528,47.2,74.6,8.8,59570,60958,86455,11983,9200,0,0,78937,41591
48,64472,4864472,San Angelo city, Texas,1,2016,103526,43.8,76.3,15.3,50621,52905,91526,5803,1259,455,0,60128,43398
48,65000,4865000,San Antonio city, Texas,1,2016,1492494,44.3,74.7,11.9,738297,754197,1184876,110885,41863,11402,727,536995,955499
48,70808,4870808,Sugar Land city, Texas,1,2016,88187,35.7,77.8,15.8,44478,43709,42580,5788,35725,167,0,80872,7315
48,72176,4872176,Temple city, Texas,0,2016,73597,37.5,73.5,18.6,35677,37920,57045,10162,764,432,0,52048,21549
48,72656,4872656,The Woodlands CDP, Texas,0,2016,112076,33.1,71.4,14,54153,57923,97357,3720,5460,0,0,93091,18985
48,74144,4874144,Tyler city, Texas,1,2016,104796,41.8,74,14.8,48952,55844,71494,23237,2799,280,0,80756,24040
48,75428,4875428,Victoria city, Texas,0,2016,67672,42.2,74.6,13.7,32496,35176,58049,5009,1396,101,164,31097,36575
48,76000,4876000,Waco city, Texas,1,2016,134422,48.5,77.2,12.2,65206,69216,90117,30745,2498,640,149,90935,43487
48,79000,4879000,Wichita Falls city, Texas,1,2016,104735,46.5,77.5,13.3,55483,49252,78901,12703,3329,856,151,81204,23531
49,43660,4943660,Layton city, Utah,1,2016,75658,43.8,66.7,10.2,36808,38850,63061,1525,1754,705,821,66484,9174
49,55980,4955980,Ogden city, Utah,1,2016,86709,44.5,70.7,9.5,45066,41643,74796,1432,1771,1065,141,56789,29920
49,57300,4957300,Orem city, Utah,1,2016,97508,50.4,71.1,9.8,50281,47227,85801,1368,1635,1358,784,80939,16569
49,62470,4962470,Provo city, Utah,1,2016,116874,66.6,78.4,5.3,58285,58589,104399,515,3532,890,1799,93429,23445
49,65330,4965330,St. George city, Utah,1,2016,82315,39.8,74.4,19.4,40330,41985,69725,456,629,789,869,69443,12872
49,67000,4967000,Salt Lake City city, Utah,1,2016,193776,50.7,79,10.5,100186,93590,140022,7022,9569,1730,2946,154048,39728
49,67440,4967440,Sandy city, Utah,1,2016,95827,38,73.8,14.1,46834,48993,88549,348,3046,422,208,86999,8828
49,70850,4970850,South Jordan city, Utah,0,2016,69034,43.6,68.7,9.2,35059,33975,-998,-998,-998,-998,-998,66404,2630
49,82950,4982950,West Jordan city, Utah,1,2016,113688,43.4,67.9,6.3,59223,54465,92944,322,2341,636,3886,91787,21901
49,83470,4983470,West Valley City city, Utah,1,2016,136579,43.5,68.4,8.4,70993,65586,76838,4588,6569,376,3713,82183,54396
51,1000,5101000,Alexandria city, Virginia,1,2016,155810,49.1,81.7,10.1,74560,81250,92717,34500,9726,99,146,129608,26202
51,3000,5103000,Arlington CDP, Virginia,0,2016,230050,51.9,82.2,9.6,114984,115066,162749,19802,23558,962,411,194678,35372
51,14440,5114440,Centreville CDP, Virginia,0,2016,68024,42.2,74.8,7.9,33867,34157,38736,4861,18770,84,329,58513,9511
51,16000,5116000,Chesapeake city, Virginia,1,2016,237940,40.7,75.8,12.5,116137,121803,147623,71159,7197,68,0,224343,13597
51,21088,5121088,Dale City CDP, Virginia,0,2016,72073,42.4,73.6,8.8,36227,35846,31207,17879,8570,0,0,50774,21299
51,35000,5135000,Hampton city, Virginia,1,2016,135410,42,79,14.2,64156,71254,56219,68730,3506,75,476,127980,7430
51,47672,5147672,Lynchburg city, Virginia,1,2016,80212,50.4,80.7,14.3,35920,44292,53004,23624,795,312,0,77404,2808
51,56000,5156000,Newport News city, Virginia,1,2016,181825,44,76.9,12.2,88786,93039,86739,73750,4472,430,202,165749,16076
51,57000,5157000,Norfolk city, Virginia,1,2016,245115,50.9,79.8,10.3,127741,117374,115675,100685,9313,832,496,226094,19021
51,64000,5164000,Portsmouth city, Virginia,1,2016,95252,41.6,76.4,14,45634,49618,38231,49467,1626,265,1001,91224,4028
51,67000,5167000,Richmond city, Virginia,1,2016,223170,49,82.1,11.9,106262,116908,101987,105155,4903,650,115,208656,14514
51,68000,5168000,Roanoke city, Virginia,1,2016,99660,39.1,77.6,15.2,47335,52325,63615,30307,3200,68,123,93444,6216
51,76432,5176432,Suffolk city, Virginia,1,2016,89273,38.3,75.2,13.7,43617,45656,45912,37324,1688,191,89,85640,3633
51,82000,5182000,Virginia Beach city, Virginia,1,2016,452602,43,77.5,13.2,222398,230204,303452,82660,30196,901,175,416167,36435
53,3180,5303180,Auburn city, Washington,1,2016,75968,38.7,73.9,11,37339,38629,48026,5401,6948,2449,1790,65302,10666
53,5210,5305210,Bellevue city, Washington,1,2016,141415,41,78.9,15.2,70126,71289,75456,4794,50111,121,470,133020,8395
53,5280,5305280,Bellingham city, Washington,1,2016,87577,53.7,83.9,13.4,42659,44918,69699,2085,5425,947,290,78598,8979
53,22640,5322640,Everett city, Washington,1,2016,109035,44.5,79,12.1,57171,51864,79608,4681,9952,1508,1564,92340,16695
53,23515,5323515,Federal Way city, Washington,1,2016,96748,41,74.6,13.8,45881,50867,57647,5951,12444,905,2451,75674,21074
53,35275,5335275,Kennewick city, Washington,1,2016,80469,39.8,71.3,13.4,40538,39931,65134,1110,2206,344,0,57073,23396
53,35415,5335415,Kent city, Washington,1,2016,127506,44.5,75.7,10.8,64371,63135,62039,14175,25478,534,1645,103952,23554
53,35940,5335940,Kirkland city, Washington,0,2016,87672,43.5,79.1,13.3,43922,43750,66935,1252,13587,180,0,81270,6402
53,43955,5343955,Marysville city, Washington,0,2016,67625,38.4,75.9,14.3,32175,35450,58328,277,4286,125,376,61614,6011
53,53545,5353545,Pasco city, Washington,0,2016,71934,44,65.8,7.6,36814,35120,42553,1382,647,609,759,30963,40971
53,57745,5357745,Renton city, Washington,1,2016,100952,43.8,78,11.5,50545,50407,47180,12634,22178,755,2890,90002,10950
53,63000,5363000,Seattle city, Washington,1,2016,704358,51.5,85,12.3,354197,350161,475419,50146,104955,2701,2098,659164,45194
53,67000,5367000,Spokane city, Washington,1,2016,215964,42.3,77,14.5,105039,110925,181230,3434,6186,5330,2166,201497,14467
53,67167,5367167,Spokane Valley city, Washington,1,2016,96337,40.1,78.4,16.3,48190,48147,87705,967,1238,855,360,90304,6033
53,70000,5370000,Tacoma city, Washington,1,2016,211304,43.5,77.1,12,106317,104987,132869,21790,21480,4164,2037,185493,25811
53,74060,5374060,Vancouver city, Washington,1,2016,174836,41.4,77.5,16.5,83469,91367,137738,4197,10538,909,2477,150234,24602
53,80010,5380010,Yakima city, Washington,1,2016,93974,39.2,70.7,13.9,45743,48231,70908,3116,1206,1899,0,47317,46657
55,2375,5502375,Appleton city, Wisconsin,1,2016,75465,41.6,73.1,12.2,37552,37913,64422,2402,4571,493,65,69972,5493
55,22300,5522300,Eau Claire city, Wisconsin,0,2016,67776,49.7,80.9,13.7,33255,34521,62345,614,3114,196,0,66448,1328
55,31000,5531000,Green Bay city, Wisconsin,1,2016,105142,42.8,75.9,10.9,53154,51988,82200,3493,4112,3765,0,90981,14161
55,39225,5539225,Kenosha city, Wisconsin,1,2016,99634,39.8,74.6,12.5,48717,50917,80060,10507,1629,688,175,83290,16344
72,6593,7206593,Bayam√≥n zona urbana, Puerto Rico,0,2016,163941,39.7,81.3,20.3,76664,87277,115073,15784,459,51,0,1137,162804
15,71550,1571550,Urban Honolulu CDP, Hawaii,0,2017,350388,39.3,83.1,19.7,172554,177834,56481,7082,192699,545,22833,326056,24332
16,8830,1608830,Boise City city, Idaho,1,2017,226567,44.1,78.2,13.8,115099,111468,201009,4659,6275,697,181,205764,20803
16,52120,1652120,Meridian city, Idaho,1,2017,99938,39.3,70.7,12.6,49540,50398,92630,105,2075,120,0,92261,7677
16,56260,1656260,Nampa city, Idaho,1,2017,93585,47,73.5,13.4,48680,44905,77618,1172,570,876,51,69652,23933
17,2154,1702154,Arlington Heights village, Illinois,1,2017,75097,34.2,78.7,20.4,35849,39248,62493,2407,6096,0,0,68960,6137
17,3012,1703012,Aurora city, Illinois,1,2017,202548,42.8,71.4,10.5,102123,100425,117300,20307,20708,1051,1013,114093,88455
17,6613,1706613,Bloomington city, Illinois,1,2017,77941,45.6,79.4,13.2,37024,40917,60636,7954,7244,469,0,74089,3852
17,7133,1707133,Bolingbrook village, Illinois,1,2017,72155,41.7,74.3,9.6,35618,36537,33573,15452,9856,0,0,55062,17093
17,12385,1712385,Champaign city, Illinois,1,2017,87426,57.6,82.2,8.9,42539,44887,56068,17268,10388,160,0,81212,6214
17,14000,1714000,Chicago city, Illinois,1,2017,2716462,46.9,79.2,12.2,1317691,1398771,1354634,809079,181505,7819,390,1928484,787978
17,14351,1714351,Cicero town, Illinois,1,2017,82560,46.7,71.6,8.2,41727,40833,28317,1327,505,0,0,7842,74718
17,18823,1718823,Decatur city, Illinois,1,2017,68645,38.4,78,20.4,31752,36893,48035,15310,576,338,19,66360,2285
17,23074,1723074,Elgin city, Illinois,1,2017,114459,40.5,72.9,11.2,57155,57304,73410,4954,4553,2480,0,61167,53292
17,24582,1724582,Evanston city, Illinois,1,2017,74752,43.8,81.4,16.6,36507,38245,48766,13752,6534,0,0,65755,8997
17,38570,1738570,Joliet city, Illinois,1,2017,147150,43.9,73.1,10.3,73801,73349,92151,24986,2583,226,113,98116,49034
17,51622,1751622,Naperville city, Illinois,1,2017,148584,38.8,74.6,12.6,72503,76081,109460,6362,28152,0,0,140984,7600
17,57225,1757225,Palatine village, Illinois,1,2017,68610,39.8,74.7,13,33762,34848,45882,1328,6832,45,0,51858,16752
17,59000,1759000,Peoria city, Illinois,1,2017,115637,38.7,76.2,16.8,55272,60365,72979,30682,6504,71,0,108443,7194
17,65000,1765000,Rockford city, Illinois,1,2017,148287,37.6,75.3,16.5,72168,76119,102643,32584,4067,451,28,120190,28097
17,68003,1768003,Schaumburg village, Illinois,1,2017,73118,39.5,79.6,15.9,35365,37753,45922,3292,19196,130,0,67723,5395
17,70122,1770122,Skokie village, Illinois,0,2017,63984,32,77.5,19.3,28938,35046,41288,4253,15054,55,250,54194,9790
17,72000,1772000,Springfield city, Illinois,1,2017,114663,37.6,77.7,17.2,53725,60938,83754,22906,3925,16,58,111179,3484
17,79293,1779293,Waukegan city, Illinois,1,2017,88805,45.3,72.4,10,44364,44441,32882,20018,4365,985,82,41164,47641
18,5860,1805860,Bloomington city, Indiana,1,2017,85551,68.1,89,9.5,43444,42107,69976,3226,8148,189,47,81347,4204
18,10342,1810342,Carmel city, Indiana,1,2017,93148,36.9,73.6,14.2,46260,46888,75921,2618,10578,817,85,90848,2300
18,22000,1822000,Evansville city, Indiana,1,2017,117940,40.4,79.7,17,56350,61590,96714,14880,593,239,0,114507,3433
18,23278,1823278,Fishers city, Indiana,1,2017,90907,38.6,70.6,9,43587,47320,75954,6562,5782,0,0,86701,4206
18,25000,1825000,Fort Wayne city, Indiana,1,2017,254796,40.5,75.1,14.1,122966,131830,184984,38292,14039,792,0,230072,24724
18,27000,1827000,Gary city, Indiana,1,2017,76430,38.3,76.5,18.1,35534,40896,12035,60467,186,40,0,72072,4358
18,31000,1831000,Hammond city, Indiana,1,2017,76627,41.9,71.6,11.4,37766,38861,37528,15444,1492,332,0,46005,30622
18,36003,1836003,Indianapolis city (balance), Indiana,1,2017,857386,43.3,75.4,12.2,414040,443346,537680,238723,27007,1388,144,764344,93042
18,40788,1840788,Lafayette city, Indiana,1,2017,71225,42.7,76.3,13.9,36678,34547,62310,4896,611,73,0,59496,11729
18,51876,1851876,Muncie city, Indiana,1,2017,68450,53.5,83.3,13.2,32979,35471,56115,7578,859,0,0,65920,2530
18,71000,1871000,South Bend city, Indiana,1,2017,96143,43.1,75.2,13.3,47953,48190,61969,24718,973,309,0,81585,14558
19,1855,1901855,Ames city, Iowa,0,2017,66500,65.4,88.2,10.3,36003,30497,54844,2606,7553,79,0,64188,2312
19,12000,1912000,Cedar Rapids city, Iowa,1,2017,132240,41.3,76.2,16,64205,68035,110013,11145,3848,251,456,125980,6260
19,19000,1919000,Davenport city, Iowa,1,2017,102314,41,77.7,14.7,50424,51890,84720,10765,2699,348,0,93287,9027
19,21000,1921000,Des Moines city, Iowa,1,2017,217508,43.5,75.7,12.3,106125,111383,158470,22848,17604,862,307,186175,31333
19,38595,1938595,Iowa City city, Iowa,1,2017,75788,61.7,86.3,10.5,38131,37657,60817,5082,6623,65,0,70338,5450
19,73335,1973335,Sioux City city, Iowa,1,2017,84034,40.8,72.7,13.5,41218,42816,69598,3248,2845,2446,584,67356,16678
19,82425,1982425,Waterloo city, Iowa,1,2017,67588,39.6,77,15.8,32726,34862,51144,10773,1559,175,212,62601,4987
20,36000,2036000,Kansas City city, Kansas,1,2017,155031,40.7,71.9,11.5,76813,78218,89973,35200,6809,691,0,108024,47007
20,38900,2038900,Lawrence city, Kansas,1,2017,95000,57.3,83.3,11.7,45922,49078,76085,4424,6367,2940,0,88601,6399
20,52575,2052575,Olathe city, Kansas,1,2017,137500,42.6,70.7,10.5,67517,69983,115688,8912,6555,415,70,123803,13697
20,53775,2053775,Overland Park city, Kansas,1,2017,191263,40.5,78.3,15.5,96051,95212,157658,9203,16290,1703,210,177174,14089
20,64500,2064500,Shawnee city, Kansas,0,2017,65505,36.8,75.2,13.5,31849,33656,-998,-998,-998,-998,-998,61001,4504
20,71000,2071000,Topeka city, Kansas,1,2017,126588,39.3,76.7,17.5,62259,64329,99349,14888,2264,720,0,108406,18182
20,79000,2079000,Wichita city, Kansas,1,2017,390599,40,75.4,14.7,192567,198032,279723,43005,19548,1951,659,322210,68389
21,8902,2108902,Bowling Green city, Kentucky,0,2017,67067,52.7,78.6,10.4,31418,35649,49671,7621,3129,0,1532,62368,4699
21,46027,2146027,Lexington-Fayette urban county, Kentucky,1,2017,321959,46,78.9,12.9,158325,163634,243170,46595,11729,814,145,298823,23136
21,48006,2148006,Louisville/Jefferson County metro government (balance), Kentucky,1,2017,621337,40.4,77.2,14.4,302759,318578,430744,149461,18182,909,285,585310,36027
22,5000,2205000,Baton Rouge city, Louisiana,1,2017,225370,46.7,77.4,13.5,105153,120217,88963,121365,7850,1111,267,217704,7666
22,8920,2208920,Bossier City city, Louisiana,0,2017,68564,43.9,74.8,13.9,32500,36064,44446,20091,843,307,114,61436,7128
22,39475,2239475,Kenner city, Louisiana,1,2017,67464,38.2,77.2,16,31953,35511,41165,17984,2395,0,0,49076,18388
22,40735,2240735,Lafayette city, Louisiana,1,2017,126847,42.9,77.4,13.3,61386,65461,76388,42310,4003,270,0,122724,4123
22,41155,2241155,Lake Charles city, Louisiana,1,2017,77125,39.4,80.3,17.2,37138,39987,37445,36492,1931,49,0,74538,2587
22,50115,2250115,Metairie CDP, Louisiana,0,2017,146847,37.9,79.4,19.5,71251,75596,115612,16061,6835,371,0,123064,23783
22,55000,2255000,New Orleans city, Louisiana,1,2017,393292,43.5,79.9,14.1,186954,206338,133124,234026,11587,597,28,370968,22324
22,70000,2270000,Shreveport city, Louisiana,1,2017,191715,40.2,75.3,15.5,90501,101214,67308,113251,3320,1039,0,186799,4916
23,60545,2360545,Portland city, Maine,1,2017,66878,49.6,84.9,15.2,32838,34040,55865,7045,2281,144,0,64398,2480
24,4000,2404000,Baltimore city, Maryland,1,2017,611648,44.3,79.4,13.5,286883,324765,183988,383508,16415,2347,128,579153,32495
24,7125,2407125,Bethesda CDP, Maryland,0,2017,68297,33.9,75.6,17.7,32866,35431,54271,4860,6945,6,0,63786,4511
24,19125,2419125,Columbia CDP, Maryland,0,2017,103709,40.9,77.7,14.6,47681,56028,52035,30334,12689,1197,0,96102,7607
24,26000,2426000,Ellicott City CDP, Maryland,0,2017,76727,36.5,75.6,15.8,37833,38894,44377,6441,21104,99,0,73635,3092
24,30325,2430325,Frederick city, Maryland,0,2017,71397,42.8,78.7,13.7,35132,36265,48471,10174,5363,172,0,60668,10729
24,31175,2431175,Gaithersburg city, Maryland,0,2017,68721,41.3,73.6,12.7,34652,34069,29627,11718,10980,316,0,49625,19096
24,32025,2432025,Germantown CDP, Maryland,0,2017,95711,44,75.8,8.3,47329,48382,41630,23897,20023,409,0,71853,23858
24,32650,2432650,Glen Burnie CDP, Maryland,0,2017,70108,45.9,79.5,13.2,31493,38615,40118,19348,4224,0,163,65201,4907
24,67675,2467675,Rockville city, Maryland,0,2017,68400,39.8,76.9,16.4,32214,36186,36687,6827,14831,466,0,57517,10883
24,72450,2472450,Silver Spring CDP, Maryland,0,2017,80265,51,79.1,10.2,39156,41109,34516,23144,5146,481,0,61137,19128
24,81175,2481175,Waldorf CDP, Maryland,0,2017,69519,39.7,75.6,11.3,32712,36807,23841,38545,2900,354,57,63848,5671
25,7000,2507000,Boston city, Massachusetts,1,2017,683015,54.4,84.5,11.7,329816,353199,360756,176868,66207,2133,40,543522,139493
25,9000,2509000,Brockton city, Massachusetts,1,2017,95664,41.7,75.1,13.3,43880,51784,32762,39480,2163,485,0,86735,8929
25,11000,2511000,Cambridge city, Massachusetts,1,2017,113631,63,88.3,12.2,56985,56646,76656,11826,19018,58,87,104035,9596
25,23000,2523000,Fall River city, Massachusetts,1,2017,89415,36.2,77.7,15.9,42019,47396,67839,9721,2046,0,0,80296,9119
25,24960,2524960,Framingham CDP, Massachusetts,0,2017,72045,37.5,74.9,13.2,34545,37500,49786,8305,5038,514,0,60184,11861
25,34550,2534550,Lawrence city, Massachusetts,1,2017,80183,46.7,72.8,10.8,39406,40777,63108,3103,432,271,0,12302,67881
25,37000,2537000,Lowell city, Massachusetts,1,2017,111343,45.8,79.7,12.1,56472,54871,69623,7526,28244,825,67,89196,22147
25,37490,2537490,Lynn city, Massachusetts,1,2017,94064,44,79.7,13.6,48764,45300,48700,13404,6558,463,0,58592,35472
25,45000,2545000,New Bedford city, Massachusetts,1,2017,95110,42.7,79.1,15,46139,48971,61843,5578,2029,0,0,76355,18755
25,45560,2545560,Newton city, Massachusetts,1,2017,88989,39.4,79.9,17.4,40356,48633,67804,3299,13305,0,0,83491,5498
25,55745,2555745,Quincy city, Massachusetts,1,2017,94165,45.1,85.2,15.9,46122,48043,52409,4592,32865,69,365,91443,2722
25,62535,2562535,Somerville city, Massachusetts,1,2017,81361,61.5,87.3,9.2,41380,39981,62971,6214,7605,0,4,70597,10764
25,67000,2567000,Springfield city, Massachusetts,1,2017,154763,44.4,76.2,12.3,72705,82058,103166,33235,2832,1021,56,85296,69467
25,82000,2582000,Worcester city, Massachusetts,1,2017,185685,47,80.5,13.6,87756,97929,129300,24025,12612,1788,55,143349,42336
26,3000,2603000,Ann Arbor city, Michigan,1,2017,121461,61.3,87.1,12.1,59659,61802,85136,8567,22374,326,0,116127,5334
26,21000,2621000,Dearborn city, Michigan,1,2017,94497,42.6,69.6,11.9,46237,48260,84918,3477,1938,40,0,91291,3206
26,22000,2622000,Detroit city, Michigan,1,2017,673103,41,75.1,14,319063,354040,97402,532057,11938,2656,134,624775,48328
26,27440,2627440,Farmington Hills city, Michigan,1,2017,81048,38.1,83.4,19.7,40019,41029,50870,14166,13445,166,30,79314,1734
26,29000,2629000,Flint city, Michigan,1,2017,96439,41.5,78.6,13.8,48391,48048,36807,51514,1229,790,0,91871,4568
26,34000,2634000,Grand Rapids city, Michigan,1,2017,198811,49.6,77.8,11.4,99549,99262,131052,39083,7056,631,0,166795,32016
26,42160,2642160,Kalamazoo city, Michigan,1,2017,75802,57.7,82.3,11.3,38105,37697,52529,16826,1785,43,0,70736,5066
26,46000,2646000,Lansing city, Michigan,1,2017,115451,46.2,77.2,11.5,54786,60665,70081,26706,6457,692,0,100839,14612
26,49000,2649000,Livonia city, Michigan,1,2017,94108,35.5,81.7,20.7,45552,48556,84937,4907,2541,56,0,91758,2350
26,69035,2669035,Rochester Hills city, Michigan,1,2017,74198,35.5,77.6,18.3,35910,38288,60712,2413,8020,136,0,71789,2409
26,74900,2674900,Southfield city, Michigan,1,2017,73203,37.7,81.3,19.4,33365,39838,15034,51991,1513,36,0,71199,2004
26,76460,2676460,Sterling Heights city, Michigan,1,2017,132628,40.4,80,16.9,65147,67481,108981,8139,9319,402,0,125101,7527
26,80700,2680700,Troy city, Michigan,1,2017,83826,38.3,78.5,15.9,41435,42391,57206,3109,21178,405,0,81806,2020
26,84000,2684000,Warren city, Michigan,1,2017,135029,38,78.5,16.1,67195,67834,91620,27976,12584,38,80,132290,2739
26,86000,2686000,Westland city, Michigan,1,2017,81750,36.8,81,17.7,38107,43643,59182,14468,3353,623,0,78081,3669
26,88940,2688940,Wyoming city, Michigan,1,2017,75938,38.9,75.5,12.6,37409,38529,56169,4524,1555,717,139,59932,16006
27,6616,2706616,Bloomington city, Minnesota,1,2017,85863,34.6,81.6,21.1,41762,44101,64527,11314,3708,85,0,79504,6359
27,7966,2707966,Brooklyn Park city, Minnesota,1,2017,80573,39.1,72.7,13,38988,41585,37054,22323,15905,612,0,77031,3542
27,17000,2717000,Duluth city, Minnesota,1,2017,86048,46.8,81.8,15.3,41532,44516,77606,1874,1127,1667,60,83691,2357
27,17288,2717288,Eagan city, Minnesota,0,2017,66623,41.6,76.2,12.2,31886,34737,49683,7637,6322,32,289,64000,2623
27,40166,2740166,Maple Grove city, Minnesota,0,2017,71069,35.9,72.2,12.2,34557,36512,55995,7225,4497,240,0,69988,1081
27,43000,2743000,Minneapolis city, Minnesota,1,2017,422326,51.7,80.1,10,211482,210844,265357,76107,27118,7272,81,375951,46375
27,51730,2751730,Plymouth city, Minnesota,1,2017,78388,37.3,76.2,14.4,36128,42260,64168,4107,7139,678,0,74219,4169
27,54880,2754880,Rochester city, Minnesota,1,2017,115733,42,75.9,14.8,55312,60421,92692,9459,7560,329,0,109246,6487
27,56896,2756896,St. Cloud city, Minnesota,0,2017,65403,47.4,79,12.4,32876,32527,51348,9253,1987,394,0,63431,1972
27,58000,2758000,St. Paul city, Minnesota,1,2017,306604,47.4,74.3,10.2,151108,155496,171021,52354,61082,2382,123,276597,30007
27,71428,2771428,Woodbury city, Minnesota,0,2017,69755,38.9,71,12.1,33593,36162,55898,4404,7101,236,9,66920,2835
28,29700,2829700,Gulfport city, Mississippi,1,2017,71812,40.5,75.4,14.5,32958,38854,40391,28821,292,596,0,68197,3615
28,36000,2836000,Jackson city, Mississippi,1,2017,167250,43.3,74.8,12.4,78721,88529,-998,-998,-998,-998,-998,165245,2005
29,15670,2915670,Columbia city, Missouri,1,2017,121720,56,82.1,10.8,59077,62643,92780,13174,7066,437,1769,117401,4319
29,35000,2935000,Independence city, Missouri,1,2017,117308,38,74.6,16.7,56585,60723,89404,6683,1383,923,1527,100200,17108
29,38000,2938000,Kansas City city, Missouri,1,2017,488825,43.4,77.3,12.7,237521,251304,293200,139386,15452,2850,647,442850,45975
29,41348,2941348,Lee's Summit city, Missouri,1,2017,97101,36.4,72.7,15.3,46677,50424,85727,5690,2185,174,80,92382,4719
29,54074,2954074,O'Fallon city, Missouri,1,2017,87578,40.3,70.3,11.6,45455,42123,79044,2341,2964,0,0,83942,3636
29,64082,2964082,St. Charles city, Missouri,0,2017,70335,46.1,84.2,16.8,32658,37677,60311,4562,1806,72,0,67526,2809
29,64550,2964550,St. Joseph city, Missouri,1,2017,76643,40.4,77,16.1,37686,38957,65430,3591,959,270,1209,70779,5864
29,65000,2965000,St. Louis city, Missouri,1,2017,308626,45.3,80.6,12.9,149544,159082,142956,144539,10477,1196,0,296179,12447
29,70000,2970000,Springfield city, Missouri,1,2017,167376,46.8,81.8,16.1,81045,86331,148924,6072,3879,1000,384,158815,8561
30,6550,3006550,Billings city, Montana,1,2017,109642,39,77.4,17.9,53417,56225,96903,1174,893,4263,579,102706,6936
30,50200,3050200,Missoula city, Montana,1,2017,73338,52.1,81.3,12.6,36751,36587,68104,106,1424,1033,0,71579,1759
31,28000,3128000,Lincoln city, Nebraska,1,2017,284734,45.9,76.9,13.1,143324,141410,241622,11717,14122,2053,174,262813,21921
31,37000,3137000,Omaha city, Nebraska,1,2017,466903,42.2,75.2,13,230216,236687,365552,57454,17470,2358,312,400847,66056
32,23770,3223770,Enterprise CDP, Nevada,0,2017,168011,45.9,74.7,11.3,85073,82938,90654,17653,37983,161,2445,135975,32036
32,31900,3231900,Henderson city, Nevada,1,2017,302535,36.5,79.7,20.7,148218,154317,228746,19170,32103,612,703,258058,44477
32,40000,3240000,Las Vegas city, Nevada,1,2017,641708,39.8,76.3,14.2,320805,320903,398287,68390,45490,5423,5832,422488,219220
32,51800,3251800,North Las Vegas city, Nevada,1,2017,242949,42.5,71.3,10.4,121077,121872,124071,51743,18558,1956,736,138538,104411
32,54600,3254600,Paradise CDP, Nevada,0,2017,235123,44.6,80.5,12.6,117778,117345,113030,28737,31043,1584,2169,159104,76019
32,60600,3260600,Reno city, Nevada,1,2017,248860,42.4,77.6,14.5,123719,125141,184947,7791,16988,2949,2309,183895,64965
32,68400,3268400,Sparks city, Nevada,1,2017,100878,40.3,78.7,16.7,50909,49969,77994,1341,6289,1878,44,72984,27894
32,68585,3268585,Spring Valley CDP, Nevada,0,2017,211280,41.7,78.3,13.9,104664,106616,113309,27443,32931,548,1793,153780,57500
32,71400,3271400,Sunrise Manor CDP, Nevada,0,2017,193055,44.7,72.8,10.1,96010,97045,90714,28130,10516,3191,968,89830,103225
33,45140,3345140,Manchester city, New Hampshire,1,2017,111194,44.9,79,12.4,57626,53568,97724,5688,4146,127,57,100098,11096
33,50260,3350260,Nashua city, New Hampshire,1,2017,88350,40.2,80.2,15.6,42371,45979,69419,5078,8908,112,0,77171,11179
34,3580,3403580,Bayonne city, New Jersey,0,2017,67178,40.7,78.5,14.6,32340,34838,45540,4683,4339,201,0,42123,25055
34,10000,3410000,Camden city, New Jersey,1,2017,74534,44,69.8,10.4,33364,41170,23168,32032,2286,438,155,39823,34711
34,13690,3413690,Clifton city, New Jersey,1,2017,86615,40.9,81,15.5,41581,45034,54474,4764,10170,59,0,51725,34890
34,19390,3419390,East Orange city, New Jersey,0,2017,65399,44.9,78.7,13.3,29543,35856,2274,55684,1294,0,0,57358,8041
34,21000,3421000,Elizabeth city, New Jersey,1,2017,130222,42.9,71.9,10.1,64678,65544,52817,23971,1752,837,0,41920,88302
34,36000,3436000,Jersey City city, New Jersey,1,2017,270750,49.4,78.8,11.4,133799,136951,92904,63621,71641,1910,70,190928,79822
34,51000,3451000,Newark city, New Jersey,1,2017,285156,44.8,75.4,10.6,138029,147127,77158,144527,5106,488,215,182070,103086
34,56550,3456550,Passaic city, New Jersey,1,2017,71245,42.9,65.5,7.5,36728,34517,57198,4576,1420,6,0,18393,52852
34,57000,3457000,Paterson city, New Jersey,1,2017,148678,44.5,72.8,10.6,70773,77905,48001,36991,6700,71,0,58610,90068
34,73110,3473110,Toms River CDP, New Jersey,0,2017,89861,35.1,77.6,18.2,41960,47901,75116,5295,3349,82,0,82388,7473
34,74000,3474000,Trenton city, New Jersey,1,2017,84971,43.7,73.7,10.1,42531,42440,34506,45681,442,117,0,53874,31097
34,74630,3474630,Union City city, New Jersey,1,2017,70409,48.8,78,9.9,33693,36716,54528,3016,1953,154,0,18091,52318
35,2000,3502000,Albuquerque city, New Mexico,1,2017,558558,41.5,77.2,15.5,272308,286250,427155,17234,16181,24814,460,281307,277251
35,39380,3539380,Las Cruces city, New Mexico,1,2017,101706,43.6,76.4,14.3,51099,50607,84861,3342,1437,1263,0,39541,62165
35,63460,3563460,Rio Rancho city, New Mexico,1,2017,96168,39.6,76,15.2,46502,49666,82754,2060,1536,1581,102,54581,41587
35,70500,3570500,Santa Fe city, New Mexico,1,2017,83763,36.7,80.8,21.7,39549,44214,72668,1471,1556,1139,272,35878,47885
36,1000,3601000,Albany city, New York,1,2017,98252,50.5,80.9,13.5,46328,51924,52325,27944,8647,337,0,87833,10419
36,8026,3608026,Brentwood CDP, New York,0,2017,66458,46.7,75.2,7.8,32322,34136,41852,9367,543,189,0,15254,51204
36,11000,3611000,Buffalo city, New York,1,2017,258592,45.8,77.7,12,123489,135103,120836,92529,17442,894,8,227211,31381
36,15000,3615000,Cheektowaga CDP, New York,0,2017,73232,39.4,81.4,17.7,35834,37398,58081,11004,1355,212,0,71215,2017
36,49121,3649121,Mount Vernon city, New York,1,2017,68702,41.8,83.4,19.1,30077,38625,12392,47745,2322,374,0,59765,8937
36,50617,3650617,New Rochelle city, New York,1,2017,79956,40.1,81.9,16.4,38526,41430,44955,16122,4005,0,129,57014,22942
36,51000,3651000,New York city, New York,1,2017,8622698,43.7,79.3,14.3,4112539,4510159,3635789,2094132,1252589,35124,4501,6105269,2517429
36,63000,3663000,Rochester city, New York,1,2017,208049,46.5,78.8,11.8,100561,107488,94639,84754,7937,1946,0,171663,36386
36,65508,3665508,Schenectady city, New York,1,2017,65626,41.8,79.3,12.7,30251,35375,39908,14336,5001,211,0,59067,6559
36,73000,3673000,Syracuse city, New York,1,2017,143398,47,77.1,11.9,67752,75646,75611,44421,12536,1368,11,129008,14390
36,84000,3684000,Yonkers city, New York,1,2017,202008,39.9,77.9,17.1,98347,103661,107404,36815,15098,2446,247,124103,77905
37,2140,3702140,Asheville city, North Carolina,1,2017,91916,42.1,83.1,19.9,43818,48098,77066,11683,1015,173,0,86161,5755
37,10740,3710740,Cary town, North Carolina,1,2017,166032,37.1,75.1,12.8,82634,83398,113595,10200,33395,579,0,152017,14015
37,12000,3712000,Charlotte city, North Carolina,1,2017,859052,46.2,76.9,10.3,413747,445305,422843,295190,55381,4117,376,736148,122904
37,14100,3714100,Concord city, North Carolina,1,2017,92072,40.6,73.5,12,46815,45257,61079,19412,4309,772,0,78193,13879
37,19000,3719000,Durham city, North Carolina,1,2017,267932,47,78.5,12.1,124894,143038,133399,103002,13345,567,123,232506,35426
37,22920,3722920,Fayetteville city, North Carolina,1,2017,209913,48.1,77.4,12.2,106697,103216,93664,87632,6798,2293,1425,183656,26257
37,25580,3725580,Gastonia city, North Carolina,1,2017,76606,38.4,77.2,16.7,36117,40489,50071,21548,1302,233,0,68351,8255
37,28000,3728000,Greensboro city, North Carolina,1,2017,290201,43.5,79,13.8,136581,153620,139750,124515,12969,1430,199,270237,19964
37,28080,3728080,Greenville city, North Carolina,1,2017,92171,54.7,80.1,10.7,41413,50758,53154,32920,1174,0,176,87071,5100
37,31400,3731400,High Point city, North Carolina,1,2017,111213,40.6,76,15.8,50953,60260,58283,40001,7755,731,19,101085,10128
37,34200,3734200,Jacksonville city, North Carolina,1,2017,72448,63.4,76.9,6.3,44516,27932,49008,15370,2855,357,0,60751,11697
37,55000,3755000,Raleigh city, North Carolina,1,2017,464972,50,78.9,10.1,225445,239527,264298,135972,23510,1169,373,413886,51086
37,74440,3774440,Wilmington city, North Carolina,1,2017,119048,44.1,82.7,16.2,54908,64140,91907,20586,1167,464,1124,111685,7363
37,75000,3775000,Winston-Salem city, North Carolina,1,2017,244592,42.2,77.5,14.2,115929,128663,141837,82611,7328,1179,325,210114,34478
38,7200,3807200,Bismarck city, North Dakota,0,2017,71574,40.8,78.2,16,35793,35781,64899,1791,685,2807,0,70005,1569
38,25700,3825700,Fargo city, North Dakota,1,2017,123590,51.9,79,10.9,63384,60206,103635,9715,4778,1565,68,120005,3585
39,1000,3901000,Akron city, Ohio,1,2017,197849,41.7,79.1,14.8,93399,104450,118028,61571,8007,618,231,192313,5536
39,12000,3912000,Canton city, Ohio,1,2017,70893,42.3,76.5,13.1,33880,37013,51995,13771,370,136,43,68528,2365
39,15000,3915000,Cincinnati city, Ohio,1,2017,301305,46.6,78.9,13,146042,155263,151869,128044,7944,258,531,289518,11787
39,16000,3916000,Cleveland city, Ohio,1,2017,385552,41.1,77.1,13.7,182588,202964,150623,187759,9319,1871,36,337590,47962
39,18000,3918000,Columbus city, Ohio,1,2017,881901,48.2,77.4,10.2,432198,449703,520193,252625,53100,2698,369,826119,55782
39,21000,3921000,Dayton city, Ohio,1,2017,140379,44.6,79.5,12,70968,69411,75045,57356,897,404,0,134614,5765
39,44856,3944856,Lorain city, Ohio,0,2017,63840,38.1,76.1,17.8,30683,33157,45638,10618,1035,766,0,44826,19014
39,61000,3961000,Parma city, Ohio,1,2017,79159,37,83.5,17.9,38766,40393,71137,3035,1173,494,0,75621,3538
39,77000,3977000,Toledo city, Ohio,1,2017,276494,40.9,76.9,14.1,132740,143754,174497,76093,3679,675,85,253698,22796
39,88000,3988000,Youngstown city, Ohio,1,2017,64585,39.2,77.9,16.2,32365,32220,30019,26630,586,382,44,56541,8044
40,9050,4009050,Broken Arrow city, Oklahoma,1,2017,110468,38.4,73.5,13.6,54357,56111,85818,4618,4496,5246,80,102271,8197
40,23200,4023200,Edmond city, Oklahoma,1,2017,91936,40.5,74.5,15.7,43683,48253,73117,5530,3575,1629,0,86620,5316
40,41850,4041850,Lawton city, Oklahoma,1,2017,93717,46.5,76.1,11.9,48139,45578,54392,16567,3103,5095,657,80593,13124
40,52500,4052500,Norman city, Oklahoma,1,2017,122842,53.1,81.6,12.2,62107,60735,92920,6656,5142,4087,0,113222,9620
40,55000,4055000,Oklahoma City city, Oklahoma,1,2017,643574,41.9,73.6,12.1,319377,324197,434367,96880,29388,15701,469,514916,128658
40,75000,4075000,Tulsa city, Oklahoma,1,2017,402227,41.1,75.9,14.2,193052,209175,259527,60102,16462,17280,546,334361,67866
41,5350,4105350,Beaverton city, Oregon,1,2017,97529,44.2,80.7,13.9,46400,51129,70799,1911,14708,1184,0,84681,12848
41,5800,4105800,Bend city, Oregon,1,2017,94527,36,76,18.4,43773,50754,88534,969,2026,564,0,83551,10976
41,23850,4123850,Eugene city, Oregon,1,2017,168909,47.5,82.9,16.6,82936,85973,142508,2008,7442,558,94,154429,14480
41,31250,4131250,Gresham city, Oregon,1,2017,111039,42.2,76.2,13.1,55341,55698,84795,7469,5908,1758,51,91684,19355
41,34100,4134100,Hillsboro city, Oregon,1,2017,106903,47.9,75.9,9,53652,53251,76436,2689,12829,146,394,80780,26123
41,47000,4147000,Medford city, Oregon,1,2017,81777,37.8,76.1,19,39261,42516,73369,398,1186,2594,34,69393,12384
41,59000,4159000,Portland city, Oregon,1,2017,648121,47.6,81.6,12.5,321499,326622,500694,35587,52428,5994,4952,580570,67551
41,64900,4164900,Salem city, Oregon,1,2017,169790,41.4,75.6,14.9,88283,81507,136140,2379,4644,1450,3930,127946,41844
42,2000,4202000,Allentown city, Pennsylvania,1,2017,121278,46,74.1,11.3,58637,62641,77546,15967,2797,1486,0,57171,64107
42,6088,4206088,Bethlehem city, Pennsylvania,1,2017,76469,45.7,80.2,13.8,35861,40608,57747,9135,1945,57,0,54885,21584
42,24000,4224000,Erie city, Pennsylvania,1,2017,97369,41.9,77.5,14.7,48482,48887,71712,14495,3175,91,47,90026,7343
42,60000,4260000,Philadelphia city, Pennsylvania,1,2017,1580863,44.8,78.2,13.4,748125,832738,665060,663708,115279,5742,406,1346680,234183
42,61000,4261000,Pittsburgh city, Pennsylvania,1,2017,302414,51,85.7,15.4,149787,152627,202557,66826,19576,748,104,293202,9212
42,63624,4263624,Reading city, Pennsylvania,1,2017,88418,43.8,69.6,10.2,42478,45940,43674,16110,402,1730,0,29682,58736
42,69000,4269000,Scranton city, Pennsylvania,1,2017,77597,42.6,78.4,16.9,38262,39335,66389,2822,4825,24,78,66416,11181
44,19180,4419180,Cranston city, Rhode Island,1,2017,81192,39.5,78.1,17.7,41677,39515,63746,4899,6707,554,41,67660,13532
44,54640,4454640,Pawtucket city, Rhode Island,1,2017,72006,44.2,79.1,13.7,36738,35268,43971,11299,1669,384,42,54104,17902
44,59000,4459000,Providence city, Rhode Island,1,2017,180388,47.7,77.6,11.8,87472,92916,109883,31037,9371,1578,648,102495,77893
44,74300,4474300,Warwick city, Rhode Island,1,2017,80873,37.3,82.2,19.2,38411,42462,73430,1430,2890,39,0,75850,5023
45,13330,4513330,Charleston city, South Carolina,1,2017,139906,47.1,82.3,13.5,68879,71027,105774,29800,1330,247,0,135404,4502
45,16000,4516000,Columbia city, South Carolina,1,2017,133578,57.2,84.5,9.3,67831,65747,67486,56854,4285,323,14,125993,7585
45,30850,4530850,Greenville city, South Carolina,0,2017,68223,48.1,84.8,13.2,33265,34958,47062,16321,1541,357,246,64037,4186
45,48535,4548535,Mount Pleasant town, South Carolina,1,2017,86668,35.1,78.3,18.6,40963,45705,76930,3615,1947,219,0,85208,1460
45,50875,4550875,North Charleston city, South Carolina,1,2017,112742,44.8,76.5,11.4,55158,57584,58536,49050,1333,325,0,100185,12557
45,61405,4561405,Rock Hill city, South Carolina,1,2017,73064,47,77.2,11,34458,38606,40955,28137,1680,162,0,69745,3319
46,52980,4652980,Rapid City city, South Dakota,1,2017,74418,38.9,76.9,18.2,36967,37451,59634,957,1246,8444,198,70601,3817
46,59020,4659020,Sioux Falls city, South Dakota,1,2017,176898,41.6,75.7,12.8,87562,89336,150977,11396,3756,2802,37,167837,9061
47,14000,4714000,Chattanooga city, Tennessee,1,2017,179130,41.9,81.2,17.7,82083,97047,109476,57983,6361,259,0,167052,12078
47,15160,4715160,Clarksville city, Tennessee,1,2017,153210,50.4,72.3,8.1,76094,77116,102154,35411,3369,672,860,135017,18193
47,27740,4727740,Franklin city, Tennessee,0,2017,78311,38,77.8,15,36895,41416,64193,6198,5472,31,0,73128,5183
47,37640,4737640,Jackson city, Tennessee,0,2017,66856,39.9,76.3,14.6,30743,36113,-998,-998,-998,-998,-998,63198,3658
47,38320,4738320,Johnson City city, Tennessee,0,2017,65816,46.4,79.8,14.2,31173,34643,55454,5230,2360,206,0,61761,4055
47,40000,4740000,Knoxville city, Tennessee,1,2017,187344,48.5,80,12.6,90919,96425,142909,32623,4006,287,0,175285,12059
47,48000,4748000,Memphis city, Tennessee,1,2017,652231,42.9,74.7,12.5,307409,344822,190438,415179,10949,1332,346,601850,50381
47,51560,4751560,Murfreesboro city, Tennessee,1,2017,136372,50.6,74,8.7,66707,69665,97605,29076,3869,264,0,125994,10378
47,52006,4752006,Nashville-Davidson metropolitan government (balance), Tennessee,1,2017,665967,47,79,11.6,321749,344218,427261,181659,24150,1507,598,596393,69574
48,1000,4801000,Abilene city, Texas,1,2017,123304,47.4,76.2,13.1,64353,58951,83534,13074,2945,1155,0,90033,33271
48,1924,4801924,Allen city, Texas,1,2017,100679,37.6,70.2,8.7,48298,52381,70552,6575,17968,231,0,90031,10648
48,3000,4803000,Amarillo city, Texas,1,2017,200558,41.6,72.8,12.7,100562,99996,164362,12974,7261,763,231,132272,68286
48,4000,4804000,Arlington city, Texas,1,2017,396407,43.7,73,10.2,192415,203992,235389,99168,22775,1188,404,277928,118479
48,4462,4804462,Atascocita CDP, Texas,0,2017,84443,40.5,67.9,8.1,42445,41998,58675,14677,3068,433,0,57819,26624
48,5000,4805000,Austin city, Texas,1,2017,950714,51.7,79.7,9.4,481582,469132,680312,73472,71831,7793,208,625741,324973
48,6128,4806128,Baytown city, Texas,1,2017,77862,42.6,73.6,12.4,37885,39977,60862,11978,525,242,133,42260,35602
48,7000,4807000,Beaumont city, Texas,1,2017,119126,42,73.3,13,58577,60549,54560,55796,3269,0,155,97717,21409
48,10768,4810768,Brownsville city, Texas,1,2017,183292,42,70.4,12.7,90216,93076,177940,364,441,367,0,10964,172328
48,10912,4810912,Bryan city, Texas,1,2017,84029,49.4,76.4,11.5,41713,42316,61756,14189,1590,95,33,50285,33744
48,13024,4813024,Carrollton city, Texas,1,2017,135709,43.5,75.6,9.6,66354,69355,97380,13698,18079,1307,0,85001,50708
48,13552,4813552,Cedar Park city, Texas,0,2017,75238,46.4,69,7.2,39202,36036,59069,2046,6511,209,40,57448,17790
48,15976,4815976,College Station city, Texas,1,2017,113563,66,82.6,6,58488,55075,88010,8571,11197,503,0,95997,17566
48,16432,4816432,Conroe city, Texas,0,2017,84379,40.8,72.4,12.9,40632,43747,70336,8748,1624,136,73,54650,29729
48,17000,4817000,Corpus Christi city, Texas,1,2017,325600,41.5,75.2,13.9,160180,165420,294497,12879,7659,1462,137,120023,205577
48,19000,4819000,Dallas city, Texas,1,2017,1341103,46.6,74.9,10.5,661926,679177,843610,328114,49720,4245,959,779648,561455
48,19972,4819972,Denton city, Texas,1,2017,136266,51.8,81.4,11.5,66388,69878,104612,13388,6396,443,280,101015,35251
48,22660,4822660,Edinburg city, Texas,1,2017,90271,45.6,66.4,8,41853,48418,80715,2184,2828,355,0,11318,78953
48,24000,4824000,El Paso city, Texas,1,2017,683583,42.6,73.1,12.7,334472,349111,519553,25511,10178,3424,812,127004,556579
48,26232,4826232,Flower Mound town, Texas,0,2017,76592,33.1,72.9,11,37006,39586,58946,5153,8547,204,83,69863,6729
48,27000,4827000,Fort Worth city, Texas,1,2017,876060,45,73,9.9,427742,448318,556658,155053,38469,2323,404,559724,316336
48,27684,4827684,Frisco city, Texas,1,2017,177281,40,68.5,7.9,88785,88496,116863,11427,36615,889,33,152238,25043
48,29000,4829000,Garland city, Texas,1,2017,237607,40.7,74.7,12.2,119791,117816,156964,34742,25466,884,0,142898,94709
48,29336,4829336,Georgetown city, Texas,0,2017,70696,33,81.7,28.2,32148,38548,60049,3831,321,108,63,57831,12865
48,30464,4830464,Grand Prairie city, Texas,1,2017,193812,42.1,71.4,8.6,94632,99180,116834,43092,15401,879,144,103200,90612
48,32372,4832372,Harlingen city, Texas,0,2017,65462,37.8,65.5,14.8,33502,31960,59188,540,1656,424,0,13260,52202
48,35000,4835000,Houston city, Texas,1,2017,2313230,45.5,74.6,10.6,1156106,1157124,1371725,530579,150310,6985,1118,1280610,1032620
48,37000,4837000,Irving city, Texas,1,2017,240369,48.1,71.8,7.1,122086,118283,113887,35875,45151,1663,72,135560,104809
48,39148,4839148,Killeen city, Texas,1,2017,145484,51.3,70.6,6.8,70277,75207,63583,54588,7910,1489,2070,104983,40501
48,41464,4841464,Laredo city, Texas,1,2017,261935,43.1,66.7,9.3,127842,134093,251077,581,1562,569,93,12191,249744
48,41980,4841980,League City city, Texas,1,2017,105105,41.9,68,9.3,50718,54387,85771,9045,7695,178,0,89164,15941
48,42508,4842508,Lewisville city, Texas,1,2017,106656,50.1,77,8.1,52608,54048,66848,18207,12924,757,149,73309,33347
48,43888,4843888,Longview city, Texas,1,2017,83081,42.3,73.8,14.6,40937,42144,59453,19200,1314,21,375,66406,16675
48,45000,4845000,Lubbock city, Texas,1,2017,253887,48.4,77.2,12.1,123407,130480,207562,21585,7070,2135,259,162407,91480
48,45384,4845384,McAllen city, Texas,1,2017,142699,41,73.4,13.8,73765,68934,108627,1066,3478,700,372,20938,121761
48,45744,4845744,McKinney city, Texas,1,2017,181330,41.1,69.3,9.9,86229,95101,135273,22531,15911,901,0,149974,31356
48,46452,4846452,Mansfield city, Texas,0,2017,69007,41.7,71.9,10.1,33907,35100,49900,12609,1898,77,0,55930,13077
48,47892,4847892,Mesquite city, Texas,1,2017,143822,39.4,68.7,9.9,70341,73481,96586,32704,4165,418,0,81117,62705
48,48072,4848072,Midland city, Texas,1,2017,136090,43.9,72.7,11.3,69972,66118,112372,11290,3339,419,0,76593,59497
48,48768,4848768,Mission city, Texas,1,2017,84428,39.4,70.9,15.4,39804,44624,-998,-998,-998,-998,-998,9906,74522
48,48804,4848804,Missouri City city, Texas,1,2017,72519,35.4,74.4,15.6,35054,37465,21966,26821,19363,0,0,59791,12728
48,50820,4850820,New Braunfels city, Texas,0,2017,82306,40.5,71.9,14.9,40618,41688,76133,1059,1077,438,0,55593,26713
48,52356,4852356,North Richland Hills city, Texas,0,2017,70446,35.9,78.2,17,34462,35984,58051,3588,3385,1430,77,57832,12614
48,53388,4853388,Odessa city, Texas,1,2017,117105,46.1,71.2,9.9,56690,60415,85447,6580,2163,432,277,50596,66509
48,56000,4856000,Pasadena city, Texas,1,2017,153533,42.5,68.7,9.1,80017,73516,136392,5541,2801,364,45,44043,109490
48,56348,4856348,Pearland city, Texas,1,2017,125198,42.3,71.9,10.4,61341,63857,79573,23842,14143,1025,0,94821,30377
48,57200,4857200,Pharr city, Texas,1,2017,79491,41.6,67.1,12.5,40961,38530,-998,-998,-998,-998,-998,4002,75489
48,58016,4858016,Plano city, Texas,1,2017,285312,41.2,78.1,13.1,141927,143385,188118,26049,56201,1173,277,243470,41842
48,61796,4861796,Richardson city, Texas,1,2017,116783,42.7,76.4,16.4,56838,59945,79246,12610,17220,208,236,95062,21721
48,63500,4863500,Round Rock city, Texas,1,2017,123560,46.3,73.2,8.2,61648,61912,88008,15202,9943,164,0,87676,35884
48,64472,4864472,San Angelo city, Texas,1,2017,94940,43.4,77.8,15.8,45984,48956,73296,5202,1308,389,108,52754,42186
48,65000,4865000,San Antonio city, Texas,1,2017,1511913,44.3,75.2,12.2,745850,766063,1206751,105602,39920,6373,1619,542848,969065
48,70808,4870808,Sugar Land city, Texas,1,2017,88488,38.8,78.9,13.8,43556,44932,44629,2781,38239,169,0,77135,11353
48,72176,4872176,Temple city, Texas,0,2017,74494,39.5,73.5,15,34689,39805,60080,10471,770,210,0,54725,19769
48,72656,4872656,The Woodlands CDP, Texas,0,2017,115097,34.4,74.3,11.6,57807,57290,94997,4943,9770,244,223,99495,15602
48,74144,4874144,Tyler city, Texas,1,2017,104998,41.6,75.6,16.6,49296,55702,71821,27141,2052,254,0,81992,23006
48,75428,4875428,Victoria city, Texas,0,2017,67102,40.5,74.5,15.6,32170,34932,57456,5467,386,519,0,31402,35700
48,76000,4876000,Waco city, Texas,1,2017,136437,48.6,75.3,12.1,65256,71181,93572,28535,3527,1349,0,91119,45318
48,79000,4879000,Wichita Falls city, Texas,1,2017,104745,46.5,78.1,14,54105,50640,74665,13096,2130,1306,88,81836,22909
49,43660,4943660,Layton city, Utah,1,2017,76694,44.2,70,10.6,38705,37989,67966,925,2061,642,832,67856,8838
49,55980,4955980,Ogden city, Utah,1,2017,87037,45.1,72.5,10.9,44474,42563,69580,2241,512,1226,193,58286,28751
49,57300,4957300,Orem city, Utah,1,2017,97840,48.5,68.8,9.1,50264,47576,87802,482,2972,786,1905,85035,12805
49,62470,4962470,Provo city, Utah,1,2017,117331,64.1,78.9,6.2,57144,60187,103720,1254,3520,330,530,96987,20344
49,65330,4965330,St. George city, Utah,1,2017,84390,37.4,75.8,23.6,42516,41874,75083,931,2591,87,1237,74898,9492
49,67000,4967000,Salt Lake City city, Utah,1,2017,200538,51.3,78.1,10.5,99185,101353,146460,3419,10910,3342,3906,158831,41707
49,67440,4967440,Sandy city, Utah,1,2017,96146,40.5,74,14.1,48038,48108,88188,508,2539,314,282,84517,11629
49,70850,4970850,South Jordan city, Utah,0,2017,70953,38.4,68,11.6,33932,37021,62795,322,3180,201,1142,66159,4794
49,82950,4982950,West Jordan city, Utah,1,2017,113921,48.9,69.1,6.9,56801,57120,83353,1483,3783,748,445,85945,27976
49,83470,4983470,West Valley City city, Utah,1,2017,136166,46,69.5,9.6,72303,63863,75672,4128,6997,955,3721,86486,49680
51,1000,5101000,Alexandria city, Virginia,1,2017,160035,49.6,82,11.2,76850,83185,98509,37374,9296,595,60,133405,26630
51,3000,5103000,Arlington CDP, Virginia,0,2017,234965,51.5,82.1,10.2,116424,118541,166594,22603,24948,648,0,198228,36737
51,14440,5114440,Centreville CDP, Virginia,0,2017,78355,41.9,75.3,7.6,39362,38993,37288,8720,25068,247,58,65661,12694
51,16000,5116000,Chesapeake city, Virginia,1,2017,240397,40.1,75.7,12.8,117602,122795,146245,73562,7690,580,71,225576,14821
51,21088,5121088,Dale City CDP, Virginia,0,2017,70223,41.5,75.3,9.8,35995,34228,32753,18163,5259,184,118,48274,21949
51,35000,5135000,Hampton city, Virginia,1,2017,134669,42.9,79.1,15,65262,69407,54485,66723,3334,436,159,126956,7713
51,47672,5147672,Lynchburg city, Virginia,1,2017,80995,51.8,80.6,14.3,37085,43910,52171,22349,2168,555,31,77742,3253
51,56000,5156000,Newport News city, Virginia,1,2017,179388,44.2,76.8,12.7,86834,92554,87810,72769,5799,928,159,163100,16288
51,57000,5157000,Norfolk city, Virginia,1,2017,244703,51.3,80.2,10.9,127975,116728,113412,101382,8664,1095,137,225100,19603
51,64000,5164000,Portsmouth city, Virginia,1,2017,94572,41.5,77,14.6,45149,49423,37326,50430,1294,494,70,90371,4201
51,67000,5167000,Richmond city, Virginia,1,2017,227032,48.7,82.2,12.7,107065,119967,103616,107022,4645,90,0,211731,15301
51,68000,5168000,Roanoke city, Virginia,1,2017,99837,38.5,78.3,16.9,47869,51968,61187,28160,3141,337,0,93471,6366
51,76432,5176432,Suffolk city, Virginia,1,2017,90237,37.9,75.6,14.2,43664,46573,46675,37496,2023,323,0,86232,4005
51,82000,5182000,Virginia Beach city, Virginia,1,2017,450435,42.7,77.7,13.7,221666,228769,294819,85486,30751,1123,365,413712,36723
53,3180,5303180,Auburn city, Washington,1,2017,79619,43.8,75,8.9,40175,39444,55067,3120,8951,915,2918,70333,9286
53,5210,5305210,Bellevue city, Washington,1,2017,144459,42.7,80.3,14.1,75054,69405,81117,3846,49669,364,1097,133830,10629
53,5280,5305280,Bellingham city, Washington,1,2017,89044,51.4,87,17.3,44318,44726,75006,1276,4802,1285,0,81881,7163
53,22640,5322640,Everett city, Washington,1,2017,110086,46.1,80.3,11.1,57254,52832,80644,6554,9083,286,355,92997,17089
53,23515,5323515,Federal Way city, Washington,1,2017,96691,42.4,78.1,14.2,48140,48551,49919,12084,13734,643,1060,76724,19967
53,35275,5335275,Kennewick city, Washington,1,2017,81601,40.7,72.6,16,41094,40507,64682,1678,2569,1639,0,55288,26313
53,35415,5335415,Kent city, Washington,1,2017,128463,44.4,76.3,11.8,66228,62235,65623,12087,27681,956,761,109148,19315
53,35940,5335940,Kirkland city, Washington,0,2017,88630,44.5,78.8,11.4,43243,45387,66007,1724,12674,84,0,83761,4869
53,43955,5343955,Marysville city, Washington,0,2017,68859,37.3,74.1,13.6,34820,34039,55564,929,4720,764,599,62412,6447
53,53545,5353545,Pasco city, Washington,0,2017,67205,44,68.1,10.3,33767,33438,45093,927,2192,2220,677,30667,36538
53,57745,5357745,Renton city, Washington,1,2017,101372,45.6,78.7,11.1,48994,52378,54250,8561,19192,299,930,83638,17734
53,63000,5363000,Seattle city, Washington,1,2017,724764,50.1,84.2,12.6,360255,364509,487046,49980,114680,2883,2128,676555,48209
53,67000,5367000,Spokane city, Washington,1,2017,217096,42.4,78.5,15.4,107378,109718,184360,4687,5978,3375,2508,203808,13288
53,67167,5367167,Spokane Valley city, Washington,1,2017,97858,39.7,79.2,17.1,49001,48857,87699,1148,1393,1690,399,91386,6472
53,70000,5370000,Tacoma city, Washington,1,2017,213426,44.3,78.6,12.9,108065,105361,140604,22671,17336,3420,2683,188072,25354
53,74060,5374060,Vancouver city, Washington,1,2017,175661,40.3,76.9,15.6,87136,88525,141782,3885,10393,660,2828,150677,24984
53,80010,5380010,Yakima city, Washington,1,2017,93669,42,72.6,14.4,46717,46952,69452,915,926,619,16,50095,43574
55,2375,5502375,Appleton city, Wisconsin,1,2017,73984,40.8,76.8,13,35468,38516,61593,2524,6603,786,50,70138,3846
55,22300,5522300,Eau Claire city, Wisconsin,0,2017,69835,50.1,80.1,12.4,34528,35307,62644,767,2601,462,2068,67944,1891
55,31000,5531000,Green Bay city, Wisconsin,1,2017,105114,42.5,77.7,14.5,51524,53590,80661,5111,3443,3539,0,89644,15470
55,39225,5539225,Kenosha city, Wisconsin,1,2017,99875,42.4,75,13.2,48119,51756,76966,11558,1660,578,0,81735,18140
55,48000,5548000,Madison city, Wisconsin,1,2017,255239,55.8,84,12.5,127414,127825,202314,14410,24495,1099,371,234498,20741
55,53000,5553000,Milwaukee city, Wisconsin,1,2017,595365,45.3,74.2,10.7,285279,310086,261951,232375,25793,3062,92,481553,113812
55,60500,5560500,Oshkosh city, Wisconsin,0,2017,66668,49.5,84.4,14,33044,33624,60797,2626,1620,218,0,64740,1928
55,66000,5566000,Racine city, Wisconsin,1,2017,77555,41.6,72.3,13,38025,39530,51059,16902,746,340,0,59395,18160
55,84250,5584250,Waukesha city, Wisconsin,1,2017,72483,43.5,82.4,17.6,34647,37836,65290,1756,2246,316,0,64203,8280
72,10334,7210334,Caguas zona urbana, Puerto Rico,0,2017,73819,38.9,79.4,20.2,32880,40939,56718,5078,104,0,0,1388,72431
72,14290,7214290,Carolina zona urbana, Puerto Rico,0,2017,135781,38.9,80.9,20.9,61768,74013,70323,35330,695,3272,0,2324,133457
72,32522,7232522,Guaynabo zona urbana, Puerto Rico,0,2017,71420,41.2,82,21.8,33452,37968,-998,-998,-998,-998,-998,2356,69064
72,63820,7263820,Ponce zona urbana, Puerto Rico,0,2017,114335,37.1,79.4,21.9,52945,61390,85388,5858,0,130,0,240,114095
1,7000,107000,Birmingham city, Alabama,1,2017,212744,43.3,80.6,14.9,101498,111246,52427,151314,2474,380,271,204664,8080
1,21184,121184,Dothan city, Alabama,0,2017,67526,37.8,74.9,16.4,31708,35818,43454,21741,674,71,0,64527,2999
1,35896,135896,Hoover city, Alabama,1,2017,84937,37.4,78,17.7,40322,44615,63947,12888,5581,109,0,82259,2678
1,37000,137000,Huntsville city, Alabama,1,2017,195369,40.9,78.8,15.9,92699,102670,119757,61312,5429,421,0,183781,11588
1,50000,150000,Mobile city, Alabama,1,2017,190273,42,79.7,15.4,91603,98670,81651,99489,3073,313,0,184310,5963
1,51000,151000,Montgomery city, Alabama,1,2017,199525,42,76,14.3,93275,106250,67441,120350,5906,311,51,192107,7418
1,77256,177256,Tuscaloosa city, Alabama,1,2017,100296,55.3,82,10.7,47818,52478,49185,46562,1861,755,115,97980,2316
2,3000,203000,Anchorage municipality, Alaska,1,2017,294356,44.9,75.5,10.5,149386,144970,182307,14810,31646,22906,7791,267408,26948
4,4720,404720,Avondale city, Arizona,1,2017,84034,47.3,71.8,9.2,39677,44357,62317,7312,1480,1827,577,34565,49469
4,7940,407940,Buckeye city, Arizona,0,2017,68431,44.5,74,11.5,37366,31065,44922,3115,3620,1216,286,39194,29237
4,10670,410670,Casas Adobes CDP, Arizona,0,2017,73668,38.7,79.4,20.2,34658,39010,61536,2214,3515,878,49,56224,17444
4,12000,412000,Chandler city, Arizona,1,2017,253448,41.2,74.7,11.8,125874,127574,196427,15065,25208,1914,507,208537,44911
4,23620,423620,Flagstaff city, Arizona,0,2017,71975,57.3,80.9,9.5,36659,35316,61793,1083,1978,2739,318,57868,14107
4,27400,427400,Gilbert town, Arizona,1,2017,242362,43.5,70.7,9.1,118931,123431,205175,6401,12125,1662,62,199875,42487
4,27820,427820,Glendale city, Arizona,1,2017,246708,42.1,73.2,11,120816,125892,184004,19568,11402,5090,1682,154421,92287
4,28380,428380,Goodyear city, Arizona,0,2017,79850,39.9,76.2,14.6,37464,42386,57322,6981,4449,2066,28,56223,23627
4,46000,446000,Mesa city, Arizona,1,2017,496395,40.2,74.5,15.8,242301,254094,397828,18938,10121,10060,1798,355710,140685
4,54050,454050,Peoria city, Arizona,1,2017,168174,36.9,78.6,16.6,79855,88319,140642,4747,7522,1012,670,142765,25409
4,55000,455000,Phoenix city, Arizona,1,2017,1626085,43.4,73.8,10.7,811245,814840,1192925,117767,65216,32710,3595,928339,697746
4,64210,464210,San Tan Valley CDP, Arizona,0,2017,92851,43.6,68,11.5,44761,48090,79989,2960,2466,435,150,72714,20137
4,65000,465000,Scottsdale city, Arizona,1,2017,249947,34.5,82.4,22.4,126044,123903,222396,6400,11946,1705,0,223661,26286
4,71510,471510,Surprise city, Arizona,1,2017,134079,35.9,81.1,25.3,65014,69065,117253,4734,2941,670,0,108294,25785
4,73000,473000,Tempe city, Arizona,1,2017,185025,58.2,84.4,9.9,98600,86425,124167,12084,14652,5579,408,141069,43956
4,77000,477000,Tucson city, Arizona,1,2017,535676,44.7,78.7,14.6,267387,268289,384608,25645,16624,22287,1059,295314,240362
4,85540,485540,Yuma city, Arizona,1,2017,95494,43.1,73.5,15.5,45733,49761,72401,3450,2479,1988,49,38133,57361
5,15190,515190,Conway city, Arkansas,0,2017,65790,51.4,78.5,10.2,31392,34398,48700,11499,1718,0,0,63128,2662
5,23290,523290,Fayetteville city, Arkansas,1,2017,85258,57.8,80.4,9.5,42397,42861,66523,7168,3808,564,116,78060,7198
5,24550,524550,Fort Smith city, Arkansas,1,2017,88028,40.8,76.7,13.7,42258,45770,55749,7696,4727,894,0,70630,17398
5,35710,535710,Jonesboro city, Arkansas,1,2017,75867,46.8,76.1,13.3,37259,38608,54217,13312,1293,91,37,71181,4686
5,41000,541000,Little Rock city, Arkansas,1,2017,198594,40.8,74.9,13.5,96529,102065,98811,83208,6819,643,208,185394,13200
5,50450,550450,North Little Rock city, Arkansas,0,2017,65920,43.3,78.7,16.3,31011,34909,28265,35057,598,78,0,62769,3151
5,60410,560410,Rogers city, Arkansas,0,2017,66432,44.2,71.2,8.6,31572,34860,58015,1727,2252,591,648,43693,22739
5,66080,566080,Springdale city, Arkansas,1,2017,82397,41.5,68.3,11.1,42023,40374,49554,881,1203,595,4498,52154,30243
6,562,600562,Alameda city, California,1,2017,79188,41.2,77.9,16.6,35603,43585,39284,6644,21911,806,153,68363,10825
6,884,600884,Alhambra city, California,1,2017,85391,41.8,85.4,20.5,41097,44294,17762,865,49306,298,1080,57903,27488
6,2000,602000,Anaheim city, California,1,2017,352456,44.7,76.2,10.7,177625,174831,216356,9839,58649,1425,949,158445,194011
6,2252,602252,Antioch city, California,1,2017,111683,40.4,73.9,11.1,54940,56743,45547,21708,14582,391,883,73690,37993
6,2364,602364,Apple Valley town, California,1,2017,73071,39,72.8,15.8,34861,38210,60108,5977,2047,417,0,45799,27272
6,2553,602553,Arden-Arcade CDP, California,0,2017,100573,39.3,74.1,15,48931,51642,62910,9676,6852,343,385,79939,20634
6,3526,603526,Bakersfield city, California,1,2017,380887,42.3,70.2,10.8,185324,195563,261398,28892,27391,2100,1005,186960,193927
6,3666,603666,Baldwin Park city, California,1,2017,76392,45.7,77.3,12.9,37878,38514,28529,1968,12779,1803,1566,18541,57851
6,4982,604982,Bellflower city, California,1,2017,77772,42.6,77.1,11.5,38552,39220,25783,11024,9004,324,826,38233,39539
6,6000,606000,Berkeley city, California,1,2017,122334,57.3,86.1,13,60181,62153,70633,11277,23736,681,859,106119,16215
6,8786,608786,Buena Park city, California,1,2017,83026,43.6,77.8,13.7,41547,41479,39156,3900,22018,1845,273,48667,34359
6,8954,608954,Burbank city, California,1,2017,104823,42.4,81.4,14.9,49966,54857,78485,4692,11319,426,0,83985,20838
6,10046,610046,Camarillo city, California,0,2017,67849,34.9,80.3,20.1,34375,33474,50762,1043,9342,736,529,51581,16268
6,11194,611194,Carlsbad city, California,1,2017,115326,31.4,77.3,18.7,56675,58651,97240,1239,9781,249,317,98755,16571
6,11390,611390,Carmichael CDP, California,0,2017,65959,39.5,81,18.2,30233,35726,51028,2261,5244,265,0,58086,7873
6,11530,611530,Carson city, California,1,2017,92736,38.9,78.8,18,44562,48174,31449,19033,23926,601,391,55976,36760
6,11964,611964,Castro Valley CDP, California,0,2017,62103,38.7,79.6,17.2,30919,31184,36970,6056,11831,850,254,49766,12337
6,13014,613014,Chico city, California,1,2017,93297,50.6,81.4,14.3,44746,48551,76299,2499,5603,658,37,75145,18152
6,13210,613210,Chino city, California,1,2017,89798,44.5,78.4,12.1,52815,36983,44957,5569,11883,518,1093,43239,46559
6,13214,613214,Chino Hills city, California,1,2017,80400,41.6,76.6,11.4,37348,43052,41622,2157,27344,346,0,58094,22306
6,13392,613392,Chula Vista city, California,1,2017,270450,43.4,74.5,11.9,130380,140070,176339,18102,37656,2083,2113,108907,161543
6,13588,613588,Citrus Heights city, California,1,2017,87924,42.1,78.7,16.4,43509,44415,70644,3976,2556,444,100,71893,16031
6,14218,614218,Clovis city, California,1,2017,109700,38.7,72.9,14.7,53637,56063,80735,2310,11095,670,939,77777,31923
6,15044,615044,Compton city, California,1,2017,97626,43.6,70.1,7.6,48576,49050,26264,29429,215,489,36,30628,66998
6,16000,616000,Concord city, California,1,2017,129778,37.9,78.3,17.2,64057,65721,81463,4141,18456,520,0,93895,35883
6,16350,616350,Corona city, California,1,2017,167843,43.2,73.4,9.8,84079,83764,94255,13462,15363,471,616,95638,72205
6,16532,616532,Costa Mesa city, California,1,2017,113821,47.5,79.6,11.6,56779,57042,88167,1947,8762,253,1594,73793,40028
6,17918,617918,Daly City city, California,1,2017,107091,45.2,81.6,16.1,51980,55111,19476,3727,61641,578,263,78351,28740
6,18100,618100,Davis city, California,0,2017,68985,58.6,84.4,10.7,31307,37678,44617,1702,13918,416,120,59195,9790
6,19766,619766,Downey city, California,1,2017,113089,41.7,75.6,12.2,55154,57935,63809,3376,6764,187,488,25567,87522
6,20802,620802,East Los Angeles CDP, California,0,2017,125542,44.6,71.9,10.5,63229,62313,60719,433,1848,1950,86,4288,121254
6,21712,621712,El Cajon city, California,1,2017,103906,43.7,73.8,12.1,50509,53397,76897,6852,4629,324,342,74971,28935
6,22020,622020,Elk Grove city, California,1,2017,171831,39.6,75.7,13.7,83309,88522,82224,17204,47526,754,4009,136061,35770
6,22230,622230,El Monte city, California,1,2017,116110,43.8,76.7,12.2,59838,56272,33074,418,33636,285,1446,39465,76645
6,22804,622804,Escondido city, California,1,2017,151979,43.7,75.8,11.3,76455,75524,98442,2727,7580,742,203,71477,80502
6,23182,623182,Fairfield city, California,1,2017,116280,43.1,74,12,58181,58099,52035,19051,21796,761,2020,87211,29069
6,24477,624477,Florence-Graham CDP, California,0,2017,68095,46.5,67.1,5.7,34878,33217,-998,-998,-998,-998,-998,5325,62770
6,24638,624638,Folsom city, California,1,2017,78038,36.6,75.5,14,39657,38381,53706,2124,14335,204,278,68277,9761
6,24680,624680,Fontana city, California,1,2017,211820,48,70.2,6.1,108425,103395,80867,19848,10043,1860,155,67444,144376
6,26000,626000,Fremont city, California,1,2017,234954,42.1,76.2,12.4,115002,119952,52702,4687,144089,1063,859,203901,31053
6,27000,627000,Fresno city, California,1,2017,527422,43.8,71.8,11.4,258635,268787,318521,40511,74388,5852,378,269136,258286
6,28000,628000,Fullerton city, California,1,2017,140402,42.7,77.8,13.7,73008,67394,76933,3773,34268,214,514,84219,56183
6,29000,629000,Garden Grove city, California,1,2017,174228,42.1,80.1,14.4,85042,89186,68564,1675,77498,493,257,116171,58057
6,30000,630000,Glendale city, California,1,2017,203066,37,83.5,18.1,94393,108673,156970,4640,26417,411,248,168918,34148
6,32548,632548,Hawthorne city, California,1,2017,87863,44.8,74,9.2,44326,43537,22725,23290,9894,220,330,43496,44367
6,33000,633000,Hayward city, California,1,2017,160485,45,77.8,11,78998,81487,48180,14771,42564,1022,2870,94767,65718
6,33182,633182,Hemet city, California,1,2017,85153,34.6,74.2,21.3,40880,44273,60697,7500,2755,1236,18,44498,40655
6,33434,633434,Hesperia city, California,1,2017,94867,40.8,66.8,10,47724,47143,79894,3881,2780,206,0,41078,53789
6,36000,636000,Huntington Beach city, California,1,2017,201882,36.6,80.1,18.5,100078,101804,148792,2786,24391,1207,357,164218,37664
6,36448,636448,Indio city, California,1,2017,89784,38,84.2,18.7,41784,48000,56831,1843,1797,220,5,30550,59234
6,36546,636546,Inglewood city, California,1,2017,110611,41.4,75.9,13.8,53773,56838,29996,44973,2236,2076,2292,53612,56999
6,36770,636770,Irvine city, California,1,2017,277436,48,76.6,9.2,134239,143197,128892,5095,115202,519,838,247993,29443
6,37692,637692,Jurupa Valley city, California,0,2017,106032,44.1,71.1,9.6,51800,54232,47876,5673,3361,836,218,30550,75482
6,39248,639248,Laguna Niguel city, California,0,2017,66346,28.6,79.9,21.3,33015,33331,48362,410,9148,0,118,59810,6536
6,39486,639486,Lake Elsinore city, California,0,2017,66412,46.4,66.6,6,31300,35112,24543,4369,6395,193,0,29282,37130
6,39496,639496,Lake Forest city, California,1,2017,84308,40.8,80.4,13.4,40904,43404,53423,1378,18601,2417,0,65108,19200
6,39892,639892,Lakewood city, California,1,2017,80971,40.8,78.3,14.8,38030,42941,41190,7167,14937,610,275,54461,26510
6,40130,640130,Lancaster city, California,1,2017,160323,42.6,71.9,9.2,83485,76838,106113,25151,8771,1483,273,89971,70352
6,41992,641992,Livermore city, California,1,2017,90290,38.4,77.1,13.7,45335,44955,70091,1463,11672,300,567,73263,17027
6,42202,642202,Lodi city, California,0,2017,65891,41.7,70,13.1,30889,35002,39984,2108,5901,574,230,43436,22455
6,43000,643000,Long Beach city, California,1,2017,469459,44.5,77.9,11.6,227282,242177,238911,59564,63147,3116,3307,266698,202761
6,44000,644000,Los Angeles city, California,1,2017,3999742,45.9,79.4,12.4,1983239,2016503,2033975,362079,461936,24208,6170,2042764,1956978
6,44574,644574,Lynwood city, California,1,2017,71115,48.7,70.5,6.9,33501,37614,30033,3951,989,564,0,6468,64647
6,45022,645022,Madera city, California,0,2017,65506,44.8,65.5,8.9,32094,33412,36986,3772,1125,951,0,15953,49553
6,45484,645484,Manteca city, California,1,2017,79275,39.1,75,13.8,38922,40353,54173,3174,8739,522,234,45463,33812
6,46842,646842,Menifee city, California,1,2017,90599,38.9,78,17.9,44721,45878,55172,5124,5851,660,346,57194,33405
6,46898,646898,Merced city, California,1,2017,83100,44.4,70,10,39552,43548,55398,3894,13136,976,180,36340,46760
6,47766,647766,Milpitas city, California,1,2017,78108,44.9,74.7,10.3,41252,36856,13303,4659,48321,279,535,66262,11846
6,48256,648256,Mission Viejo city, California,1,2017,96009,33.6,79.6,16.8,47351,48658,74049,1204,11182,912,65,81465,14544
6,48354,648354,Modesto city, California,1,2017,214220,40.4,75.9,15.2,105212,109008,162820,10793,14679,1960,3436,129726,84494
6,49270,649270,Moreno Valley city, California,1,2017,207211,46.9,71.7,8.5,102328,104883,63448,33951,12551,1562,1309,78299,128912
6,49670,649670,Mountain View city, California,1,2017,81443,51.6,81.8,11.5,43086,38357,40671,727,30286,59,95,66347,15096
6,50076,650076,Murrieta city, California,1,2017,113316,37.5,69.8,13.4,53385,59931,71478,5587,10028,898,248,81450,31866
6,50258,650258,Napa city, California,1,2017,79782,39.2,77.4,16.4,39215,40567,66162,281,2199,392,89,48712,31070
6,51182,651182,Newport Beach city, California,1,2017,86151,30.1,82,23.4,42031,44120,76827,740,5446,50,140,80029,6122
6,52526,652526,Norwalk city, California,1,2017,106086,43.7,77.7,13.4,53275,52811,34159,3163,14663,194,505,30129,75957
6,53000,653000,Oakland city, California,1,2017,425204,45.4,80.3,13.2,209049,216155,145499,99476,66084,3160,2696,304434,120770
6,53322,653322,Oceanside city, California,1,2017,176208,39.4,79.5,17.4,89753,86455,123081,8764,13959,2542,780,112479,63729
6,53896,653896,Ontario city, California,1,2017,175850,45.7,74.7,10.6,87140,88710,87432,8992,12443,3680,167,56411,119439
6,53980,653980,Orange city, California,1,2017,140557,47.4,81,12.1,69868,70689,102233,1622,15686,643,155,83691,56866
6,54652,654652,Oxnard city, California,1,2017,210038,44.3,72.9,9.9,105062,104976,159828,6028,14600,4205,332,51330,158708
6,55156,655156,Palmdale city, California,1,2017,157507,41.3,70.5,9.2,78937,78570,63013,20850,6503,2421,962,64981,92526
6,55282,655282,Palo Alto city, California,0,2017,67170,37.5,75.5,18.4,32892,34278,39822,1523,22124,308,0,63223,3947
6,56000,656000,Pasadena city, California,1,2017,142632,45.4,81.5,14,69276,73356,73484,11871,24827,285,140,92543,50089
6,56700,656700,Perris city, California,1,2017,77895,47.8,66.5,6.2,40100,37795,22714,4340,1760,0,50,12213,65682
6,57456,657456,Pittsburg city, California,0,2017,72157,45,77.6,13.7,35355,36802,22539,11469,10808,1379,938,41512,30645
6,57792,657792,Pleasanton city, California,1,2017,83007,36.1,79,13.9,42101,40906,47515,2310,25903,436,508,76632,6375
6,58072,658072,Pomona city, California,1,2017,152946,45,75.2,11.1,76593,76353,64665,9026,19266,5203,21,44233,108713
6,59444,659444,Rancho Cordova city, California,0,2017,73554,44.7,76.7,12.1,37335,36219,44847,7369,6900,311,756,57483,16071
6,59451,659451,Rancho Cucamonga city, California,1,2017,177446,41.7,74.8,10.8,86231,91215,103013,15006,28111,1378,122,109807,67639
6,59920,659920,Redding city, California,1,2017,91788,38.4,78.5,17.6,44184,47604,78930,1247,4440,2958,36,80853,10935
6,59962,659962,Redlands city, California,1,2017,71562,40.3,80.2,16.9,35654,35908,45420,7518,8278,499,0,49881,21681
6,60018,660018,Redondo Beach city, California,1,2017,67908,39.2,80.4,12.6,35337,32571,46860,2084,8835,186,126,57344,10564
6,60102,660102,Redwood City city, California,1,2017,86683,44.3,81.5,12.1,45508,41175,51897,2666,12529,301,334,60324,26359
6,60466,660466,Rialto city, California,1,2017,103555,46.3,72.8,8.3,49259,54296,60269,14523,2918,1052,0,26996,76559
6,60620,660620,Richmond city, California,1,2017,110037,44.9,77.8,12.2,54397,55640,54084,20340,14423,619,394,57612,52425
6,62000,662000,Riverside city, California,1,2017,327722,48.3,76.1,9.7,163201,164521,157604,21930,27379,2603,399,148304,179418
6,62938,662938,Roseville city, California,1,2017,135325,37.8,77.1,16.7,66617,68708,106343,3064,13869,1179,1484,114605,20720
6,64000,664000,Sacramento city, California,1,2017,501890,43.3,76.7,12.7,245487,256403,207994,70339,94903,5008,10238,360138,141752
6,64224,664224,Salinas city, California,1,2017,157594,44.8,69.4,9.1,81048,76546,49310,2119,8140,346,111,33476,124118
6,65000,665000,San Bernardino city, California,1,2017,216983,45.2,72.1,10.2,105294,111689,128647,28292,7598,1136,169,76501,140482
6,65042,665042,San Buenaventura (Ventura) city, California,1,2017,110784,39.7,78.5,17.1,55207,55577,95897,2765,3192,396,0,70292,40492
6,65084,665084,San Clemente city, California,0,2017,65269,30.4,81.2,21.4,32084,33185,54593,214,2638,153,40,53958,11311
6,66000,666000,San Diego city, California,1,2017,1419488,47.8,80.1,12.5,720638,698850,916430,87393,243458,8562,6322,990314,429174
6,67000,667000,San Francisco city, California,1,2017,884363,48.2,86.6,15.4,450429,433934,402967,45815,306459,3078,3639,749658,134705
6,68000,668000,San Jose city, California,1,2017,1035353,43.1,77.9,12.8,522618,512735,404330,29587,368311,7629,4733,702750,332603
6,68084,668084,San Leandro city, California,1,2017,90555,36.9,82.2,19.9,41923,48632,34188,8223,33444,925,1297,70849,19706
6,68196,668196,San Marcos city, California,1,2017,96188,43.3,73.9,13.3,47574,48614,75554,1484,8332,895,61,52905,43283
6,68252,668252,San Mateo city, California,1,2017,104733,41,77.4,16,51826,52907,55238,1506,24734,516,3662,77956,26777
6,68378,668378,San Ramon city, California,1,2017,75922,39.2,70.1,9.6,37016,38906,27953,2639,37802,415,385,71687,4235
6,69000,669000,Santa Ana city, California,1,2017,334135,45.8,73.6,8.3,170471,163664,117032,2941,40138,1034,1325,78671,255464
6,69070,669070,Santa Barbara city, California,1,2017,92099,45.3,85.9,18.7,47048,45051,70084,2055,3388,175,0,62677,29422
6,69084,669084,Santa Clara city, California,1,2017,127131,50.2,80.9,12.9,66383,60748,46236,5371,57272,163,209,107036,20095
6,69088,669088,Santa Clarita city, California,1,2017,210886,39,74.9,11.9,103781,107105,146368,8669,25851,3012,178,144028,66858
6,69112,669112,Santa Cruz city, California,0,2017,65028,54.9,88.6,12.4,31793,33235,47951,928,7182,361,135,51629,13399
6,69196,669196,Santa Maria city, California,1,2017,107018,42.5,69.8,9.5,50818,56200,86766,1209,6187,766,0,25955,81063
6,70000,670000,Santa Monica city, California,1,2017,92298,43.7,84.7,20.3,43939,48359,66344,3901,9734,42,204,78749,13549
6,70098,670098,Santa Rosa city, California,1,2017,175269,40.4,78.9,17.5,82595,92674,110856,5482,9507,2992,1674,118316,56953
6,72016,672016,Simi Valley city, California,1,2017,126875,38.6,77.4,15,62835,64040,100179,1960,14097,260,41,94073,32802
6,73080,673080,South Gate city, California,1,2017,95422,45.8,72.7,10.3,46479,48943,56213,668,851,1210,0,4771,90651
6,73262,673262,South San Francisco city, California,0,2017,67430,38.5,79.4,16.6,32224,35206,17540,1566,31033,296,693,46385,21045
6,75000,675000,Stockton city, California,1,2017,310476,43.2,72.9,11.7,147877,162599,123347,38074,65267,1477,2042,176742,133734
6,77000,677000,Sunnyvale city, California,1,2017,153656,46.7,80.2,12,79775,73881,58210,2617,72824,650,271,129711,23945
6,78120,678120,Temecula city, California,1,2017,114318,39.8,71.8,11.7,56793,57525,75762,5282,8152,542,217,78663,35655
6,78582,678582,Thousand Oaks city, California,1,2017,128972,33.4,77.6,19.5,61103,67869,104797,1651,13264,469,68,106828,22144
6,80000,680000,Torrance city, California,1,2017,146745,35.8,79.6,18.3,71314,75431,65609,4005,57265,497,702,119435,27310
6,80238,680238,Tracy city, California,1,2017,90886,42.1,71.6,9.2,46557,44329,51081,4056,16604,147,1805,56191,34695
6,80812,680812,Turlock city, California,1,2017,73562,43.9,75.3,13.7,36124,37438,53363,1015,5300,450,70,44675,28887
6,80854,680854,Tustin city, California,1,2017,80502,41.4,75.1,11,38591,41911,37692,4376,20709,225,0,51536,28966
6,81204,681204,Union City city, California,1,2017,75344,43,83.9,14.6,38713,36631,15649,3990,42816,598,1143,61520,13824
6,81344,681344,Upland city, California,1,2017,76985,37.9,78.1,14.5,37208,39777,52750,2703,6696,452,0,37145,39840
6,81554,681554,Vacaville city, California,1,2017,100023,39.5,80.6,15,50108,49915,68360,9904,6489,247,869,71067,28956
6,81666,681666,Vallejo city, California,1,2017,122086,40.6,77.6,14.9,58389,63697,40919,23854,28037,437,1136,87947,34139
6,82590,682590,Victorville city, California,1,2017,122465,41.6,71.2,10.5,60586,61879,79084,12637,5983,545,190,50722,71743
6,82954,682954,Visalia city, California,1,2017,133009,43.7,70.3,10.8,62011,70998,92946,3170,6728,1247,0,61630,71379
6,82996,682996,Vista city, California,1,2017,101557,44.7,74.7,10.5,52303,49254,87494,2963,3590,221,94,48342,53215
6,83346,683346,Walnut Creek city, California,0,2017,69792,31,81.4,27.9,32860,36932,47144,2136,13445,302,161,62468,7324
6,84200,684200,West Covina city, California,1,2017,107623,41.5,78.8,15.5,53517,54106,34334,4719,35971,694,182,51441,56182
6,84550,684550,Westminster city, California,1,2017,91548,38.7,80.6,16.5,42978,48570,34597,874,46642,953,237,69401,22147
6,85292,685292,Whittier city, California,1,2017,86841,40.9,75,13.9,41878,44963,41768,1030,4302,483,13,28958,57883
6,86832,686832,Yorba Linda city, California,0,2017,68234,33.9,78.2,17.9,33329,34905,50526,747,14127,27,130,58377,9857
6,86972,686972,Yuba City city, California,0,2017,66872,40.1,74.3,14.5,34008,32864,41889,2153,13897,1107,583,46636,20236
8,3455,803455,Arvada city, Colorado,1,2017,118300,38.5,79,16.1,58265,60035,108552,1141,2789,679,0,99777,18523
8,4000,804000,Aurora city, Colorado,1,2017,367250,44.4,74.8,11,181607,185643,228065,58459,28722,3015,1049,266047,101203
8,7850,807850,Boulder city, Colorado,1,2017,107128,60.8,85.8,10.2,54966,52162,93877,1379,5503,126,7,96294,10834
8,9280,809280,Broomfield city, Colorado,0,2017,68341,41.6,76.5,12.9,34183,34158,58633,1028,4591,330,0,59865,8476
8,12815,812815,Centennial city, Colorado,1,2017,110277,36.1,76.5,15.1,55525,54752,96566,3851,4008,41,44,100476,9801
8,16000,816000,Colorado Springs city, Colorado,1,2017,464470,43.3,76.3,13.9,233923,230547,365865,26209,11075,5133,2375,383143,81327
8,20000,820000,Denver city, Colorado,1,2017,704621,49.7,80.1,11.6,352865,351756,531343,64231,27131,7422,1165,493800,210821
8,27425,827425,Fort Collins city, Colorado,1,2017,165089,54,79.2,9.8,82978,82111,147787,3192,5214,1853,164,140951,24138
8,32155,832155,Greeley city, Colorado,1,2017,105457,45.2,77,12.4,52194,53263,92366,2061,1245,856,0,65576,39881
8,36410,836410,Highlands Ranch CDP, Colorado,0,2017,107216,37.2,73,12.3,53301,53915,93488,1453,6893,519,0,99107,8109
8,43000,843000,Lakewood city, Colorado,1,2017,154952,42.8,80.2,15.9,76284,78668,136697,1564,5217,2380,0,115564,39388
8,45970,845970,Longmont city, Colorado,1,2017,94145,40.9,74.7,12.6,46004,48141,82029,890,3243,749,0,71386,22759
8,46465,846465,Loveland city, Colorado,1,2017,76702,38.7,83.7,20.4,36630,40072,72986,143,825,707,0,69095,7607
8,62000,862000,Pueblo city, Colorado,1,2017,111121,39.3,78.3,17,53854,57267,83058,2652,1229,5538,99,55243,55878
8,77290,877290,Thornton city, Colorado,1,2017,136992,40.3,72.2,10.2,70041,66951,119386,3327,6542,814,0,88559,48433
8,83835,883835,Westminster city, Colorado,1,2017,112814,44.2,79.1,14.4,55955,56859,95774,1402,7128,983,134,88923,23891
9,8000,908000,Bridgeport city, Connecticut,1,2017,146582,44.8,77.2,11.3,72997,73585,60706,52238,5253,916,0,87963,58619
9,18430,918430,Danbury city, Connecticut,1,2017,85243,42.5,81,15.3,43231,42012,48940,9630,5377,62,0,61102,24141
9,37000,937000,Hartford city, Connecticut,1,2017,123420,47.4,74.8,10.6,58573,64847,34203,44676,4629,156,0,67771,55649
9,50370,950370,New Britain city, Connecticut,1,2017,72718,43.5,78.4,14.6,33259,39459,53936,9531,2381,0,0,42048,30670
9,52000,952000,New Haven city, Connecticut,1,2017,131005,52.7,77.7,9.8,65965,65040,56692,46115,6400,72,0,92646,38359
9,55990,955990,Norwalk city, Connecticut,1,2017,89000,40.1,79.1,13.3,42017,46983,65239,12457,3668,464,58,57996,31004
9,73000,973000,Stamford city, Connecticut,1,2017,130835,43.7,80.4,15.7,63537,67298,88082,10602,11484,1060,161,94557,36278
9,80000,980000,Waterbury city, Connecticut,1,2017,108642,38.9,74.1,14.9,50889,57753,66360,20073,2551,208,0,64097,44545
10,77580,1077580,Wilmington city, Delaware,1,2017,71104,41.9,77,14.4,34323,36781,26324,42911,560,64,0,65123,5981
11,50000,1150000,Washington city, District of Columbia,1,2017,693972,51.2,82,12.1,329078,364894,284536,318220,28499,1690,302,617446,76526
12,410,1200410,Alafaya CDP, Florida,0,2017,88496,48.6,80.4,11.4,42131,46365,60229,9343,6232,191,0,52838,35658
12,7300,1207300,Boca Raton city, Florida,1,2017,98153,30.8,82.1,24.9,46711,51442,85721,4812,3088,0,0,83956,14197
12,7875,1207875,Boynton Beach city, Florida,1,2017,77704,39.7,81.4,19.2,38609,39095,44961,29359,1891,84,0,66922,10782
12,8150,1208150,Brandon CDP, Florida,0,2017,121190,43.9,78,13.3,57470,63720,81500,23599,6828,391,0,86607,34583
12,10275,1210275,Cape Coral city, Florida,1,2017,183356,32.1,82.3,24.6,91070,92286,167835,6610,3598,793,33,143533,39823
12,12875,1212875,Clearwater city, Florida,1,2017,115501,36.6,79.1,19.4,51382,64119,87730,14777,2478,1531,31,87802,27699
12,14400,1214400,Coral Springs city, Florida,1,2017,133058,41.2,74.2,11.6,61711,71347,86855,27453,9323,281,0,97170,35888
12,16475,1216475,Davie town, Florida,1,2017,105146,39.9,76.5,13.6,48791,56355,73530,15394,4499,51,434,67113,38033
12,16525,1216525,Daytona Beach city, Florida,0,2017,68055,40.5,80.5,18.9,34906,33149,39313,23172,2124,352,83,62622,5433
12,16725,1216725,Deerfield Beach city, Florida,1,2017,80572,40.3,80.9,20.9,38982,41590,50274,23990,2945,87,0,63511,17061
12,17100,1217100,Delray Beach city, Florida,0,2017,68749,32.5,82,24.8,32402,36347,43064,22319,1941,0,0,62632,6117
12,17200,1217200,Deltona city, Florida,1,2017,90743,39.1,74.8,15.1,45223,45520,67034,10523,1151,394,0,57346,33397
12,24000,1224000,Fort Lauderdale city, Florida,1,2017,180071,38.3,81.6,16.6,92412,87659,108703,59911,1795,64,32,141164,38907
12,24125,1224125,Fort Myers city, Florida,0,2017,79941,38.2,80.4,20.2,39215,40726,49867,17224,3900,48,77,61000,18941
12,25175,1225175,Gainesville city, Florida,1,2017,132253,61.8,87.1,10.5,61571,70682,87784,27229,8438,272,194,116257,15996
12,30000,1230000,Hialeah city, Florida,1,2017,239682,33.3,83.6,21.2,115531,124151,223904,4939,2108,0,0,9197,230485
12,32000,1232000,Hollywood city, Florida,1,2017,153625,39.3,78.2,16.4,76885,76740,103684,28054,4804,545,0,91197,62428
12,32275,1232275,Homestead city, Florida,0,2017,69909,48.2,72.2,10.1,35628,34281,53691,11323,759,853,0,22310,47599
12,35000,1235000,Jacksonville city, Florida,1,2017,892064,42,77.1,13.5,432039,460025,516074,281757,47503,1709,101,804192,87872
12,36100,1236100,Kendall CDP, Florida,0,2017,73805,37.6,82.3,21.9,34342,39463,62083,3712,1641,0,0,21472,52333
12,36950,1236950,Kissimmee city, Florida,0,2017,71103,47.1,75.3,9.5,38752,32351,45673,7408,3598,308,43,22238,48865
12,38250,1238250,Lakeland city, Florida,1,2017,108051,40.1,81.2,19.8,50197,57854,78858,22501,2953,273,184,91230,16821
12,39425,1239425,Largo city, Florida,1,2017,84768,34.4,84.8,26,41606,43162,73210,5782,2220,169,146,74144,10624
12,39550,1239550,Lauderhill city, Florida,1,2017,71976,40.1,70.6,11.1,33705,38271,9650,58858,438,406,0,65931,6045
12,39925,1239925,Lehigh Acres CDP, Florida,0,2017,132618,39.1,70.5,12.8,63743,68875,92966,26204,1789,0,137,83487,49131
12,43975,1243975,Melbourne city, Florida,1,2017,82003,32.4,80.3,24.3,39842,42161,63105,7984,5545,213,0,74605,7398
12,45000,1245000,Miami city, Florida,1,2017,463354,42.5,82.3,16.2,228354,235000,343909,83411,6411,2232,79,131140,332214
12,45025,1245025,Miami Beach city, Florida,1,2017,92319,39.7,82.8,17.6,47582,44737,68408,4312,536,439,0,41826,50493
12,45060,1245060,Miami Gardens city, Florida,1,2017,113743,43.6,75.1,12.8,53602,60141,29850,77908,1701,152,0,82190,31553
12,45975,1245975,Miramar city, Florida,1,2017,140323,42.5,75.5,10.5,69194,71129,64174,62207,4524,375,0,84732,55591
12,49675,1249675,North Port city, Florida,0,2017,66293,34.7,81.6,23.5,30345,35948,-998,-998,-998,-998,-998,56646,9647
12,53000,1253000,Orlando city, Florida,1,2017,280258,49.7,77.8,10.5,136571,143687,158310,77172,11963,310,78,193953,86305
12,54000,1254000,Palm Bay city, Florida,1,2017,111660,40.1,79,14.2,58480,53180,84902,17211,1992,1072,0,93042,18618
12,54200,1254200,Palm Coast city, Florida,1,2017,88394,31.4,81.8,28.1,41508,46886,70157,11663,3064,291,0,78350,10044
12,55775,1255775,Pembroke Pines city, Florida,1,2017,170703,39.8,79.2,15.4,81421,89282,105038,39865,10827,810,190,99017,71686
12,56825,1256825,Pine Hills CDP, Florida,0,2017,76847,45.3,72.4,10.4,37258,39589,11543,53759,3649,265,0,64458,12389
12,57425,1257425,Plantation city, Florida,1,2017,93922,38.1,79.9,18.6,44396,49526,65799,16070,3963,152,0,66209,27713
12,57900,1257900,Poinciana CDP, Florida,0,2017,71694,36.1,75.4,19.4,34627,37067,41340,18007,1798,1485,508,34274,37420
12,58050,1258050,Pompano Beach city, Florida,1,2017,110464,35.4,83.7,18.6,58432,52032,67285,37644,711,83,0,89680,20784
12,58350,1258350,Port Charlotte CDP, Florida,0,2017,65972,29.5,85.5,30.7,32274,33698,-998,-998,-998,-998,-998,60517,5455
12,58715,1258715,Port St. Lucie city, Florida,1,2017,189331,34.7,79.2,21.4,93407,95924,142385,34890,4875,466,0,154650,34681
12,60950,1260950,Riverview CDP, Florida,0,2017,90538,42.7,73.3,9.1,44382,46156,63997,16176,4354,157,0,68025,22513
12,63000,1263000,St. Petersburg city, Florida,1,2017,263252,36.5,83.8,20.3,126815,136437,184415,56947,9879,591,0,247322,15930
12,68350,1268350,Spring Hill CDP, Florida,0,2017,113508,33.3,77.2,22.1,56017,57491,99136,6346,2099,1099,0,95167,18341
12,69700,1269700,Sunrise city, Florida,1,2017,94313,41.8,78.1,16.9,42995,51318,52088,31494,4668,446,45,64770,29543
12,70600,1270600,Tallahassee city, Florida,1,2017,191039,58.6,84.2,10.1,89596,101443,109980,64649,7811,229,0,177495,13544
12,70675,1270675,Tamarac city, Florida,0,2017,65683,30.8,82.8,29,30255,35428,38318,21585,3483,49,0,48939,16744
12,71000,1271000,Tampa city, Florida,1,2017,385423,43.9,79.1,12.8,189874,195549,256273,91940,16438,886,84,283653,101770
12,71569,1271569,The Hammocks CDP, Florida,0,2017,68457,44.6,83.1,11.6,31922,36535,58386,3083,3387,0,0,11602,56855
12,71625,1271625,The Villages CDP, Florida,0,2017,-998,-999999999,-999999999,-999999999,-998,-998,-998,-998,-998,-998,-998,78754,866
12,72145,1272145,Town 'n' Country CDP, Florida,0,2017,89143,41.4,77.9,12.8,41206,47937,67323,10977,3843,76,0,49402,39741
12,76582,1276582,Weston city, Florida,0,2017,70927,32.5,72.6,12.7,34677,36250,55928,5016,4355,0,126,36836,34091
12,76600,1276600,West Palm Beach city, Florida,1,2017,110219,40.7,79.6,19.4,52934,57285,64388,38133,2536,37,0,80252,29967
13,1052,1301052,Albany city, Georgia,1,2017,71593,43.1,76.8,15.1,33225,38368,-998,-998,-998,-998,-998,69969,1624
13,1696,1301696,Alpharetta city, Georgia,0,2017,65774,37.7,74.8,10,31513,34261,38578,7822,13480,28,0,59176,6598
13,3440,1303440,Athens-Clarke County unified government (balance), Georgia,1,2017,125929,57.3,82.7,10.5,60245,65684,78877,34634,4979,0,0,112121,13808
13,4000,1304000,Atlanta city, Georgia,1,2017,486299,50.9,81.1,11.2,238210,248089,190415,256888,19551,704,0,465421,20878
13,4204,1304204,Augusta-Richmond County consolidated government (balance), Georgia,1,2017,195678,42.7,76.8,13.5,93839,101839,70088,112673,3910,336,103,185569,10109
13,19000,1319000,Columbus city, Georgia,1,2017,194058,42.3,75.1,12.9,94497,99561,84356,90141,4864,261,164,179357,14701
13,42425,1342425,Johns Creek city, Georgia,1,2017,84359,34.6,72.5,8.8,41631,42728,-998,-998,-998,-998,-998,79127,5232
13,49008,1349008,Macon-Bibb County, Georgia,0,2017,152646,39,75.3,15,71387,81259,61664,83882,3191,396,63,147627,5019
13,67284,1367284,Roswell city, Georgia,1,2017,94792,39.1,74.4,14.3,45321,49471,70004,14550,2882,207,0,79498,15294
13,68516,1368516,Sandy Springs city, Georgia,1,2017,106742,44.8,81,13.8,50109,56633,78719,15691,8743,800,0,90881,15861
13,69000,1369000,Savannah city, Georgia,1,2017,146449,45.7,80.5,12.9,68096,78353,53571,81766,2539,132,1341,140138,6311
13,80508,1380508,Warner Robins city, Georgia,1,2017,75675,41.1,73.7,12.9,34775,40900,38782,28625,2572,81,0,67791,7884
72,76770,7276770,San Juan zona urbana, Puerto Rico,0,2017,321613,37.6,81.6,22,145917,175696,202970,49524,389,582,0,4198,317415
72,6593,7206593,Bayam√≥n zona urbana, Puerto Rico,0,2017,164319,38.1,81.3,21.3,77323,86996,122871,13814,278,393,0,855,163464
6,14218,614218,Clovis city, California,1,2018,112019,42,71.9,13.8,54549,57470,73710,5555,11376,1737,0,77501,34518
6,29000,629000,Garden Grove city, California,1,2018,172652,41.7,78.6,12.6,87021,85631,66269,1762,68867,880,3903,107045,65607
6,53896,653896,Ontario city, California,1,2018,181119,48.2,75.4,9.2,90402,90717,82457,9507,11341,1658,68,48500,132619
6,78582,678582,Thousand Oaks city, California,1,2018,127720,33,78.9,18.4,60955,66765,104856,1962,13489,790,180,103063,24657
48,24000,4824000,El Paso city, Texas,1,2018,682686,42.9,73.6,12.9,334759,347927,526550,21759,9954,2746,1030,122925,559761
55,48000,5548000,Madison city, Wisconsin,1,2018,258034,55.1,83.5,12.5,127328,130706,201826,20865,23594,1411,0,239167,18867
6,86832,686832,Yorba Linda city, California,0,2018,67804,33.1,76.1,20.9,33270,34534,48986,1417,12206,190,80,56782,11022
18,31000,1831000,Hammond city, Indiana,1,2018,75806,43.2,74.2,13.7,38229,37577,37786,13734,335,267,0,43266,32540
29,64550,2964550,St. Joseph city, Missouri,1,2018,75437,37.8,76.9,17.2,38154,37283,64641,4592,756,219,0,69532,5905
48,10768,4810768,Brownsville city, Texas,1,2018,183389,42.3,70,11.6,88298,95091,-998,-998,-998,-998,-998,9973,173416
4,23620,423620,Flagstaff city, Arizona,0,2018,73955,59.9,82.9,9,37736,36219,57397,1494,2324,6717,0,61444,12511
25,7000,2507000,Boston city, Massachusetts,1,2018,695926,54.4,84.1,11.8,333815,362111,365340,170804,66261,2306,165,556739,139187
49,83470,4983470,West Valley City city, Utah,1,2018,136420,47.1,72.2,9.1,69169,67251,73685,3274,7365,1520,5323,82661,53759
72,63820,7263820,Ponce zona urbana, Puerto Rico,0,2018,107947,37.6,81.7,22.9,50397,57550,89255,7640,90,407,0,778,107169
44,19180,4419180,Cranston city, Rhode Island,1,2018,81282,42,81.3,15.1,39912,41370,64774,3744,5301,893,160,68824,12458
53,35415,5335415,Kent city, Washington,1,2018,129613,40.7,73.8,12.6,64390,65223,62079,17988,21172,458,3651,108317,21296
6,81554,681554,Vacaville city, California,1,2018,100147,42.4,76,14.8,51704,48443,65087,11112,6990,542,3237,79684,20463
12,75812,1275812,Wellington village, Florida,0,2018,65190,35.2,70.4,14.1,31273,33917,56081,4895,2636,255,0,49894,15296
48,52356,4852356,North Richland Hills city, Texas,0,2018,70839,39.5,76.6,15.7,34163,36676,54173,3176,3520,797,0,58318,12521
6,2000,602000,Anaheim city, California,1,2018,352018,43.3,75.1,11.8,170041,181977,233389,10405,53606,2002,552,156115,195903
6,53322,653322,Oceanside city, California,1,2018,176090,40.5,79.3,17.1,85652,90438,129981,7146,14747,1087,1692,115444,60646
15,71550,1571550,Urban Honolulu CDP, Hawaii,0,2018,347403,39.9,82.2,20.3,176513,170890,58248,6836,181174,324,27090,319617,27786
29,38000,2938000,Kansas City city, Missouri,1,2018,491809,43.6,77.2,13.2,240320,251489,300253,139598,12333,2191,400,439171,52638
48,17000,4817000,Corpus Christi city, Texas,1,2018,326566,42.6,75.4,14.4,160229,166337,294085,13614,7863,1243,359,117613,208953
6,62364,662364,Rocklin city, California,0,2018,67231,42.9,73.8,11.5,31848,35383,51836,967,6443,565,77,55924,11307
12,70675,1270675,Tamarac city, Florida,0,2018,66043,33.7,82.9,26.4,29531,36512,44580,16247,1344,70,0,40465,25578
20,52575,2052575,Olathe city, Kansas,1,2018,139588,41.4,70.7,10,69837,69751,119391,8491,5461,296,108,121661,17927
21,8902,2108902,Bowling Green city, Kentucky,0,2018,68393,52.8,79.2,12,32240,36153,51701,6492,3668,149,1217,62036,6357
22,40735,2240735,Lafayette city, Louisiana,1,2018,126149,43.6,79,14.1,62362,63787,80665,38164,2684,467,0,119503,6646
24,31175,2431175,Gaithersburg city, Maryland,0,2018,68294,41.1,76.7,13.1,34786,33508,30190,13001,14370,517,0,52416,15878
45,30850,4530850,Greenville city, South Carolina,0,2018,68543,45.8,79.6,14.3,32372,36171,46232,18157,1620,0,681,65496,3047
6,33000,633000,Hayward city, California,1,2018,159618,43.9,77.6,13,79264,80354,44214,14445,45727,1700,2813,99210,60408
6,66000,666000,San Diego city, California,1,2018,1425999,46.2,80,13.3,719960,706039,926159,96339,240609,5795,5422,996101,429898
8,27425,827425,Fort Collins city, Colorado,1,2018,167823,55.1,82,10.7,84376,83447,148431,2146,6614,1185,214,148746,19077
25,37000,2537000,Lowell city, Massachusetts,1,2018,111666,49.1,77.9,10,53850,57816,67227,11576,24181,1303,0,91057,20609
48,4000,4804000,Arlington city, Texas,1,2018,398122,44.5,74.4,10.9,196792,201330,226690,92364,27658,2633,0,285641,112481
48,19972,4819972,Denton city, Texas,1,2018,138553,55.7,81.9,11.1,66840,71713,106453,15169,6751,1423,0,108939,29614
4,28380,428380,Goodyear city, Arizona,0,2018,82837,40.5,79.5,17.9,38978,43859,63357,3297,3444,1593,874,54829,28008
6,13214,613214,Chino Hills city, California,1,2018,83438,42.1,74.7,9.4,41094,42344,36626,4422,34081,994,0,60734,22704
6,39486,639486,Lake Elsinore city, California,0,2018,68187,41.3,70.8,11.1,32544,35643,35690,5920,4573,690,143,33821,34366
13,42425,1342425,Johns Creek city, Georgia,1,2018,84292,37.2,73.4,11.2,42379,41913,44974,11168,23100,1077,69,78828,5464
4,71510,471510,Surprise city, Arizona,1,2018,138144,35,75,22.3,66922,71222,117869,9137,3910,201,72,112993,25151
18,71000,1871000,South Bend city, Indiana,1,2018,103869,41,71,13.1,49150,54719,63862,27568,1870,398,38,87670,16199
33,50260,3350260,Nashua city, New Hampshire,1,2018,89257,35.6,81.3,17.3,44309,44948,73309,3737,7204,47,0,77863,11394
72,6593,7206593,Bayam√≥n zona urbana, Puerto Rico,0,2018,155832,38.1,82.1,22,72849,82983,110054,16637,155,50,0,1552,154280
17,14000,1714000,Chicago city, Illinois,1,2018,2705988,46.7,79.7,12.9,1319875,1386113,1389965,797489,181679,7237,501,1929327,776661
55,53000,5553000,Milwaukee city, Wisconsin,1,2018,592002,45.8,74.3,10.9,287293,304709,255565,225047,25525,2859,268,472126,119876
12,16525,1216525,Daytona Beach city, Florida,0,2018,68862,41.8,84.5,21.2,34393,34469,39297,22448,2086,0,120,62263,6599
12,45000,1245000,Miami city, Florida,1,2018,470911,40.7,82.3,17.6,233853,237058,358137,71830,6753,103,0,121910,349001
28,29700,2829700,Gulfport city, Mississippi,1,2018,71865,41.6,76.1,12.1,34410,37455,37649,29951,1259,212,0,68360,3505
49,67440,4967440,Sandy city, Utah,1,2018,96901,40.8,78,16,50243,46658,86213,329,3372,242,1740,87811,9090
45,50875,4550875,North Charleston city, South Carolina,1,2018,119214,47,74.6,10.4,58464,60750,55792,52220,2820,597,0,106437,12777
48,74144,4874144,Tyler city, Texas,1,2018,105727,42.9,75.3,14.2,50083,55644,72877,23385,3546,705,162,82227,23500
6,55282,655282,Palo Alto city, California,0,2018,66655,37.3,79.2,19.7,31854,34801,37760,1287,23271,46,8,63465,3190
12,25175,1225175,Gainesville city, Florida,1,2018,133851,64,85.1,10.1,65863,67988,84163,32560,9217,558,172,116343,17508
17,6613,1706613,Bloomington city, Illinois,1,2018,77955,42.6,76.4,13.5,39285,38670,60525,7246,6601,218,0,72036,5919
17,23074,1723074,Elgin city, Illinois,1,2018,110893,41.2,75.5,12.6,54429,56464,73607,7351,6243,50,0,63348,47545
18,27000,1827000,Gary city, Indiana,1,2018,69602,34.2,75.4,20.3,31071,38531,10393,53235,146,71,0,61603,7999
19,12000,1912000,Cedar Rapids city, Iowa,1,2018,133169,42.2,78.6,15,65741,67428,108489,13243,4973,305,586,128723,4446
51,14440,5114440,Centreville CDP, Virginia,0,2018,78356,41.1,77.1,10.5,38234,40122,43485,5479,22034,246,189,66871,11485
55,22300,5522300,Eau Claire city, Wisconsin,0,2018,68256,50.3,81.2,15.2,33447,34809,61354,596,4894,0,0,66023,2233
6,55156,655156,Palmdale city, California,1,2018,156661,40.6,70.7,11.1,76835,79826,65899,19902,7535,1070,729,65195,91466
6,69196,669196,Santa Maria city, California,1,2018,107424,44.5,67.6,8.9,53753,53671,89061,1468,4556,994,0,21271,86153
41,34100,4134100,Hillsboro city, Oregon,1,2018,108382,45.9,76,11.5,54483,53899,74964,3505,12990,693,361,88801,19581
24,4000,2404000,Baltimore city, Maryland,1,2018,602495,44.3,79.6,14,282677,319818,183276,371664,15490,1600,61,569434,33061
12,32000,1232000,Hollywood city, Florida,1,2018,154813,40,80.2,16.3,78329,76484,100042,31982,4908,760,0,92383,62430
12,58350,1258350,Port Charlotte CDP, Florida,0,2018,64815,26.8,85.6,31.6,30241,34574,54629,5528,867,77,215,56918,7897
12,60950,1260950,Riverview CDP, Florida,0,2018,89982,43.4,77.5,11.7,42930,47052,63807,17998,2525,377,0,67921,22061
37,75000,3775000,Winston-Salem city, North Carolina,1,2018,246334,42.1,76.3,13.8,117797,128537,137579,85690,6721,256,1307,207208,39126
6,46842,646842,Menifee city, California,1,2018,92602,37.1,74.6,18.3,46509,46093,61008,5099,2617,1302,178,56293,36309
6,62000,662000,Riverside city, California,1,2018,330080,48.7,76.4,10.5,160110,169970,209083,19591,27672,2736,660,144752,185328
25,67000,2567000,Springfield city, Massachusetts,1,2018,155029,43.6,75.9,13.3,75821,79208,97277,34369,3681,713,0,80031,74998
51,21088,5121088,Dale City CDP, Virginia,0,2018,68805,41.7,72.9,10.7,35840,32965,34949,17559,6719,794,0,46928,21877
6,73080,673080,South Gate city, California,1,2018,94439,46,71.2,9.4,47917,46522,60943,611,864,757,653,3503,90936
25,34550,2534550,Lawrence city, Massachusetts,1,2018,80370,44.6,70.7,8.7,38578,41792,26489,3586,2109,173,0,14733,65637
34,13690,3413690,Clifton city, New Jersey,1,2018,85272,41.2,81.1,16.1,41941,43331,62880,3316,7425,98,82,51916,33356
39,61000,3961000,Parma city, Ohio,1,2018,78746,42,81.9,17.7,39251,39495,70046,3146,1720,18,0,74318,4428
20,38900,2038900,Lawrence city, Kansas,1,2018,97293,57.1,84.1,12.2,48090,49203,75876,5125,6828,4046,123,89954,7339
39,16000,3916000,Cleveland city, Ohio,1,2018,383781,41.8,78.5,14.3,188481,195300,158228,181840,11503,1987,249,336637,47144
39,21000,3921000,Dayton city, Ohio,1,2018,140638,45.8,81.3,13.8,69798,70840,74832,55336,1691,892,0,133839,6799
6,72016,672016,Simi Valley city, California,1,2018,125844,37.4,79.5,17.2,60482,65362,99506,802,15091,446,226,94499,31345
12,14400,1214400,Coral Springs city, Florida,1,2018,133493,39.9,74.4,12.3,66655,66838,89008,30399,7359,10,154,94690,38803
13,68516,1368516,Sandy Springs city, Georgia,1,2018,108798,45,79.9,14.1,54298,54500,76021,18558,9227,189,267,95882,12916
17,18823,1718823,Decatur city, Illinois,1,2018,71860,36.5,79.1,20.7,33564,38296,50693,17344,484,149,0,69822,2038
17,72000,1772000,Springfield city, Illinois,1,2018,114512,39.1,78,17.3,55283,59229,82517,23521,3911,553,0,111600,2912
26,80700,2680700,Troy city, Michigan,1,2018,84259,38.2,78.8,16.5,41232,43027,55116,4744,21346,20,44,82149,2110
37,34200,3734200,Jacksonville city, North Carolina,1,2018,72895,64.7,78.4,5.7,43603,29292,49568,13977,2327,388,0,60280,12615
6,23182,623182,Fairfield city, California,1,2018,116885,42.1,75,13,58945,57940,64471,16745,20227,921,424,84012,32873
6,24638,624638,Folsom city, California,1,2018,79015,37.7,73.3,12.1,41354,37661,53243,2180,14740,289,260,67678,11337
6,54652,654652,Oxnard city, California,1,2018,209886,45.1,74,9.7,110397,99489,164395,4601,13131,951,542,58253,151633
8,77290,877290,Thornton city, Colorado,1,2018,139430,46.1,70.2,9.2,68281,71149,114139,2554,6454,1515,101,88332,51098
9,8000,908000,Bridgeport city, Connecticut,1,2018,144898,45.2,76.5,11.2,69293,75605,49468,55260,5603,657,0,84971,59927
17,38570,1738570,Joliet city, Illinois,1,2018,149356,42.8,72.8,9.2,75343,74013,99248,27096,2648,856,127,97088,52268
48,48072,4848072,Midland city, Texas,1,2018,142339,44.4,72.5,10,72117,70222,114272,12640,3150,3069,182,82218,60121
6,36448,636448,Indio city, California,1,2018,91235,38.3,85.1,21.3,43452,47783,49161,1245,1394,57,0,32308,58927
12,30000,1230000,Hialeah city, Florida,1,2018,238950,36.7,83.7,19.1,117193,121757,219812,4524,1662,52,0,10915,228035
25,11000,2511000,Cambridge city, Massachusetts,1,2018,118967,63.5,88.4,10.3,58344,60623,79472,10551,21603,178,471,105368,13599
25,82000,2582000,Worcester city, Massachusetts,1,2018,185883,47.8,81.8,13.3,92336,93547,127395,23956,16130,72,107,142887,42996
48,64472,4864472,San Angelo city, Texas,1,2018,101824,44.4,76,14.9,51356,50468,89438,4536,1917,534,7,58413,43411
4,27820,427820,Glendale city, Arizona,1,2018,250705,41.4,74.6,13.1,124205,126500,185137,16663,10614,4165,327,153045,97660
4,65000,465000,Scottsdale city, Arizona,1,2018,255315,35.6,84.4,22.9,126458,128857,225776,6093,13109,1407,283,226882,28433
6,3526,603526,Bakersfield city, California,1,2018,383601,43.8,70.5,10.6,192252,191349,263237,32383,24531,2737,1119,186473,197128
6,22804,622804,Escondido city, California,1,2018,152232,42.6,77.2,14.1,74713,77519,115538,3781,11072,1976,284,73058,79174
30,6550,3006550,Billings city, Montana,1,2018,109544,39,78,17.5,52882,56662,96367,528,1019,6409,67,102307,7237
37,19000,3719000,Durham city, North Carolina,1,2018,274497,47.1,79.1,12.2,129912,144585,136725,104079,14899,1101,0,235149,39348
13,1052,1301052,Albany city, Georgia,1,2018,71646,45.5,77.2,14,33095,38551,14341,53941,372,494,128,70530,1116
8,20000,820000,Denver city, Colorado,1,2018,716492,50.1,80.5,11.7,358836,357656,544519,64199,26827,6686,1213,503930,212562
51,35000,5135000,Hampton city, Virginia,1,2018,134313,42.3,79.5,15.4,64444,69869,55091,67768,2668,317,237,126227,8086
13,72122,1372122,South Fulton city, Georgia,0,2018,97266,44.1,82.1,12.7,43003,54263,-998,-998,-998,-998,-998,96142,1124
22,8920,2208920,Bossier City city, Louisiana,0,2018,68222,45.2,76.5,15,32663,35559,43410,20571,942,79,0,61436,6786
24,26000,2426000,Ellicott City CDP, Maryland,0,2018,72689,36.9,74,13.7,33505,39184,41501,7148,20817,23,42,69354,3335
25,55745,2555745,Quincy city, Massachusetts,1,2018,94590,45.8,84.4,15.4,45315,49275,55548,6330,30173,124,0,91508,3082
6,77000,677000,Sunnyvale city, California,1,2018,153175,46.5,80.1,12,80638,72537,58616,2548,77599,449,47,131417,21758
53,70000,5370000,Tacoma city, Washington,1,2018,216271,44.6,78.5,13.7,108542,107729,142454,20374,20435,3920,2902,192106,24165
38,7200,3807200,Bismarck city, North Dakota,0,2018,71843,41.5,78.8,17.2,35491,36352,64111,2208,567,2971,0,69808,2035
13,49008,1349008,Macon-Bibb County, Georgia,0,2018,153095,39.6,75.4,15.7,72997,80098,61370,81723,3249,188,144,147879,5216
6,45022,645022,Madera city, California,0,2018,65711,43.7,67.4,10,32809,32902,29361,2899,905,128,0,14999,50712
12,35875,1235875,Jupiter town, Florida,0,2018,65544,34.8,83,20.2,30945,34599,56665,1578,1501,0,149,56584,8960
6,70098,670098,Santa Rosa city, California,1,2018,177587,40.2,78.8,17.5,85668,91919,113551,2447,9432,2532,93,113617,63970
8,4000,804000,Aurora city, Colorado,1,2018,373487,44.5,76.1,11.8,184950,188537,226683,65757,23272,4230,1399,264333,109154
32,68400,3268400,Sparks city, Nevada,1,2018,104254,38.5,74.9,17.2,51778,52476,75775,2659,6702,1784,955,73223,31031
36,73000,3673000,Syracuse city, New York,1,2018,142740,48.3,78,11.4,68926,73814,75751,46638,8482,2336,34,128815,13925
1,50000,150000,Mobile city, Alabama,1,2018,189570,40.6,79.3,17.5,89005,100565,79694,102401,2758,579,85,184814,4756
48,63500,4863500,Round Rock city, Texas,1,2018,128490,46,73.5,9.6,65056,63434,98036,13551,8076,377,0,96660,31830
6,68378,668378,San Ramon city, California,1,2018,75832,37.2,72.4,11,37827,38005,30525,1186,35787,0,1275,69350,6482
12,36100,1236100,Kendall CDP, Florida,0,2018,75979,35.2,81,21.1,34555,41424,67045,998,3219,0,0,22814,53165
13,1696,1301696,Alpharetta city, Georgia,0,2018,66263,35.6,72.3,9.8,32888,33375,-998,-998,-998,-998,-998,61272,4991
42,69000,4269000,Scranton city, Pennsylvania,1,2018,77186,40.4,78.8,16.6,38097,39089,62332,4053,4250,0,42,64255,12931
4,85540,485540,Yuma city, Arizona,1,2018,97917,43.1,74.5,15.8,49808,48109,81988,3018,3077,850,0,39364,58553
6,82954,682954,Visalia city, California,1,2018,133783,40.2,67.6,11.9,67405,66378,85269,4181,6897,795,34,65150,68633
31,37000,3137000,Omaha city, Nebraska,1,2018,468267,42,75.5,13.6,232016,236251,360742,56874,17430,4147,51,399520,68747
53,43955,5343955,Marysville city, Washington,0,2018,69765,42.5,78.1,13,34384,35381,55733,1223,5979,752,998,60658,9107
13,69000,1369000,Savannah city, Georgia,1,2018,145852,46.7,78,14.1,71764,74088,60547,73788,4070,355,742,136720,9132
22,39475,2239475,Kenner city, Louisiana,1,2018,66656,39.2,77.9,18.1,31185,35471,44922,13454,2599,796,0,50265,16391
51,57000,5157000,Norfolk city, Virginia,1,2018,244076,51.1,80.4,11.2,127098,116978,113964,98688,9250,614,211,223669,20407
9,55990,955990,Norwalk city, Connecticut,1,2018,89049,38.3,79.8,17.9,43229,45820,65383,11758,3721,408,247,64624,24425
25,45000,2545000,New Bedford city, Massachusetts,1,2018,95323,45.1,77.6,13.5,48566,46757,56588,5919,1286,99,0,71076,24247
53,57745,5357745,Renton city, Washington,1,2018,102152,46.9,80.4,12.4,49738,52414,48248,9496,26987,582,1763,85972,16180
6,16532,616532,Costa Mesa city, California,1,2018,113610,45.9,78.1,11.5,57046,56564,78549,2242,11628,396,0,73095,40515
12,55775,1255775,Pembroke Pines city, Florida,1,2018,172387,38.2,79.1,18.8,81969,90418,106193,39495,9891,1551,249,96523,75864
26,22000,2622000,Detroit city, Michigan,1,2018,672681,41.3,75.5,14,316529,356152,103779,522070,10597,1770,184,619963,52718
26,46000,2646000,Lansing city, Michigan,1,2018,117388,44.8,76.3,12.9,54222,63166,73069,26793,4039,519,0,101103,16285
48,37000,4837000,Irving city, Texas,1,2018,242228,48.4,73,6.4,121658,120570,106844,35443,47988,1057,100,134575,107653
6,13014,613014,Chico city, California,1,2018,94787,50.7,80.9,13.3,45856,48931,76007,2300,3986,799,280,77464,17323
6,10046,610046,Camarillo city, California,0,2018,69112,40.2,77.3,20.8,33539,35573,55881,1493,4832,136,136,50212,18900
12,32275,1232275,Homestead city, Florida,0,2018,70469,43.8,65.2,8.9,33750,36719,44953,12644,686,0,195,21394,49075
20,64500,2064500,Shawnee city, Kansas,0,2018,65844,38.4,73.8,12.7,31167,34677,58153,2617,966,0,0,60480,5364
4,54050,454050,Peoria city, Arizona,1,2018,172272,35.5,76.7,18.1,84667,87605,141243,5653,9248,2497,607,141157,31115
6,82590,682590,Victorville city, California,1,2018,122305,41.4,66.7,8,58474,63831,70153,28692,5855,2139,447,65607,56698
36,11000,3611000,Buffalo city, New York,1,2018,256322,45.3,76.6,12.5,123429,132893,118102,90050,16712,1050,22,223263,33059
48,79000,4879000,Wichita Falls city, Texas,1,2018,104568,46.7,77.5,13.3,54310,50258,78185,13870,3181,1227,0,82876,21692
6,47766,647766,Milpitas city, California,1,2018,80424,43.7,77.3,11.5,42990,37434,11645,3811,54117,327,0,69900,10524
13,3440,1303440,Athens-Clarke County unified government (balance), Georgia,1,2018,126000,57.1,83.2,11.7,60481,65519,79583,35138,4947,311,166,112360,13640
26,76460,2676460,Sterling Heights city, Michigan,1,2018,132967,37.9,77.8,16.8,66262,66705,112657,6242,10309,557,0,131345,1622
25,24960,2524960,Framingham city, Massachusetts,0,2018,73123,42.9,82.8,17.4,37788,35335,49120,5634,6347,0,0,58802,14321
34,51000,3451000,Newark city, New Jersey,1,2018,282102,44.8,75.2,9.9,136968,145134,74843,139245,6047,237,0,171473,110629
49,44320,4944320,Lehi city, Utah,0,2018,66029,44.4,60.9,7.9,32432,33597,60758,43,1654,37,148,62154,3875
40,9050,4009050,Broken Arrow city, Oklahoma,1,2018,110123,40.4,73.8,15,52998,57125,84636,4114,4981,5016,0,100351,9772
6,13392,613392,Chula Vista city, California,1,2018,271653,42.7,73.8,11.5,135432,136221,177460,9984,46536,449,1227,105229,166424
6,57792,657792,Pleasanton city, California,1,2018,82377,35.4,74.5,15.1,41117,41260,46355,1403,28451,376,0,72919,9458
53,23515,5323515,Federal Way city, Washington,1,2018,97037,40.8,74.2,12.6,49468,47569,45835,16075,12370,1644,2459,76515,20522
1,7000,107000,Birmingham city, Alabama,1,2018,209294,42.3,79.2,15.5,96634,112660,56509,141377,2946,361,206,199220,10074
6,17918,617918,Daly City city, California,1,2018,107016,44,85.3,17,51137,55879,22549,2538,62960,161,880,81916,25100
6,60620,660620,Richmond city, California,1,2018,110175,44.3,78.4,13.7,55031,55144,35479,18232,21967,265,1107,66390,43785
6,78120,678120,Temecula city, California,1,2018,114749,39,69.3,10.2,55532,59217,81226,6106,8283,239,2246,77660,37089
6,83346,683346,Walnut Creek city, California,0,2018,69814,33.2,86.6,31.8,32496,37318,49528,1428,11175,167,153,63375,6439
8,7850,807850,Boulder city, Colorado,1,2018,107355,57.5,86.9,11.5,53767,53588,92242,938,6202,193,51,94573,12782
9,50370,950370,New Britain city, Connecticut,1,2018,72440,45.4,76.9,12,35368,37072,52573,8764,2557,48,0,39612,32828
12,10275,1210275,Cape Coral city, Florida,1,2018,189342,29.8,83.6,25.4,94381,94961,170640,10826,3854,0,23,155033,34309
12,36950,1236950,Kissimmee city, Florida,0,2018,73596,50.6,79.9,12.1,37786,35810,51874,9956,2339,0,4,19965,53631
25,9000,2509000,Brockton city, Massachusetts,1,2018,95781,42.7,75.1,13.9,47020,48761,33789,46027,1985,91,0,85388,10393
47,15160,4715160,Clarksville city, Tennessee,1,2018,156800,49.9,74.1,8.1,79914,76886,98694,40681,4825,1503,483,140097,16703
5,15190,515190,Conway city, Arkansas,0,2018,66421,53.5,80.5,12.2,30182,36239,47377,12191,1570,360,0,62671,3750
26,86000,2686000,Westland city, Michigan,1,2018,81714,38.2,79.2,16.8,36466,45248,59001,16122,3625,205,0,78470,3244
5,50450,550450,North Little Rock city, Arkansas,0,2018,66126,40.3,75.2,16.8,31283,34843,36551,25815,435,208,0,62449,3677
45,13330,4513330,Charleston city, South Carolina,1,2018,141088,47.3,82.8,14.4,65108,75980,107995,27218,3005,0,0,135733,5355
48,56348,4856348,Pearland city, Texas,1,2018,124321,41,73.2,13.6,62347,61974,74586,25162,18760,217,0,95913,28408
48,72656,4872656,The Woodlands CDP, Texas,0,2018,107305,29.3,72.7,14.6,52944,54361,91218,4568,5820,111,128,91207,16098
6,884,600884,Alhambra city, California,1,2018,84650,43.1,83.6,17.6,40753,43897,19460,1843,39097,312,38,51610,33040
6,62938,662938,Roseville city, California,1,2018,139110,38.8,76.3,16.9,69014,70096,111786,2169,13304,257,339,119333,19777
6,70000,670000,Santa Monica city, California,1,2018,91417,44,83.7,17.2,46087,45330,69355,4011,9227,351,120,78060,13357
26,88940,2688940,Wyoming city, Michigan,1,2018,75812,43.3,77.6,12.4,35742,40070,54997,4258,5464,867,132,58679,17133
6,69084,669084,Santa Clara city, California,1,2018,129489,49,80.1,12.7,69045,60444,58332,2525,54638,145,389,105856,23633
12,16475,1216475,Davie town, Florida,1,2018,106565,44,79.6,12.6,52859,53706,80700,6403,4840,143,0,59246,47319
47,27740,4727740,Franklin city, Tennessee,0,2018,80920,40,74.9,12.1,38340,42580,66834,6078,5015,32,0,76909,4011
6,48354,648354,Modesto city, California,1,2018,215032,41.5,72.6,12.6,103806,111226,164276,9144,12790,2669,3419,124745,90287
6,52526,652526,Norwalk city, California,1,2018,105125,42.1,76.1,13.8,52101,53024,35801,3881,17869,487,819,32971,72154
39,18000,3918000,Columbus city, Ohio,1,2018,895877,48.7,77.8,10.7,437213,458664,515828,262044,55627,3079,68,841942,53935
8,45970,845970,Longmont city, Colorado,1,2018,95986,40.2,77.9,16.5,48068,47918,84493,1360,3439,830,66,75010,20976
27,6616,2706616,Bloomington city, Minnesota,1,2018,85574,36.4,80.7,20.7,40884,44690,63677,7023,6595,151,4,80608,4966
34,74630,3474630,Union City city, New Jersey,1,2018,68521,47,74.3,10.5,32945,35576,45069,5441,1535,0,0,15669,52852
49,65330,4965330,St. George city, Utah,1,2018,87178,36.8,76.1,24.1,43185,43993,78465,622,615,1648,851,75822,11356
6,45484,645484,Manteca city, California,1,2018,81593,39.1,76.6,13.9,40765,40828,56803,2107,7942,770,878,47479,34114
6,82996,682996,Vista city, California,1,2018,101227,44.4,75.9,9.8,52543,48684,81390,4035,5081,590,283,54321,46906
6,85292,685292,Whittier city, California,1,2018,86060,43.1,79.4,14.8,42530,43530,43187,1033,4786,1570,0,28267,57793
13,4204,1304204,Augusta-Richmond County consolidated government (balance), Georgia,1,2018,196138,43.8,77.5,14.1,93254,102884,70382,112032,4377,595,118,186241,9897
48,53388,4853388,Odessa city, Texas,1,2018,122440,44.7,71,9.5,60903,61537,95567,8127,2001,925,109,52083,70357
53,67000,5367000,Spokane city, Washington,1,2018,219197,43.1,79.9,15.7,107750,111447,185895,5231,4604,2886,2159,204140,15057
47,40000,4740000,Knoxville city, Tennessee,1,2018,187514,48.1,81.9,12.9,90322,97192,142844,31844,2689,615,0,177567,9947
6,60102,660102,Redwood City city, California,1,2018,86186,44.4,79.5,14.5,42032,44154,50664,1718,11578,855,635,52472,33714
12,45975,1245975,Miramar city, Florida,1,2018,140827,40.7,75.5,10.1,68622,72205,52305,69664,11601,314,47,94223,46604
17,65000,1765000,Rockford city, Illinois,1,2018,147676,38.2,75.5,18,70449,77227,101802,31980,5570,216,0,122631,25045
25,37490,2537490,Lynn city, Massachusetts,1,2018,94655,44.4,76.3,12.2,47556,47099,50017,15418,4800,61,0,48074,46581
53,61115,5361115,Sammamish city, Washington,0,2018,65726,35.8,70.2,7.1,32706,33020,-998,-998,-998,-998,-998,63836,1890
6,37692,637692,Jurupa Valley city, California,0,2018,108400,44.3,73.5,11.8,55789,52611,57260,3976,4927,462,363,32383,76017
49,67000,4967000,Salt Lake City city, Utah,1,2018,200576,52.8,80.2,10.4,102709,97867,148780,4734,9523,3252,1774,157445,43131
51,64000,5164000,Portsmouth city, Virginia,1,2018,94632,41.3,76.9,14.7,46138,48494,37625,47317,1429,1554,0,90223,4409
6,39892,639892,Lakewood city, California,1,2018,80132,43.2,80.9,12,39538,40594,36809,6878,15808,439,1030,53382,26750
6,56700,656700,Perris city, California,1,2018,79139,45.8,66.2,5.8,41065,38074,27697,7217,3583,208,290,19362,59777
12,16725,1216725,Deerfield Beach city, Florida,1,2018,80854,34.9,85.3,24,39809,41045,54902,19574,677,97,0,61536,19318
12,17200,1217200,Deltona city, Florida,1,2018,91946,38.4,76,16,45602,46344,67261,11629,2634,0,0,58755,33191
12,57425,1257425,Plantation city, Florida,1,2018,94291,39.8,77.4,16.3,45673,48618,58946,22908,4163,218,0,70192,24099
12,76600,1276600,West Palm Beach city, Florida,1,2018,111389,39.1,82.8,19.7,52855,58534,66194,36960,2027,0,0,81339,30050
40,75000,4075000,Tulsa city, Oklahoma,1,2018,401112,41.1,75.6,14.7,194240,206872,263783,63841,12120,18141,186,334140,66972
6,11530,611530,Carson city, California,1,2018,91899,42.1,77.1,15,42382,49517,26557,22829,17430,486,4238,51276,40623
6,64000,664000,Sacramento city, California,1,2018,508517,45.1,76.6,13.3,247463,261054,225098,67826,99214,2764,10191,360174,148343
6,86972,686972,Yuba City city, California,0,2018,66988,39.5,74.2,16.4,31787,35201,44198,1463,11194,589,1251,46698,20290
12,63000,1263000,St. Petersburg city, Florida,1,2018,265100,39.5,82.2,17.7,128379,136721,178420,58822,13183,1012,580,240688,24412
34,36000,3436000,Jersey City city, New Jersey,1,2018,265560,50,78.4,10.7,132817,132743,90986,60556,70962,2383,0,189638,75922
36,8026,3608026,Brentwood CDP, New York,0,2018,64855,44.4,71.9,8.1,31642,33213,39083,8646,1986,934,84,18019,46836
8,36410,836410,Highlands Ranch CDP, Colorado,0,2018,108257,38.6,73.6,11,53531,54726,98361,1219,5213,203,0,97660,10597
12,17100,1217100,Delray Beach city, Florida,0,2018,69356,35,85.1,25.2,32048,37308,45110,19189,1526,116,41,61031,8325
34,57000,3457000,Paterson city, New Jersey,1,2018,145626,40.6,72.1,11,72398,73228,38944,38204,6561,135,219,57811,87815
48,50820,4850820,New Braunfels city, Texas,0,2018,85566,41,74.8,14.6,43417,42149,79623,1242,611,407,0,53111,32455
49,70850,4970850,South Jordan city, Utah,0,2018,74155,45,67.4,8.9,35788,38367,63833,807,2924,99,30,68084,6071
48,5000,4805000,Austin city, Texas,1,2018,964243,51.4,80.3,9.4,486285,477958,682357,82148,73960,8555,439,649294,314949
6,22230,622230,El Monte city, California,1,2018,115602,42.5,76,13.3,56533,59069,53017,842,30897,1973,347,36036,79566
1,3076,103076,Auburn city, Alabama,0,2018,65737,60,82,8,31482,34255,48691,9784,5671,0,0,63656,2081
6,24477,624477,Florence-Graham CDP, California,0,2018,63621,46.2,68,8,32442,31179,-998,-998,-998,-998,-998,4540,59081
6,44574,644574,Lynwood city, California,1,2018,70492,46.3,72.6,8.2,34445,36047,38803,5682,674,468,130,9406,61086
10,77580,1077580,Wilmington city, Delaware,1,2018,70653,43.1,78.2,11.8,34605,36048,26621,40965,760,206,83,63471,7182
12,39425,1239425,Largo city, Florida,1,2018,85008,31.9,84.9,27.6,38063,46945,74801,5256,1513,120,21,74537,10471
4,4720,404720,Avondale city, Arizona,1,2018,85828,46.4,71.7,8.9,42328,43500,58546,10346,3117,814,123,41678,44150
6,6000,606000,Berkeley city, California,1,2018,121654,57.1,88.6,13.7,61022,60632,64094,9894,29839,687,758,106703,14951
27,58000,2758000,St. Paul city, Minnesota,1,2018,307701,46.5,75.8,10.8,151617,156084,173556,45362,59746,3217,86,281620,26081
37,55000,3755000,Raleigh city, North Carolina,1,2018,470509,48.6,79.6,11.3,228779,241730,271068,132356,22926,888,0,420235,50274
6,3666,603666,Baldwin Park city, California,1,2018,75806,45.2,78.5,10.5,37397,38409,33502,589,15349,1046,0,19724,56082
18,5860,1805860,Bloomington city, Indiana,1,2018,86522,68.7,88.6,9.6,44262,42260,69643,3370,9464,654,0,83164,3358
2,3000,203000,Anchorage municipality, Alaska,1,2018,291538,43.6,75.5,11.3,148668,142870,181491,16679,28273,22022,6105,264431,27107
42,60000,4260000,Philadelphia city, Pennsylvania,1,2018,1584138,44.8,78.3,13.6,750017,834121,623482,657756,116907,4326,582,1343869,240269
17,14351,1714351,Cicero town, Illinois,1,2018,81602,44.5,72.3,8.1,39115,42487,28614,3058,64,147,34,11133,70469
24,30325,2430325,Frederick city, Maryland,0,2018,72152,42.3,76.5,13.4,35359,36793,54106,11101,3854,0,0,57262,14890
25,23000,2523000,Fall River city, Massachusetts,1,2018,89662,37.8,77.8,16.7,42429,47233,74561,5658,2475,59,0,82145,7517
25,62535,2562535,Somerville city, Massachusetts,1,2018,81568,63.9,87.8,7.7,40572,40996,60477,5083,7492,204,0,72240,9328
48,13024,4813024,Carrollton city, Texas,1,2018,136869,41.9,77.3,12.5,64303,72566,94309,16413,19661,149,396,93045,43824
6,44000,644000,Los Angeles city, California,1,2018,3990469,46.1,79.8,12.8,1995286,1995183,2072924,345892,481963,30566,7017,2038613,1951856
6,8954,608954,Burbank city, California,1,2018,103687,41.3,82.5,15,51615,52072,77672,2307,12766,894,0,81369,22318
37,28080,3728080,Greenville city, North Carolina,1,2018,93136,59.6,80.8,9.3,43005,50131,50812,35016,2810,660,0,88533,4603
6,60018,660018,Redondo Beach city, California,1,2018,67396,37.1,76.8,13.4,33336,34060,46842,3957,9008,341,89,54701,12695
19,38595,1938595,Iowa City city, Iowa,1,2018,76291,58.6,85.2,10.8,40165,36126,57333,6640,6546,134,250,72264,4027
37,14100,3714100,Concord city, North Carolina,1,2018,94134,39.9,75.4,13.8,46368,47766,59999,22433,5278,0,74,82686,11448
48,45384,4845384,McAllen city, Texas,1,2018,143429,43.7,69.9,11.8,68066,75363,113985,773,4947,106,0,18427,125002
17,3012,1703012,Aurora city, Illinois,1,2018,206389,42.9,70.9,9,102657,103732,133728,19436,17960,1665,126,113672,92717
20,36000,2036000,Kansas City city, Kansas,1,2018,154361,41.2,72,12.1,76933,77428,86325,34052,7768,618,1379,107553,46808
32,31900,3231900,Henderson city, Nevada,1,2018,310374,36.7,78.1,18.9,151415,158959,228182,18097,26810,1765,2334,256474,53900
48,30464,4830464,Grand Prairie city, Texas,1,2018,194600,44.2,72.7,9.5,93287,101313,117963,36313,11677,676,175,98351,96249
5,23290,523290,Fayetteville city, Arkansas,1,2018,86765,59.7,82.7,7.6,43372,43393,68149,5433,2687,659,1078,79394,7371
48,56000,4856000,Pasadena city, Texas,1,2018,153212,44.8,71.4,9.2,76591,76621,137365,4196,2290,2481,35,44416,108796
6,73430,673430,South Whittier CDP, California,0,2018,65577,42.3,75.4,11.8,32411,33166,24978,225,4921,256,705,15772,49805
12,24125,1224125,Fort Myers city, Florida,0,2018,82260,34.7,80,24.2,39940,42320,50588,18790,2159,0,185,63648,18612
12,58715,1258715,Port St. Lucie city, Florida,1,2018,195251,35.9,78.3,21.1,95575,99676,144022,37720,3977,0,230,158547,36704
48,29336,4829336,Georgetown city, Texas,0,2018,74176,31.9,78.9,28.5,34774,39402,66749,4113,826,135,91,55844,18332
48,76000,4876000,Waco city, Texas,1,2018,138180,50.1,75.3,11.1,66618,71562,100206,29326,2646,249,28,91175,47005
5,24550,524550,Fort Smith city, Arkansas,1,2018,87851,40.5,75.6,14.1,43567,44284,55900,8662,4910,1048,57,70523,17328
6,13588,613588,Citrus Heights city, California,1,2018,87916,41.9,79.1,16.5,42182,45734,71654,2362,3726,633,302,68716,19200
6,24680,624680,Fontana city, California,1,2018,213736,46.1,72.4,7.9,106494,107242,77981,16967,13046,877,334,63678,150058
32,51800,3251800,North Las Vegas city, Nevada,1,2018,245949,42.7,71.8,10.6,120011,125938,129926,49211,12521,1559,3750,139304,106645
6,562,600562,Alameda city, California,1,2018,78322,38.8,79,17.3,38198,40124,37702,5863,21905,97,421,68220,10102
22,41155,2241155,Lake Charles city, Louisiana,1,2018,77999,42.1,76.9,14.6,38777,39222,-998,-998,-998,-998,-998,75611,2388
27,51730,2751730,Plymouth city, Minnesota,1,2018,79437,39,78.2,14.1,40265,39172,60194,5451,9381,139,111,75633,3804
4,55000,455000,Phoenix city, Arizona,1,2018,1660272,44.2,74.2,10.8,824568,835704,1278742,121943,57194,40653,2989,945954,714318
21,46027,2146027,Lexington-Fayette urban county, Kentucky,1,2018,323780,45.6,79.2,13.3,158158,165622,240762,47626,12495,356,0,299752,24028
6,11390,611390,Carmichael CDP, California,0,2018,65328,37.3,78.3,20,31376,33952,51486,2655,3945,320,45,54557,10771
18,54180,1854180,Noblesville city, Indiana,0,2018,66358,45.3,72.6,10.5,33273,33085,-998,-998,-998,-998,-998,65051,1307
27,7966,2707966,Brooklyn Park city, Minnesota,1,2018,80614,39,72.1,12.3,38689,41925,33961,27166,13912,0,50,75021,5593
39,15000,3915000,Cincinnati city, Ohio,1,2018,302615,46.5,78.6,12.5,146754,155861,155452,123267,7028,244,55,291842,10773
39,88000,3988000,Youngstown city, Ohio,1,2018,64958,40.3,78.9,17.8,32300,32658,31954,25113,417,217,0,56806,8152
47,38320,4738320,Johnson City city, Tennessee,0,2018,68245,41.9,83.7,16.2,33183,35062,58063,4656,2244,291,0,64456,3789
48,13552,4813552,Cedar Park city, Texas,0,2018,75553,42.9,72.3,8.4,37207,38346,60595,2481,6512,167,0,58551,17002
48,57200,4857200,Pharr city, Texas,1,2018,79704,43.7,67.1,10.6,36682,43022,-998,-998,-998,-998,-998,5486,74218
6,53980,653980,Orange city, California,1,2018,139502,45.3,79.6,11.9,70020,69482,101663,2417,17803,283,183,86269,53233
48,27684,4827684,Frisco city, Texas,1,2018,188153,40.8,69.2,8.7,93624,94529,121347,18325,39223,919,0,167387,20766
48,42508,4842508,Lewisville city, Texas,1,2018,106205,47.5,76,8.8,52430,53775,73535,12675,10480,416,93,72525,33680
55,39225,5539225,Kenosha city, Wisconsin,1,2018,100151,40.9,76,12.6,50319,49832,78421,11042,2674,414,83,82757,17394
22,50115,2250115,Metairie CDP, Louisiana,0,2018,141114,37,81.1,19.9,70454,70660,112695,15003,6866,380,67,120524,20590
6,50076,650076,Murrieta city, California,1,2018,114982,39,70.5,11.9,58574,56408,82876,4617,10227,43,226,75789,39193
23,60545,2360545,Portland city, Maine,1,2018,66420,46.3,84.7,12.9,32586,33834,58143,5102,1310,27,109,65290,1130
27,54880,2754880,Rochester city, Minnesota,1,2018,116957,40.7,77,15.4,57492,59465,92665,9964,8710,200,64,109824,7133
6,36770,636770,Irvine city, California,1,2018,282584,48,77.9,10.5,138076,144508,137841,2936,120706,1198,402,247353,35231
6,41992,641992,Livermore city, California,1,2018,90258,37,77.1,13.6,45064,45194,65759,2753,10895,225,788,72387,17871
48,47892,4847892,Mesquite city, Texas,1,2018,142874,39.9,68.3,9.6,70739,72135,91312,34843,3629,1357,40,74409,68465
53,3180,5303180,Auburn city, Washington,1,2018,82782,39.1,75.7,13.9,40948,41834,49411,6087,10683,1168,1238,67989,14793
6,32548,632548,Hawthorne city, California,1,2018,86970,42.8,76.2,9.9,39957,47013,35610,24695,7573,1182,366,43288,43682
12,75875,1275875,Wesley Chapel CDP, Florida,0,2018,65249,40.5,74.1,11,32094,33155,47105,6455,5335,424,38,51994,13255
20,53775,2053775,Overland Park city, Kansas,1,2018,192525,40.2,77.8,16.1,95915,96610,157046,9319,17779,603,128,178615,13910
29,70000,2970000,Springfield city, Missouri,1,2018,168113,45.8,82.8,17.6,82007,86106,151016,6551,2844,982,36,161561,6552
6,2364,602364,Apple Valley town, California,1,2018,73508,34.1,70.9,15.6,35771,37737,55980,6657,1247,254,2,47117,26391
6,4982,604982,Bellflower city, California,1,2018,77132,44,75.7,10.2,37337,39795,24296,9733,10031,258,1263,34616,42516
6,8786,608786,Buena Park city, California,1,2018,82435,43.4,78.8,12.1,40112,42323,42395,2605,28735,444,250,52628,29807
18,22000,1822000,Evansville city, Indiana,1,2018,117967,41.7,78.8,15.5,58319,59648,92986,17983,1382,156,0,113734,4233
4,46000,446000,Mesa city, Arizona,1,2018,508979,40.2,75.9,16.4,250913,258066,412281,25378,8360,13246,2400,366448,142531
6,13210,613210,Chino city, California,1,2018,91589,44.8,78,13.2,46721,44868,50505,5588,15651,487,226,46820,44769
8,83835,883835,Westminster city, Colorado,1,2018,113473,42.7,80,13.5,58634,54839,99666,2961,3481,1288,52,85250,28223
37,12000,3712000,Charlotte city, North Carolina,1,2018,872506,45.8,77,10.9,421513,450993,412362,311637,61615,4507,269,745742,126764
48,39148,4839148,Killeen city, Texas,1,2018,149102,47.9,69,6.4,73090,76012,65326,64870,4563,1694,1207,108242,40860
49,55980,4955980,Ogden city, Utah,1,2018,87305,48,73.6,10.7,43909,43396,75256,1624,1023,912,803,61098,26207
13,19000,1319000,Columbus city, Georgia,1,2018,194160,42.5,75.2,13.4,94670,99490,83257,91077,4211,107,224,179273,14887
51,47672,5147672,Lynchburg city, Virginia,1,2018,82126,49.2,80.5,14.5,38123,44003,52897,23311,1889,277,0,78509,3617
51,67000,5167000,Richmond city, Virginia,1,2018,228783,49.1,82.6,13.2,107729,121054,108092,106543,5502,236,0,212607,16176
6,69070,669070,Santa Barbara city, California,1,2018,91330,42.5,82.3,18.2,45623,45707,72303,960,4098,817,0,51719,39611
12,54000,1254000,Palm Bay city, Florida,1,2018,114190,33.9,80,23.1,54497,59693,83716,17650,2684,256,0,94430,19760
17,12385,1712385,Champaign city, Illinois,1,2018,88033,55.8,81.6,11.2,43833,44200,53772,17104,14080,9,0,82792,5241
53,57535,5357535,Redmond city, Washington,0,2018,67680,49.5,73.8,8,35073,32607,38497,1413,23119,412,0,59310,8370
6,68196,668196,San Marcos city, California,1,2018,96834,44.7,76,12,49201,47633,73554,1775,8314,365,0,51611,45223
8,62000,862000,Pueblo city, Colorado,1,2018,111751,39.8,78.1,18.8,55273,56478,85916,3399,1053,4194,79,58375,53376
37,28000,3728000,Greensboro city, North Carolina,1,2018,294726,43.1,78.3,13.9,138206,156520,141028,119500,14874,1369,5,269082,25644
42,2000,4202000,Allentown city, Pennsylvania,1,2018,121429,45.5,75.8,12.4,59802,61627,71941,18651,5137,1318,0,55998,65431
6,39248,639248,Laguna Niguel city, California,0,2018,66265,37.5,82.6,17,33355,32910,49118,1799,6940,0,94,55279,10986
6,65084,665084,San Clemente city, California,0,2018,64850,33.9,78.5,18.1,32337,32513,53327,792,2927,91,0,51899,12951
17,2154,1702154,Arlington Heights village, Illinois,1,2018,77259,36.3,80.7,20.6,37748,39511,62939,893,10323,38,115,71672,5587
53,5210,5305210,Bellevue city, Washington,1,2018,147595,43.5,79.3,14.4,75209,72386,78543,4224,55089,145,0,138314,9281
55,84250,5584250,Waukesha city, Wisconsin,1,2018,72549,44.6,80.1,14.6,35607,36942,65395,2539,3158,186,0,64349,8200
27,43000,2743000,Minneapolis city, Minnesota,1,2018,425395,52.4,79.8,10.8,214813,210582,270795,82552,26877,7745,0,384483,40912
40,52500,4052500,Norman city, Oklahoma,1,2018,123469,53.5,79.8,11.6,60581,62888,91114,6588,6971,6597,47,112590,10879
4,12000,412000,Chandler city, Arizona,1,2018,257153,41.6,75.5,11.8,126583,130570,187013,13379,31287,3531,581,205321,51832
12,71000,1271000,Tampa city, Florida,1,2018,392905,45.8,77.6,12.5,192670,200235,246391,94786,15046,1295,0,286949,105956
21,48006,2148006,Louisville/Jefferson County metro government (balance), Kentucky,1,2018,620149,40.1,77.5,15.4,302893,317256,426337,149053,17961,1829,0,585170,34979
48,29000,4829000,Garland city, Texas,1,2018,242402,42.8,74.1,12.4,118496,123906,148644,35681,29998,2558,0,137716,104686
48,45744,4845744,McKinney city, Texas,1,2018,191666,41.5,72,11.2,92013,99653,145554,22319,13257,728,0,158297,33369
19,19000,1919000,Davenport city, Iowa,1,2018,102080,41.1,77.6,15,50743,51337,82594,10356,2837,471,175,94314,7766
48,72176,4872176,Temple city, Texas,0,2018,76251,39.1,74.8,17.3,36475,39776,57986,11152,1106,420,0,56318,19933
6,59962,659962,Redlands city, California,1,2018,71595,42.1,79,16.4,32314,39281,54642,3351,4480,52,306,46473,25122
12,72145,1272145,Town 'n' Country CDP, Florida,0,2018,82577,41.8,79.6,14.9,40805,41772,61582,6181,4147,236,0,39512,43065
16,52120,1652120,Meridian city, Idaho,1,2018,106794,41.5,71,9.7,52903,53891,95137,227,4297,350,460,98454,8340
28,36000,2836000,Jackson city, Mississippi,1,2018,164720,44.7,76.1,13.3,75656,89064,25874,136279,824,146,27,162785,1935
47,37640,4737640,Jackson city, Tennessee,0,2018,66900,41.3,75.8,14.6,31566,35334,30588,32058,1033,80,0,63439,3461
12,7875,1207875,Boynton Beach city, Florida,1,2018,78038,38.6,82.7,22.9,36897,41141,41802,28311,2666,156,0,67396,10642
12,68350,1268350,Spring Hill CDP, Florida,0,2018,117519,34.8,79.5,23.4,56881,60638,99768,8343,1893,598,0,94457,23062
26,49000,2649000,Livonia city, Michigan,1,2018,93970,37.4,79.7,16.9,46458,47512,82735,4277,3707,473,0,91491,2479
48,7000,4807000,Beaumont city, Texas,1,2018,118425,40.7,75,15,56416,62009,53687,55408,4948,126,0,97689,20736
6,75000,675000,Stockton city, California,1,2018,311189,43.1,71.7,12.3,151561,159628,145895,37348,69347,1579,2003,179998,131191
36,84000,3684000,Yonkers city, New York,1,2018,199646,39.1,81,17.1,95456,104190,103825,40916,9398,1344,0,120774,78872
17,59000,1759000,Peoria city, Illinois,1,2018,115720,40.6,75.1,15.3,55443,60277,70808,29876,7476,511,0,108827,6893
26,27440,2627440,Farmington Hills city, Michigan,1,2018,81103,36.4,82.9,20.8,39123,41980,49645,16377,12304,595,171,78430,2673
29,15670,2915670,Columbia city, Missouri,1,2018,123182,54.8,81.5,10.9,59551,63631,97048,11041,7653,553,0,118020,5162
37,31400,3731400,High Point city, North Carolina,1,2018,114322,40.9,76.1,14.6,53691,60631,55898,37200,9727,1269,46,102336,11986
36,15000,3615000,Cheektowaga CDP, New York,0,2018,74223,43.4,83.4,19.3,34792,39431,58007,10618,1990,224,0,72384,1839
5,35710,535710,Jonesboro city, Arkansas,1,2018,76990,44.4,73.1,11.4,36818,40172,56699,16246,634,326,0,72298,4692
6,73262,673262,South San Francisco city, California,0,2018,67736,40.3,82,18.5,32860,34876,22128,1120,29427,171,370,46683,21053
12,58050,1258050,Pompano Beach city, Florida,1,2018,111930,36.1,83,20.1,58674,53256,64154,41216,1511,203,36,90040,21890
29,35000,2935000,Independence city, Missouri,1,2018,116939,37.8,78.2,16.8,54315,62624,96479,11088,990,316,2055,110105,6834
37,74440,3774440,Wilmington city, North Carolina,1,2018,122610,45.3,82.9,17.1,57238,65372,91104,26057,1823,258,0,115396,7214
48,1924,4801924,Allen city, Texas,1,2018,103378,37,75,10.2,53478,49900,71117,10517,19157,691,0,92277,11101
48,70808,4870808,Sugar Land city, Texas,1,2018,118614,36.5,78.9,17.4,57942,60672,64922,6721,41506,699,43,101920,16694
6,27000,627000,Fresno city, California,1,2018,530073,43.8,72.1,11.4,261641,268432,317715,35127,75516,7929,775,267735,262338
6,53000,653000,Oakland city, California,1,2018,429114,46.6,80.9,13.5,204202,224912,150454,99449,65748,3743,3324,315476,113638
31,28000,3128000,Lincoln city, Nebraska,1,2018,287399,46.7,77.8,13.2,144380,143019,242363,12423,12494,2057,123,265060,22339
4,64210,464210,San Tan Valley CDP, Arizona,0,2018,105922,41.2,68.6,11.1,51620,54302,90617,2811,3060,943,69,78646,27276
19,73335,1973335,Sioux City city, Iowa,1,2018,82762,39.8,73.1,14,41312,41450,70635,4374,2499,1873,137,67149,15613
27,40166,2740166,Maple Grove city, Minnesota,0,2018,71812,35.8,77,15.5,35348,36464,59177,4019,4262,805,0,69289,2523
51,56000,5156000,Newport News city, Virginia,1,2018,178626,44.1,76.9,13.1,87141,91485,85037,75446,6400,126,381,162225,16401
6,68252,668252,San Mateo city, California,1,2018,105016,41.1,79.9,16.9,51736,53280,54868,2274,27655,457,2683,85666,19350
22,5000,2205000,Baton Rouge city, Louisiana,1,2018,221606,46.3,78.8,15.3,106292,115314,84217,122315,6966,246,0,212566,9040
72,32522,7232522,Guaynabo zona urbana, Puerto Rico,0,2018,67294,37.2,85.5,23.1,32724,34570,50632,5085,121,36,0,966,66328
9,80000,980000,Waterbury city, Connecticut,1,2018,108086,43.1,76.1,12.4,50468,57618,65751,23701,2261,586,0,69804,38282
48,1000,4801000,Abilene city, Texas,1,2018,125456,48.6,76.1,12.5,64161,61295,88513,13299,3726,470,27,91321,34135
51,76432,5176432,Suffolk city, Virginia,1,2018,91185,37.7,75.8,14.4,44445,46740,46485,37311,1952,174,0,86926,4259
1,35896,135896,Hoover city, Alabama,1,2018,85115,36.7,72.9,17.8,39998,45117,60576,14801,4687,198,43,78670,6445
6,39496,639496,Lake Forest city, California,1,2018,85619,40,77.8,15.1,41395,44224,54985,3286,17223,148,344,70147,15472
12,71569,1271569,The Hammocks CDP, Florida,0,2018,64910,38.6,78.8,17.7,31000,33910,51441,2341,1359,0,0,13899,51011
24,32025,2432025,Germantown CDP, Maryland,0,2018,81399,40.1,74.2,12.1,37946,43453,41120,14699,14343,138,0,62369,19030
48,15976,4815976,College Station city, Texas,1,2018,116218,66.1,84.1,7.8,59676,56542,91533,6765,12060,107,0,93480,22738
42,61000,4261000,Pittsburgh city, Pennsylvania,1,2018,301038,51.1,86,15.6,143718,157320,202511,68867,16813,690,157,290858,10180
34,56550,3456550,Passaic city, New Jersey,1,2018,69945,44.1,70.2,9.8,35704,34241,40141,4991,1832,478,0,15487,54458
24,81175,2481175,Waldorf CDP, Maryland,0,2018,78591,42.8,74.8,9.4,36316,42275,18644,51929,2109,481,0,72081,6510
34,10000,3410000,Camden city, New Jersey,1,2018,73968,41.3,70.1,9.8,33272,40696,10844,29375,1288,227,0,34522,39446
48,48768,4848768,Mission city, Texas,1,2018,84829,37,64.3,13.6,40715,44114,-998,-998,-998,-998,-998,7154,77675
6,69000,669000,Santa Ana city, California,1,2018,332727,46.4,74.5,9.7,173527,159200,143656,5420,38202,1529,393,77765,254962
6,81204,681204,Union City city, California,1,2018,74568,44.4,82.2,15.7,37854,36714,13936,3252,38022,290,567,55782,18786
39,77000,3977000,Toledo city, Ohio,1,2018,274973,42.6,76.8,14,133721,141252,168318,75931,2873,1093,390,250348,24625
41,59000,4159000,Portland city, Oregon,1,2018,652573,47.1,82.2,13.4,322810,329763,503158,40763,58246,6184,4657,591813,60760
48,35000,4835000,Houston city, Texas,1,2018,2326090,46.4,75.1,10.6,1154069,1172021,1252435,522419,169263,8662,1259,1281160,1044930
53,80010,5380010,Yakima city, Washington,1,2018,93874,40.7,73.5,17,46778,47096,70046,930,823,2038,114,52939,40935
6,67000,667000,San Francisco city, California,1,2018,883305,48.3,86.6,15.6,450985,432320,400727,45886,302795,2308,2126,748641,134664
22,55000,2255000,New Orleans city, Louisiana,1,2018,391006,43.2,80,14.7,185255,205751,133177,231314,10870,706,0,369044,21962
6,18100,618100,Davis city, California,0,2018,69288,59.5,85.2,10.8,34035,35253,45445,920,16367,0,0,60471,8817
12,69700,1269700,Sunrise city, Florida,1,2018,95461,40,81.8,20,45150,50311,50272,31418,5099,58,268,62001,33460
18,10342,1810342,Carmel city, Indiana,1,2018,95767,36.9,75.3,13.8,47864,47903,78463,3719,9605,0,107,90775,4992
27,56896,2756896,St. Cloud city, Minnesota,0,2018,68928,51.9,81.1,11.6,35849,33079,51770,10622,2854,234,0,67581,1347
34,3580,3403580,Bayonne city, New Jersey,0,2018,65082,40.3,75.2,14.8,32197,32885,38362,7684,6849,0,0,38057,27025
48,4462,4804462,Atascocita CDP, Texas,0,2018,86243,43.9,72.5,8,45200,41043,63785,16308,2567,102,0,61937,24306
55,66000,5566000,Racine city, Wisconsin,1,2018,77434,42.7,73.5,11.9,38220,39214,52958,18363,897,169,71,60471,16963
35,2000,3502000,Albuquerque city, New Mexico,1,2018,560234,41.6,78.3,15.8,273480,286754,435061,18280,17866,25410,65,283457,276777
41,47000,4147000,Medford city, Oregon,1,2018,82348,36.9,77.3,18,39085,43263,72819,1317,1237,1508,393,67735,14613
41,64900,4164900,Salem city, Oregon,1,2018,173420,40.5,76.3,14.8,89014,84406,136284,2892,5162,3539,1719,135326,38094
27,71428,2771428,Woodbury city, Minnesota,0,2018,71299,37.7,72.3,14,35201,36098,57656,1985,8505,247,35,67945,3354
29,65000,2965000,St. Louis city, Missouri,1,2018,302838,45.1,81,13.8,146922,155916,142649,137404,10878,685,432,290329,12509
12,45025,1245025,Miami Beach city, Florida,1,2018,91715,44,86.5,16.8,45938,45777,72503,4908,1445,75,0,41924,49791
19,1855,1901855,Ames city, Iowa,0,2018,67155,66.6,88.2,9.8,36077,31078,53514,1176,7902,93,0,64177,2978
24,32650,2432650,Glen Burnie CDP, Maryland,0,2018,65987,46.7,81.1,12.8,32874,33113,42992,13625,4036,0,61,61274,4713
27,35180,2735180,Lakeville city, Minnesota,0,2018,65871,38.2,72.1,9.8,32451,33420,-998,-998,-998,-998,-998,61250,4621
44,59000,4459000,Providence city, Rhode Island,1,2018,179335,50.2,77.2,11.7,86616,92719,106728,31432,12738,716,0,104158,75177
53,5280,5305280,Bellingham city, Washington,1,2018,90660,56.4,86.9,14.6,44190,46470,75011,1471,6418,276,92,79708,10952
4,77000,477000,Tucson city, Arizona,1,2018,545987,45.8,78.9,14.8,268484,277503,380776,31817,17373,24125,1229,307849,238138
6,43000,643000,Long Beach city, California,1,2018,467353,44.6,79.4,11.3,230683,236670,228023,62817,61105,4082,3029,274135,193218
19,21000,1921000,Des Moines city, Iowa,1,2018,216993,44.3,74.9,11.7,105590,111403,162746,24112,15057,563,0,185287,31706
41,31250,4131250,Gresham city, Oregon,1,2018,110165,42.4,75.9,13.5,55251,54914,91934,3881,4597,858,843,84098,26067
6,11194,611194,Carlsbad city, California,1,2018,115897,34.3,79.3,19.3,57672,58225,99089,2519,9825,100,0,100146,15751
6,60466,660466,Rialto city, California,1,2018,103446,43.9,73,12.4,50945,52501,65257,13595,2288,166,0,26754,76692
12,38250,1238250,Lakeland city, Florida,1,2018,110494,38.6,79.9,19.5,52991,57503,78754,25220,1894,387,0,90276,20218
26,3000,2603000,Ann Arbor city, Michigan,1,2018,121885,62.4,86.4,10.8,59821,62064,86802,7418,21855,92,0,116461,5424
36,49121,3649121,Mount Vernon city, New York,1,2018,67606,39.8,78.1,14,29648,37958,13368,44103,662,52,0,54632,12974
45,61405,4561405,Rock Hill city, South Carolina,1,2018,74308,45.1,75.5,14,34005,40303,42152,27349,901,194,0,66942,7366
48,41464,4841464,Laredo city, Texas,1,2018,259512,43.5,67.4,9.5,127654,131858,250434,1532,1591,116,0,12412,247100
48,48804,4848804,Missouri City city, Texas,1,2018,72978,41.9,79.3,14.2,34706,38272,26654,29272,12518,0,0,61691,11287
6,2252,602252,Antioch city, California,1,2018,111535,41.2,74.7,12.9,54865,56670,46695,22219,14829,978,397,69917,41618
6,16350,616350,Corona city, California,1,2018,168826,43,71.6,9.6,85465,83361,100921,11986,17378,738,1101,85560,83266
12,410,1200410,Alafaya CDP, Florida,0,2018,92740,47.1,79.1,10.3,43868,48872,70502,5681,7961,641,0,58654,34086
6,48256,648256,Mission Viejo city, California,1,2018,95196,32.9,82.1,20.3,46160,49036,73855,1307,11648,122,66,76773,18423
6,80854,680854,Tustin city, California,1,2018,79787,42.1,73.8,9.7,40189,39598,38115,2125,15379,90,50,39491,40296
12,39550,1239550,Lauderhill city, Florida,1,2018,72081,39.1,73.7,13.2,33968,38113,9190,58099,800,182,0,66557,5524
12,43975,1243975,Melbourne city, Florida,1,2018,82823,36.6,80.7,19.5,37991,44832,64212,9805,2875,7,477,71315,11508
34,73110,3473110,Toms River CDP, New Jersey,0,2018,91268,36.7,77.7,19.1,44688,46580,79451,1980,4156,398,0,81270,9998
32,23770,3223770,Enterprise CDP, Nevada,0,2018,187078,46.9,75,9.6,95251,91827,94242,23858,41515,1680,387,155334,31744
48,58016,4858016,Plano city, Texas,1,2018,287765,41.3,76.8,13.2,143215,144550,184130,21986,66814,1427,50,245086,42679
4,10670,410670,Casas Adobes CDP, Arizona,0,2018,75694,38.3,80,19.8,39725,35969,61556,1499,3473,351,0,56100,19594
16,56260,1656260,Nampa city, Idaho,1,2018,96245,40,73.8,15.4,46828,49417,79917,396,1387,510,408,74397,21848
51,1000,5101000,Alexandria city, Virginia,1,2018,160530,49,81.7,12.2,77087,83443,100922,36569,9090,0,82,133643,26887
13,80508,1380508,Warner Robins city, Georgia,1,2018,75413,45,77,10.7,37548,37865,-998,-998,-998,-998,-998,70196,5217
16,8830,1608830,Boise City city, Idaho,1,2018,228807,43.7,80.6,15.4,114632,114175,201557,6267,8698,1198,421,208576,20231
17,70122,1770122,Skokie village, Illinois,0,2018,63292,33.2,76.5,19.7,31315,31977,32746,5066,18978,0,656,58555,4737
33,45140,3345140,Manchester city, New Hampshire,1,2018,112529,46.9,78.5,12.6,55221,57308,90064,8719,7304,57,42,100495,12034
6,33182,633182,Hemet city, California,1,2018,85291,34.6,75.5,25.1,40333,44958,65498,5047,2968,966,97,46934,38357
6,59920,659920,Redding city, California,1,2018,91777,39.4,79.1,18.2,44183,47594,77301,1569,4207,1421,162,82832,8945
12,24000,1224000,Fort Lauderdale city, Florida,1,2018,182611,36.6,84.4,18.2,94013,88598,111851,57816,3279,772,453,147100,35511
20,79000,2079000,Wichita city, Kansas,1,2018,389259,40.4,74.8,14.7,192356,196903,285945,44681,17677,4942,166,318695,70564
48,27000,4827000,Fort Worth city, Texas,1,2018,898919,43.4,72.6,9.7,442049,456870,546141,170498,43267,6617,1497,579873,319046
19,2305,1902305,Ankeny city, Iowa,0,2018,65282,42.3,76.5,12.3,30926,34356,-998,-998,-998,-998,-998,63344,1938
29,41348,2941348,Lee's Summit city, Missouri,1,2018,98919,34.4,74.5,17.3,47729,51190,85213,5844,2452,115,0,93724,5195
47,51560,4751560,Murfreesboro city, Tennessee,1,2018,141336,50.3,77.6,9.9,70278,71058,101154,28270,4762,461,0,132170,9166
8,12815,812815,Centennial city, Colorado,1,2018,110822,38.9,75.5,14.4,56436,54386,94183,3535,6664,431,87,97674,13148
26,34000,2634000,Grand Rapids city, Michigan,1,2018,200230,48.8,76.8,12.4,96945,103285,134229,37061,4431,1063,204,163761,36469
6,11964,611964,Castro Valley CDP, California,0,2018,63226,35.4,76.2,17.3,30109,33117,28939,4631,20682,324,101,53185,10041
26,69035,2669035,Rochester Hills city, Michigan,1,2018,74700,36.7,76.3,16.9,34961,39739,60164,2595,10148,128,0,70738,3962
27,6382,2706382,Blaine city, Minnesota,0,2018,65215,41.7,73.6,11.6,32067,33148,49289,5604,5517,294,0,60518,4697
6,51182,651182,Newport Beach city, California,1,2018,85315,35.5,85.2,23.7,43364,41951,73190,2058,5861,178,249,78321,6994
12,56825,1256825,Pine Hills CDP, Florida,0,2018,90070,39.3,69.4,12.2,43201,46869,13669,65806,2049,1642,0,77250,12820
24,19125,2419125,Columbia CDP, Maryland,0,2018,106772,38.8,78.1,16.6,52247,54525,59665,28067,13003,527,0,96334,10438
6,65042,665042,San Buenaventura (Ventura) city, California,1,2018,111120,39.4,78.9,17.5,53746,57374,95410,2709,5729,796,0,67048,44072
48,45000,4845000,Lubbock city, Texas,1,2018,255885,48.6,77,12.3,125399,130486,205415,20449,7122,2452,531,164321,91564
26,42160,2642160,Kalamazoo city, Michigan,1,2018,76557,58.1,81.9,10.5,37885,38672,50858,16647,1365,122,0,70201,6356
27,17000,2717000,Duluth city, Minnesota,1,2018,85884,45.8,83.5,18,42241,43643,76848,1581,1231,1728,36,83532,2352
8,46465,846465,Loveland city, Colorado,1,2018,77444,41,77.7,17.9,37784,39660,72849,702,387,358,0,68521,8923
34,19390,3419390,East Orange city, New Jersey,0,2018,64469,43.3,75.8,13.1,29088,35381,1682,51252,508,282,241,54181,10288
4,7940,407940,Buckeye city, Arizona,0,2018,74378,38.3,72.1,16.1,38957,35421,52929,3657,2395,1664,113,45373,29005
6,30000,630000,Glendale city, California,1,2018,201374,39.3,83,17.7,91915,109459,157995,2640,27051,952,125,166140,35234
6,69088,669088,Santa Clarita city, California,1,2018,210085,37.5,74.7,12.7,103814,106271,149099,4777,21404,1113,55,135685,74400
47,52006,4752006,Nashville-Davidson metropolitan government (balance), Tennessee,1,2018,665498,47.2,79.4,12,320837,344661,416071,184470,23845,927,852,594339,71159
53,53545,5353545,Pasco city, Washington,0,2018,71727,43.8,66,9.7,36591,35136,48344,2448,2415,1747,0,31128,40599
12,7300,1207300,Boca Raton city, Florida,1,2018,99241,31.4,83.1,30,48239,51002,86155,5541,2617,0,95,86072,13169
36,50617,3650617,New Rochelle city, New York,1,2018,78747,40.7,77.5,15.7,37597,41150,41927,14853,5514,231,0,53262,25485
6,28000,628000,Fullerton city, California,1,2018,139629,44.3,78.8,13.1,68028,71601,80375,3219,34155,1250,482,88302,51327
6,59444,659444,Rancho Cordova city, California,0,2018,74590,38.9,76.7,16.1,37112,37478,44210,5874,11264,1398,171,58180,16410
8,43000,843000,Lakewood city, Colorado,1,2018,156779,42.6,83.3,17,75727,81052,135426,2274,6542,1814,37,120124,36655
9,73000,973000,Stamford city, Connecticut,1,2018,129770,42.7,80.5,16.3,63579,66191,86198,13150,11995,413,0,95418,34352
22,70000,2270000,Shreveport city, Louisiana,1,2018,189149,40.2,76.1,17,88563,100586,72375,106532,3669,1109,140,185005,4144
41,23850,4123850,Eugene city, Oregon,1,2018,171259,48.5,82.4,15.3,81611,89648,139521,1418,8088,1551,981,154338,16921
12,70600,1270600,Tallahassee city, Florida,1,2018,193550,56.6,82.2,9.9,91252,102298,107239,68967,9819,523,97,180094,13456
17,24582,1724582,Evanston city, Illinois,1,2018,74110,41,78.5,15.8,34419,39691,49612,12002,7090,0,0,65103,9007
17,51622,1751622,Naperville city, Illinois,1,2018,147823,38.3,74.6,11.6,73587,74236,107198,6571,27826,196,68,137323,10500
18,23278,1823278,Fishers city, Indiana,1,2018,93790,39.6,70.8,10.1,44528,49262,78320,5469,6334,0,175,90137,3653
24,67675,2467675,Rockville city, Maryland,0,2018,68252,43,80.1,16.8,32712,35540,34685,6759,15905,106,0,57817,10435
49,43660,4943660,Layton city, Utah,1,2018,77306,43.7,70.1,10,39318,37988,67952,2026,1760,285,333,68909,8397
6,36546,636546,Inglewood city, California,1,2018,109427,41.3,73.9,11.3,52610,56817,29676,42425,3786,1482,746,54035,55392
18,36003,1836003,Indianapolis city (balance), Indiana,1,2018,864131,43,75.5,12.5,415501,448630,511051,254710,32312,1966,534,776109,88022
72,76770,7276770,San Juan zona urbana, Puerto Rico,0,2018,309990,37.1,82.5,22.8,141243,168747,197005,42908,1040,1089,183,5599,304391
6,69112,669112,Santa Cruz city, California,0,2018,64729,57.9,84.8,13,30113,34616,43908,2194,7276,129,119,50057,14672
12,54200,1254200,Palm Coast city, Florida,1,2018,87617,30.3,82,30.3,42263,45354,70632,8980,2575,0,0,77423,10194
12,71625,1271625,The Villages CDP, Florida,0,2018,-998,-999999999,-999999999,-999999999,-998,-998,-998,-998,-998,-998,-998,79654,922
26,74900,2674900,Southfield city, Michigan,1,2018,73141,34.8,80.9,23,30925,42216,17524,51422,1774,43,0,71919,1222
27,17288,2717288,Eagan city, Minnesota,0,2018,66539,42,75,12.5,31748,34791,53160,6020,4349,33,66,63076,3463
48,43888,4843888,Longview city, Texas,1,2018,81424,41,75.1,15.3,38799,42625,57469,20209,1419,191,363,67704,13720
72,10334,7210334,Caguas zona urbana, Puerto Rico,0,2018,72704,39.8,83,20.8,32947,39757,-998,-998,-998,-998,-998,1062,71642
6,64224,664224,Salinas city, California,1,2018,156275,45.2,68.7,9.2,78708,77567,48158,1250,9127,1926,44,29179,127096
6,84200,684200,West Covina city, California,1,2018,106314,38.3,78.5,16.6,48990,57324,39547,4262,35233,952,1297,55128,51186
35,63460,3563460,Rio Rancho city, New Mexico,1,2018,98016,37.2,75,16.9,47039,50977,83864,3260,1719,922,1007,55793,42223
35,70500,3570500,Santa Fe city, New Mexico,1,2018,84605,37.2,81.9,23.9,40125,44480,75308,932,885,1053,102,36763,47842
46,59020,4659020,Sioux Falls city, South Dakota,1,2018,181906,42.4,74.7,11.8,90739,91167,150917,13514,5886,4027,0,172276,9630
48,46452,4846452,Mansfield city, Texas,0,2018,74786,42.5,70.4,8.7,37380,37406,52084,12077,2726,562,0,55293,19493
51,16000,5116000,Chesapeake city, Virginia,1,2018,242634,40.7,76,13.2,118384,124250,146670,72849,9053,212,128,226788,15846
51,68000,5168000,Roanoke city, Virginia,1,2018,99920,40,77.8,16.9,47479,52441,61938,29378,3048,162,0,93382,6538
9,18430,918430,Danbury city, Connecticut,1,2018,84731,42.1,77,11.9,41747,42984,47412,10766,3554,569,0,55319,29412
37,2140,3702140,Asheville city, North Carolina,1,2018,92460,42.3,83.1,19.6,41478,50982,76036,11816,1234,165,365,84781,7679
48,65000,4865000,San Antonio city, Texas,1,2018,1532212,44.6,75.2,12.4,760783,771429,1251454,101551,51302,11822,722,551467,980745
4,73000,473000,Tempe city, Arizona,1,2018,192354,58.6,85.2,10.5,101778,90576,132142,12650,17061,6282,1034,151118,41236
5,41000,541000,Little Rock city, Arkansas,1,2018,197868,42.3,77.8,14.1,93999,103869,97114,84329,6262,1333,145,181581,16287
17,68003,1768003,Schaumburg village, Illinois,1,2018,73970,42.2,74.2,13.5,35441,38529,44204,4283,18053,1841,0,65881,8089
30,50200,3050200,Missoula city, Montana,1,2018,74427,53.1,82,12.8,37815,36612,67317,542,980,756,515,71301,3126
6,42202,642202,Lodi city, California,0,2018,66995,38.4,72.8,15.1,32833,34162,38623,871,9103,172,882,40580,26415
6,49670,649670,Mountain View city, California,1,2018,83377,48.8,79.4,10.9,43677,39700,43750,1534,27683,383,0,67967,15410
6,84550,684550,Westminster city, California,1,2018,90931,35.3,78.2,19.4,43400,47531,26624,582,51958,194,139,70827,20104
44,54640,4454640,Pawtucket city, Rhode Island,1,2018,71842,37.8,80.9,14,35759,36083,42956,15041,788,87,37,53598,18244
53,35275,5335275,Kennewick city, Washington,1,2018,82950,40.8,73.8,13.7,42393,40557,67077,2102,3492,260,0,62280,20670
4,27400,427400,Gilbert town, Arizona,1,2018,248269,40.1,69.5,10.3,120840,127429,202179,13494,15120,1156,565,207129,41140
6,80000,680000,Torrance city, California,1,2018,145181,35.3,79.2,17.9,69026,76155,67929,3488,51799,956,348,116287,28894
13,4000,1304000,Atlanta city, Georgia,1,2018,498073,51.7,81.5,11.1,245352,252721,203515,253770,20019,818,142,475094,22979
37,10740,3710740,Cary town, North Carolina,1,2018,169537,38.2,76,13.2,82221,87316,110277,18571,32063,308,283,158220,11317
47,48000,4748000,Memphis city, Tennessee,1,2018,650632,41.5,75.1,13.1,304415,346217,183694,428009,9788,951,74,605793,44839
53,35940,5335940,Kirkland city, Washington,0,2018,89557,46.8,77.7,10.5,44332,45225,68636,579,12458,488,0,82570,6987
19,82425,1982425,Waterloo city, Iowa,1,2018,67797,41.5,78.6,17.7,33990,33807,51040,12473,1088,572,79,62840,4957
6,15044,615044,Compton city, California,1,2018,96616,43.3,67.7,9.4,45567,51049,24168,28974,611,203,108,31257,65359
39,1000,3901000,Akron city, Ohio,1,2018,198025,41.5,79.1,15,96018,102007,120141,56646,9909,318,0,192718,5307
48,41980,4841980,League City city, Texas,1,2018,106188,38.1,71.6,11.2,52201,53987,82426,11532,6445,145,0,85756,20432
6,65000,665000,San Bernardino city, California,1,2018,215929,44.4,70,9,106951,108978,143789,25408,9055,1493,2057,72170,143759
17,79293,1779293,Waukegan city, Illinois,1,2018,82934,43.7,72.1,9.2,41017,41917,32526,14242,4832,1211,0,36056,46878
32,68585,3268585,Spring Valley CDP, Nevada,0,2018,214161,43.3,79.5,13.9,108590,105571,103519,30283,36890,491,914,161456,52705
48,19000,4819000,Dallas city, Texas,1,2018,1345076,46.1,75.3,10.7,669867,675209,836340,338036,45979,4163,412,797335,547741
49,62470,4962470,Provo city, Utah,1,2018,116713,66,78.4,6.1,56949,59764,99646,1813,2667,1272,2721,97482,19231
48,26232,4826232,Flower Mound town, Texas,0,2018,77038,33.9,72.8,10.1,39409,37629,61230,2670,8326,514,0,66960,10078
5,60410,560410,Rogers city, Arkansas,0,2018,67615,42.6,73.5,9.7,33165,34450,61114,1272,1173,307,1005,43086,24529
12,76582,1276582,Weston city, Florida,0,2018,71224,34.3,65.9,9.8,35375,35849,55727,2139,3479,0,0,31700,39524
48,6128,4806128,Baytown city, Texas,1,2018,77962,42.3,73.1,12.7,39055,38907,53662,18877,991,24,95,41919,36043
48,22660,4822660,Edinburg city, Texas,1,2018,98671,49.1,70.8,9,51419,47252,89296,2592,2151,283,0,12399,86272
8,16000,816000,Colorado Springs city, Colorado,1,2018,472666,43.7,76.3,13.3,235360,237306,363389,32160,16843,3788,1208,385582,87084
35,39380,3539380,Las Cruces city, New Mexico,1,2018,102929,45.1,79.5,17.2,50717,52212,89314,3198,1238,1667,0,40110,62819
42,24000,4224000,Erie city, Pennsylvania,1,2018,96459,43,78.4,16.1,49669,46790,70941,16524,1928,696,63,89508,6951
34,74000,3474000,Trenton city, New Jersey,1,2018,83973,44.2,75.7,11.4,39469,44504,30852,39931,1381,612,0,50378,33595
53,67167,5367167,Spokane Valley city, Washington,1,2018,99703,42.4,75.3,15.1,48907,50796,87570,2112,1431,1840,157,93583,6120
36,51000,3651000,New York city, New York,1,2018,8398748,43.2,79.3,14.8,4003933,4394815,3548402,2039194,1192303,38946,5250,5949297,2449451
12,49675,1249675,North Port city, Florida,0,2018,68637,31.5,83.9,30.3,32282,36355,-998,-998,-998,-998,-998,64890,3747
24,72450,2472450,Silver Spring CDP, Maryland,0,2018,81816,47.1,78,13.2,39839,41977,33608,25670,8515,0,0,66489,15327
55,60500,5560500,Oshkosh city, Wisconsin,0,2018,66737,47.9,82.5,13.6,34639,32098,60144,2653,2174,311,0,63556,3181
6,46898,646898,Merced city, California,1,2018,83311,45.7,72.5,11.9,40153,43158,53730,4327,10565,561,0,37565,45746
12,53000,1253000,Orlando city, Florida,1,2018,285705,49.8,80.1,10.9,132334,153371,167127,74899,10297,377,145,195017,90688
20,71000,2071000,Topeka city, Kansas,1,2018,125908,39,77.6,19.2,61231,64677,99263,13465,2518,2051,73,106558,19350
36,65508,3665508,Schenectady city, New York,1,2018,65570,43.8,79.4,14.2,33471,32099,36975,12993,4822,1373,220,58791,6779
49,82950,4982950,West Jordan city, Utah,1,2018,116047,46.3,67.7,7.8,57756,58291,90596,2930,5094,1652,2069,98314,17733
6,68084,668084,San Leandro city, California,1,2018,89683,39.4,81.5,15,44555,45128,35388,9507,30188,282,750,63660,26023
48,10912,4810912,Bryan city, Texas,1,2018,85447,48.1,74,9.9,43606,41841,64169,16602,2589,65,0,52121,33326
55,2375,5502375,Appleton city, Wisconsin,1,2018,74345,40,75.7,15,36008,38337,63806,3222,3947,190,0,71078,3267
1,37000,137000,Huntsville city, Alabama,1,2018,199808,42.1,78.5,16.7,95202,104606,114924,62225,6221,1300,0,186411,13397
6,36000,636000,Huntington Beach city, California,1,2018,200658,37.5,80.1,16.5,100382,100276,137202,2645,27359,719,1199,160510,40148
6,58072,658072,Pomona city, California,1,2018,152348,45.7,73.9,11.1,72447,79901,65570,7598,16306,3112,104,43770,108578
12,8150,1208150,Brandon CDP, Florida,0,2018,119778,43.6,79.1,13.2,58602,61176,82700,19764,8322,398,0,91945,27833
12,45060,1245060,Miami Gardens city, Florida,1,2018,113085,40.9,75.1,14.6,50021,63064,24466,84497,705,0,0,85515,27570
29,54074,2954074,O'Fallon city, Missouri,1,2018,88464,39.5,72.2,10.8,44258,44206,76867,3956,4445,171,0,85388,3076
39,12000,3912000,Canton city, Ohio,1,2018,70469,37.8,73.3,15.4,35741,34728,45439,18211,727,0,0,65915,4554
41,5350,4105350,Beaverton city, Oregon,1,2018,98951,46.5,76.5,10.9,50742,48209,71204,2447,14083,96,518,74758,24193
45,48535,4548535,Mount Pleasant town, South Carolina,1,2018,89340,38.1,78,17.6,46120,43220,-998,-998,-998,-998,-998,86122,3218
6,57456,657456,Pittsburg city, California,0,2018,72443,44.9,74,9.7,34819,37624,26872,12634,12049,1203,69,40799,31644
6,81666,681666,Vallejo city, California,1,2018,121915,39.5,79.7,16.2,59464,62451,40188,24309,31487,540,734,86577,35338
32,60600,3260600,Reno city, Nevada,1,2018,250989,42.8,79.7,15.8,125566,125423,186614,8327,14851,2901,1962,191164,59825
34,21000,3421000,Elizabeth city, New Jersey,1,2018,128882,44.5,72.3,9.9,64901,63981,49482,19331,4069,2502,0,38392,90490
37,22920,3722920,Fayetteville city, North Carolina,1,2018,209465,48.8,76.9,12.2,104484,104981,91410,89964,7061,2502,883,183991,25474
48,61796,4861796,Richardson city, Texas,1,2018,120954,44.8,77.9,13.7,60765,60189,80130,12017,19932,1234,104,98333,22621
1,21184,121184,Dothan city, Alabama,0,2018,67814,37.1,77.3,19.6,32283,35531,43412,22262,603,53,0,65083,2731
1,77256,177256,Tuscaloosa city, Alabama,1,2018,101111,52.8,81.8,12.3,47889,53222,54470,42341,2710,300,0,96502,4609
18,40788,1840788,Lafayette city, Indiana,1,2018,72393,45.1,77.9,13.8,36818,35575,60658,6223,1326,263,0,62625,9768
26,21000,2621000,Dearborn city, Michigan,1,2018,94325,42.1,72.6,12.5,48569,45756,85224,2078,2646,530,0,91426,2899
6,59451,659451,Rancho Cucamonga city, California,1,2018,177742,41,76,12.6,88615,89127,100511,19284,19569,518,70,105863,71879
6,80238,680238,Tracy city, California,1,2018,91803,45,73,9,45691,46112,52652,4108,16552,547,344,54973,36830
18,25000,1825000,Fort Wayne city, Indiana,1,2018,264170,41.9,74.6,13.8,127645,136525,185587,41659,13661,574,432,239547,24623
32,40000,3240000,Las Vegas city, Nevada,1,2018,644664,39.5,76.2,15.2,321489,323175,379389,73470,47686,9803,4127,421804,222860
32,71400,3271400,Sunrise Manor CDP, Nevada,0,2018,188515,41.4,71.8,11.6,91456,97059,98399,25697,9229,2930,1111,89999,98516
48,3000,4803000,Amarillo city, Texas,1,2018,200880,40.6,72.5,13.1,97982,102898,166268,14161,9048,1455,443,135248,65632
55,31000,5531000,Green Bay city, Wisconsin,1,2018,104880,40.1,75.4,13.3,53576,51304,82731,4609,4859,3719,213,87635,17245
17,7133,1707133,Bolingbrook village, Illinois,1,2018,74224,42.7,74.5,11.3,36951,37273,38136,10582,6879,404,165,52552,21672
38,25700,3825700,Fargo city, North Dakota,1,2018,125040,51.1,81,12,63735,61305,104856,9867,5410,1840,0,121032,4008
6,49270,649270,Moreno Valley city, California,1,2018,209051,46.3,71.4,8.2,98921,110130,73698,36977,13973,303,37,81928,127123
37,25580,3725580,Gastonia city, North Carolina,1,2018,77021,39.3,78.6,15.1,37185,39836,47628,23211,1114,261,95,70682,6339
39,44856,3944856,Lorain city, Ohio,0,2018,64031,38.9,75.6,16.3,30275,33756,47150,10575,0,223,75,45440,18591
6,2553,602553,Arden-Arcade CDP, California,0,2018,107894,42.7,77.2,14,51383,56511,69433,9594,7135,881,404,83755,24139
6,19766,619766,Downey city, California,1,2018,112262,44.3,78,14,55320,56942,59139,4694,7592,1764,168,33025,79237
53,22640,5322640,Everett city, Washington,1,2018,111263,44.8,79.6,12.5,57830,53433,79337,6554,12037,562,1464,94180,17083
48,63572,4863572,Rowlett city, Texas,0,2018,66686,40.2,76,9.1,31321,35365,45034,12643,4678,573,0,50937,15749
6,20802,620802,East Los Angeles CDP, California,0,2018,117961,45.7,75.5,11.3,58810,59151,57395,1254,1756,299,95,6046,111915
6,21712,621712,El Cajon city, California,1,2018,103229,45.4,74.7,12.1,51339,51890,78246,5939,4967,502,437,79372,23857
9,52000,952000,New Haven city, Connecticut,1,2018,130407,49.9,76.1,9.2,60711,69696,57087,45759,6572,812,0,94983,35424
12,39925,1239925,Lehigh Acres CDP, Florida,0,2018,135272,40.8,72.5,11.9,65752,69520,97207,27830,942,177,71,70367,64905
12,54350,1254350,Palm Harbor CDP, Florida,0,2018,65994,29.2,80.8,26.7,27769,38225,-998,-998,-998,-998,-998,62616,3378
17,57225,1757225,Palatine village, Illinois,1,2018,68017,37.6,74.5,13.8,32293,35724,45144,1976,8513,468,0,52951,15066
26,29000,2629000,Flint city, Michigan,1,2018,95932,41.2,76,13.7,45062,50870,37069,51902,157,378,66,92648,3284
42,6088,4206088,Bethlehem city, Pennsylvania,1,2018,75979,44,82.3,17.4,36509,39470,59225,4453,2905,0,0,51896,24083
72,14290,7214290,Carolina zona urbana, Puerto Rico,0,2018,133734,37.9,82.4,22.3,60475,73259,74813,19435,505,0,0,1013,132721
6,16000,616000,Concord city, California,1,2018,129681,41.5,83,15.6,62538,67143,80258,4753,14189,1383,156,89941,39740
6,50258,650258,Napa city, California,1,2018,79261,38.5,77.1,18.4,39869,39392,65866,588,2069,813,0,48425,30836
8,32155,832155,Greeley city, Colorado,1,2018,107345,45.6,74.2,10.8,51928,55417,94570,3529,1121,652,1030,70982,36363
12,35000,1235000,Jacksonville city, Florida,1,2018,903896,41.7,77,13.7,436155,467741,524891,277151,43394,3195,409,809738,94158
36,63000,3663000,Rochester city, New York,1,2018,206290,47.5,77.8,11.4,99175,107115,97371,79508,6416,2080,0,163929,42361
53,74060,5374060,Vancouver city, Washington,1,2018,183017,41.2,78.6,16.5,89428,93589,148545,3844,9832,847,2141,155506,27511
40,23200,4023200,Edmond city, Oklahoma,1,2018,93118,39,73.2,15.5,44138,48980,74600,5153,1785,1321,112,87598,5520
48,16432,4816432,Conroe city, Texas,0,2018,87656,46.4,76.1,12.8,45219,42437,68188,7410,4572,1133,0,58422,29234
46,52980,4652980,Rapid City city, South Dakota,1,2018,75448,40.1,76.3,17.8,38313,37135,58778,1133,1134,9638,39,70831,4617
12,12875,1212875,Clearwater city, Florida,1,2018,116484,34.5,81.1,22.7,57933,58551,88067,16964,2815,151,106,98241,18243
13,67284,1367284,Roswell city, Georgia,1,2018,94648,37.9,77.1,13.6,45594,49054,74797,13040,3190,426,0,80716,13932
19,83910,1983910,West Des Moines city, Iowa,0,2018,67127,41.9,76.9,14.7,34276,32851,56848,4691,3636,127,262,62096,5031
42,63624,4263624,Reading city, Pennsylvania,1,2018,88508,44.7,69.4,10.4,42013,46495,48397,11654,1259,149,0,28703,59805
44,74300,4474300,Warwick city, Rhode Island,1,2018,80842,38.3,82.6,20,38465,42377,74267,1864,2305,537,0,74973,5869
45,16000,4516000,Columbia city, South Carolina,1,2018,133610,57.4,83.5,9.8,66107,67503,68936,55176,2961,358,294,127055,6555
48,75428,4875428,Victoria city, Texas,0,2018,67020,40.4,75.2,16.6,31904,35116,55922,5379,1285,167,0,30448,36572
49,57300,4957300,Orem city, Utah,1,2018,97512,50.3,71.1,9.5,48219,49293,87548,434,2148,127,817,80130,17382
6,22020,622020,Elk Grove city, California,1,2018,172891,39.9,75.9,13.7,83600,89291,81436,20348,48180,1968,3844,141532,31359
40,41850,4041850,Lawton city, Oklahoma,1,2018,92860,46.3,77.3,12.5,48673,44187,53723,16675,2123,3129,913,79153,13707
6,56000,656000,Pasadena city, California,1,2018,141374,42.2,80.4,16.8,66775,74599,63624,12787,27190,372,150,90282,51092
26,84000,2684000,Warren city, Michigan,1,2018,134583,40.1,81.7,16.9,64622,69961,95906,23501,10897,151,59,130814,3769
41,5800,4105800,Bend city, Oregon,1,2018,97590,40,75.3,16.8,47229,50361,87959,695,2245,524,0,88815,8775
47,14000,4714000,Chattanooga city, Tennessee,1,2018,180551,42.4,81.4,16.9,84488,96063,112989,56502,3738,297,0,168416,12135
40,55000,4055000,Oklahoma City city, Oklahoma,1,2018,649410,42.5,74.2,12.8,318760,330650,437976,90992,33390,20575,599,521555,127855
6,33434,633434,Hesperia city, California,1,2018,95267,40.3,71.6,12.5,47162,48105,76781,3688,2440,1164,104,36004,59263
6,81344,681344,Upland city, California,1,2018,77002,42.5,76.8,15,37240,39762,47323,4186,10525,1404,95,47070,29932
53,63000,5363000,Seattle city, Washington,1,2018,744949,52.1,85,13.1,380030,364919,498504,50578,115719,4023,1388,690934,54015
11,50000,1150000,Washington city, District of Columbia,1,2018,702455,51.2,81.9,12.2,334208,368247,296747,319777,27538,1932,397,623206,79249
51,3000,5103000,Arlington CDP, Virginia,0,2018,237521,51.8,81.9,10.5,119798,117723,165900,21345,23125,1341,717,200015,37506
1,51000,151000,Montgomery city, Alabama,1,2018,198218,41.7,76.1,14.1,93079,105139,60070,123862,6702,245,0,190828,7390
18,51876,1851876,Muncie city, Indiana,1,2018,70178,52.5,79.9,14.5,32873,37305,59161,7727,1330,78,0,67797,2381
36,1000,3601000,Albany city, New York,1,2018,97273,49.8,82.5,13.7,46974,50299,52823,31454,5923,0,0,88931,8342
48,32372,4832372,Harlingen city, Texas,0,2018,65434,41.9,72.1,16.4,32581,32853,-998,-998,-998,-998,-998,11181,54253
5,66080,566080,Springdale city, Arkansas,1,2018,81641,41.9,70,10.3,39365,42276,51853,2545,1817,1527,5288,51498,30143
6,68000,668000,San Jose city, California,1,2018,1030119,43.2,77.9,13,515713,514406,411976,30835,369178,5762,5545,696300,333819
51,82000,5182000,Virginia Beach city, Virginia,1,2018,450189,42.6,77.9,14.2,221277,228912,296395,86768,32129,1861,143,412824,37365
6,80812,680812,Turlock city, California,1,2018,73490,44.5,71.9,13.1,35752,37738,53698,4318,3607,74,521,45384,28106
8,3455,803455,Arvada city, Colorado,1,2018,120127,39.1,81.2,18.8,59816,60311,110226,1393,2447,569,0,105614,14513
12,57900,1257900,Poinciana CDP, Florida,0,2018,71331,36.6,68.8,15.9,36271,35060,48010,14208,418,0,0,25902,45429
25,45560,2545560,Newton city, Massachusetts,1,2018,88911,37,78.3,20.1,41714,47197,68232,3741,12890,83,0,86530,2381
6,26000,626000,Fremont city, California,1,2018,237815,40.7,77.5,12.8,121872,115943,56593,8492,139437,1236,2302,208468,29347
6,40130,640130,Lancaster city, California,1,2018,159038,41.1,69.1,10,82449,76589,94937,32316,6343,1615,162,89615,69423
9,37000,937000,Hartford city, Connecticut,1,2018,122591,45.8,75.1,11.5,59277,63314,35129,46635,2868,974,404,66890,55701
32,54600,3254600,Paradise CDP, Nevada,0,2018,242266,44.8,81.8,13.8,124081,118185,116955,30514,25388,2727,1708,156529,85737
29,64082,2964082,St. Charles city, Missouri,0,2018,70770,41.8,83,16.7,35137,35633,60952,5211,2065,202,0,67915,2855
8,9280,809280,Broomfield city, Colorado,0,2018,69267,41.9,77.1,13.9,34710,34557,60869,1103,4951,196,0,60537,8730