FIPS_STATE,FIPS_PLACE,FIPS_STATE_PLACE,CITY_NAME,ST_NAME,NYU_500_LARGEST,YEAR,POP_TOTAL,PER_AGE_15TO44,PER_AGE_18PLUS,PER_AGE_65PLUS,POP_MALE,POP_FEMALE,POP_WHITE,POP_BLACK,POP_ASIAN,POP_AIAN,POP_NHOPI,POP_NONHISPANIC,POP_HISPANIC
01,07000,0107000,Birmingham city, Alabama,1,2010,211670,42.80,78.70,13.10,98760,112910,47657,158193,1528,593,0,204155,7515
01,21184,0121184,Dothan city, Alabama,0,2010,66121,38.70,74.80,14.30,31087,35034,41867,21123,916,186,0,64104,2017
01,35896,0135896,Hoover city, Alabama,1,2010,80376,39.70,71.30,12.40,38694,41682,57507,11555,5345,235,0,72254,8122
01,37000,0137000,Huntsville city, Alabama,1,2010,181126,42.50,78.40,13.50,88132,92994,114796,53460,5734,434,161,170562,10564
01,50000,0150000,Mobile city, Alabama,1,2010,195249,40.50,76.70,13.90,91746,103503,89418,98746,2621,474,53,190257,4992
01,51000,0151000,Montgomery city, Alabama,1,2010,206655,43.50,75.30,11.80,97605,109050,78817,115853,4368,571,90,198566,8089
01,77256,0177256,Tuscaloosa city, Alabama,1,2010,90637,50.70,79.90,11.00,43997,46640,48895,38870,861,0,0,86642,3995
02,03000,0203000,Anchorage municipality, Alaska,1,2010,293227,44.60,74.10,7.00,148566,144661,195553,17874,23986,21787,6388,270925,22302
04,04720,0404720,Avondale city, Arizona,1,2010,76446,45.60,66.50,4.60,39206,37240,59236,6888,1557,1039,189,32456,43990
04,12000,0412000,Chandler city, Arizona,1,2010,236775,44.00,72.30,7.20,116459,120316,181872,12980,24702,1834,384,180028,56747
04,23620,0423620,Flagstaff city, Arizona,0,2010,65976,58.10,80.00,7.60,31783,34193,47043,1248,1731,8413,51,54703,11273
04,27400,0427400,Gilbert town, Arizona,1,2010,209007,43.90,70.00,5.80,103460,105547,173989,11926,10597,2577,205,180642,28365
04,27820,0427820,Glendale city, Arizona,1,2010,227358,44.40,71.80,8.60,112794,114564,160175,15327,8313,4836,697,141901,85457
04,28380,0428380,Goodyear city, Arizona,0,2010,65445,46.30,72.50,9.90,31194,34251,57568,2244,904,2116,0,43326,22119
04,46000,0446000,Mesa city, Arizona,1,2010,440248,40.40,74.50,14.70,214522,225726,369684,13168,10333,11202,1308,324773,115475
04,54050,0454050,Peoria city, Arizona,1,2010,154475,40.30,74.60,14.10,73403,81072,133143,5866,6887,1422,56,122187,32288
04,55000,0455000,Phoenix city, Arizona,1,2010,1449481,45.00,72.20,8.70,731869,717612,1128609,100335,42050,24637,2515,877736,571745
04,64210,0464210,San Tan Valley CDP, Arizona,0,2010,74977,44.40,60.70,6.10,36003,38974,49889,3298,2977,2077,1237,52826,22151
04,65000,0465000,Scottsdale city, Arizona,1,2010,217977,33.50,82.60,19.80,104832,113145,200918,4118,5771,1397,169,202249,15728
04,71510,0471510,Surprise city, Arizona,1,2010,117826,37.00,70.20,18.10,57572,60254,106563,3721,786,795,0,97971,19855
04,73000,0473000,Tempe city, Arizona,1,2010,162123,56.80,80.70,9.90,83327,78796,127359,8114,9884,4731,1987,127900,34223
04,77000,0477000,Tucson city, Arizona,1,2010,521132,45.60,77.30,12.00,258275,262857,406502,24883,12609,16563,1026,309756,211376
04,85540,0485540,Yuma city, Arizona,1,2010,93409,45.10,70.20,10.50,46307,47102,60535,2827,1616,845,107,40308,53101
05,23290,0523290,Fayetteville city, Arkansas,1,2010,73946,57.60,81.30,9.90,35991,37955,63496,4865,1361,1111,0,69737,4209
05,24550,0524550,Fort Smith city, Arkansas,1,2010,86338,41.90,74.90,12.00,42421,43917,68833,8336,4413,452,0,72034,14304
05,35710,0535710,Jonesboro city, Arkansas,1,2010,67486,48.70,74.30,10.30,33384,34102,-998,-998,-998,-998,-998,63847,3639
05,41000,0541000,Little Rock city, Arkansas,1,2010,193973,41.60,73.50,11.30,91274,102699,102579,83780,5377,745,50,183124,10849
05,66080,0566080,Springdale city, Arkansas,1,2010,70751,44.60,66.10,7.70,33760,36991,47566,2264,938,277,3734,47872,22879
06,00562,0600562,Alameda city, California,1,2010,73981,40.70,75.90,11.60,34930,39051,34074,6738,24442,267,999,64946,9035
06,00884,0600884,Alhambra city, California,1,2010,83202,45.60,83.50,16.10,38154,45048,21262,972,43049,45,0,53545,29657
06,02000,0602000,Anaheim city, California,1,2010,337259,46.00,73.60,9.40,171859,165400,195457,9062,46131,1122,886,155244,182015
06,02252,0602252,Antioch city, California,1,2010,102745,41.70,73.00,9.80,49453,53292,52584,13027,12011,856,1962,61143,41602
06,02364,0602364,Apple Valley town, California,1,2010,69387,36.00,72.00,14.90,32930,36457,57326,5677,1642,72,0,48517,20870
06,02553,0602553,Arden-Arcade CDP, California,0,2010,87272,42.90,79.90,15.20,40372,46900,62644,7495,5002,1018,432,67522,19750
06,03526,0603526,Bakersfield city, California,1,2010,348582,43.40,68.30,8.70,173473,175109,227269,28173,19603,3005,162,186631,161951
06,03666,0603666,Baldwin Park city, California,1,2010,75496,43.60,68.40,8.60,35872,39624,26445,1106,11720,800,0,14476,61020
06,04982,0604982,Bellflower city, California,1,2010,76717,44.20,73.80,10.40,35921,40796,28663,11667,8193,685,0,38669,38048
06,06000,0606000,Berkeley city, California,1,2010,112824,55.00,86.90,12.10,53328,59496,69208,12520,23378,123,162,100839,11985
06,08786,0608786,Buena Park city, California,1,2010,80766,42.50,74.40,10.30,37841,42925,45296,3090,24593,179,1844,50095,30671
06,08954,0608954,Burbank city, California,1,2010,103472,42.30,81.00,14.50,48500,54972,79813,1402,14119,45,0,81873,21599
06,10046,0610046,Camarillo city, California,0,2010,65406,31.50,77.10,21.60,29023,36383,47381,1112,8803,486,53,49677,15729
06,11194,0611194,Carlsbad city, California,1,2010,105707,39.70,77.70,11.50,53138,52569,91926,1273,6505,71,81,94188,11519
06,11530,0611530,Carson city, California,1,2010,91828,41.30,76.80,12.30,45492,46336,27324,18854,26705,685,2783,58656,33172
06,13014,0613014,Chico city, California,1,2010,86213,51.50,82.60,10.50,41857,44356,70317,2218,4576,1251,113,72373,13840
06,13210,0613210,Chino city, California,1,2010,78237,49.00,73.30,6.80,40030,38207,46160,4675,8643,554,244,33284,44953
06,13214,0613214,Chino Hills city, California,1,2010,75070,41.10,74.40,7.20,35798,39272,38186,2559,21633,186,112,47363,27707
06,13392,0613392,Chula Vista city, California,1,2010,244789,43.10,72.00,10.10,115293,129496,160287,13237,39342,1317,180,109018,135771
06,13588,0613588,Citrus Heights city, California,1,2010,83490,42.30,78.10,13.30,40704,42786,69968,1557,1318,739,45,68089,15401
06,14218,0614218,Clovis city, California,1,2010,95915,42.50,72.10,12.20,48070,47845,67689,4200,7737,2349,53,70572,25343
06,15044,0615044,Compton city, California,1,2010,96558,46.10,68.10,6.60,46880,49678,45389,33840,144,352,0,35549,61009
06,16000,0616000,Concord city, California,1,2010,122508,42.10,77.40,11.80,58950,63558,87092,5132,13221,773,1024,90511,31997
06,16350,0616350,Corona city, California,1,2010,153335,44.30,70.70,7.60,77726,75609,109403,6207,14952,1160,2736,89151,64184
06,16532,0616532,Costa Mesa city, California,1,2010,110253,50.80,78.60,8.50,56717,53536,71905,1223,8931,620,252,66662,43591
06,17918,0617918,Daly City city, California,1,2010,101361,43.50,78.30,11.70,49447,51914,27862,2862,57504,237,137,76768,24593
06,18100,0618100,Davis city, California,0,2010,65740,54.30,78.60,8.80,32556,33184,43957,1396,13409,57,392,57790,7950
06,19766,0619766,Downey city, California,1,2010,111922,44.70,73.70,10.10,56251,55671,48458,3782,7344,522,95,29383,82539
06,20802,0620802,East Los Angeles CDP, California,0,2010,127198,49.30,70.30,7.70,66095,61103,65495,592,828,861,121,3190,124008
06,21712,0621712,El Cajon city, California,1,2010,99841,44.80,72.10,9.80,49497,50344,73778,6502,4333,1030,184,70350,29491
06,22020,0622020,Elk Grove city, California,1,2010,153401,40.40,70.40,8.90,75206,78195,68196,15492,39696,766,4995,124091,29310
06,22230,0622230,El Monte city, California,1,2010,113614,45.00,74.70,11.40,55826,57788,42040,516,30841,1091,309,40612,73002
06,22804,0622804,Escondido city, California,1,2010,144402,43.60,74.70,15.20,69294,75108,124845,2746,4041,713,127,78060,66342
06,23182,0623182,Fairfield city, California,1,2010,105580,42.10,72.10,9.80,50417,55163,48600,16947,16620,686,926,77836,27744
06,24638,0624638,Folsom city, California,1,2010,72348,44.00,76.70,8.90,40490,31858,49590,6119,10103,819,1189,64218,8130
06,24680,0624680,Fontana city, California,1,2010,196778,46.60,69.20,6.40,97566,99212,118496,24506,11995,1058,960,74594,122184
06,26000,0626000,Fremont city, California,1,2010,214613,42.10,75.90,10.00,106745,107868,73507,10342,100448,513,1060,181072,33541
06,27000,0627000,Fresno city, California,1,2010,496147,45.10,69.30,9.00,242478,253669,266945,37239,65354,3676,1113,264057,232090
06,28000,0628000,Fullerton city, California,1,2010,135541,45.00,75.90,11.90,65943,69598,71470,3335,31413,1002,93,85487,50054
06,29000,0629000,Garden Grove city, California,1,2010,171386,46.20,75.70,11.40,86320,85066,76555,1659,68161,1044,2816,113134,58252
06,30000,0630000,Glendale city, California,1,2010,191954,40.30,78.60,13.70,93963,97991,147731,1589,29723,342,770,159506,32448
06,32548,0632548,Hawthorne city, California,1,2010,84382,46.40,71.30,8.50,41338,43044,45462,23286,4362,182,495,39370,45012
06,33000,0633000,Hayward city, California,1,2010,144549,44.90,74.30,9.20,71220,73329,52958,16618,31695,2019,2752,84898,59651
06,33182,0633182,Hemet city, California,1,2010,79157,35.40,71.00,20.60,38486,40671,59681,4875,2724,794,0,48268,30889
06,33434,0633434,Hesperia city, California,1,2010,90486,42.00,70.20,10.00,44418,46068,69120,6690,2876,1848,83,51745,38741
06,36000,0636000,Huntington Beach city, California,1,2010,190541,39.20,80.50,15.10,92967,97574,144668,1637,21949,1494,0,156045,34496
06,36448,0636448,Indio city, California,1,2010,76512,38.80,68.80,14.40,35697,40815,49162,1446,1546,403,0,23866,52646
06,36546,0636546,Inglewood city, California,1,2010,109799,45.60,74.10,9.40,50085,59714,26774,43423,1045,372,957,52398,57401
06,36770,0636770,Irvine city, California,1,2010,212982,52.10,79.50,8.50,105706,107276,111516,3603,82165,1161,905,192011,20971
06,39496,0639496,Lake Forest city, California,1,2010,77482,39.70,71.60,10.10,38373,39109,61680,1409,8862,476,81,59631,17851
06,39892,0639892,Lakewood city, California,1,2010,80154,39.20,75.40,11.90,39559,40595,38530,5776,12403,396,101,50546,29608
06,40130,0640130,Lancaster city, California,1,2010,156786,42.70,69.10,8.90,77100,79686,98660,35510,7645,1218,217,101194,55592
06,41992,0641992,Livermore city, California,1,2010,81178,40.10,76.00,9.80,40563,40615,67952,2003,6895,65,0,63926,17252
06,43000,0643000,Long Beach city, California,1,2010,462793,47.80,75.80,8.80,232262,230531,262737,55094,57230,2243,4515,266596,196197
06,44000,0644000,Los Angeles city, California,1,2010,3797144,47.30,76.70,10.40,1879472,1917672,1980767,362142,430314,15393,6700,1943870,1853274
06,44574,0644574,Lynwood city, California,1,2010,69863,52.70,70.80,5.30,33415,36448,-998,-998,-998,-998,-998,10161,59702
06,45484,0645484,Manteca city, California,1,2010,67338,39.80,69.00,9.10,33320,34018,48355,3899,7207,633,161,43396,23942
06,46842,0646842,Menifee city, California,1,2010,78018,34.50,73.80,21.80,38486,39532,60885,5397,1768,452,44,53979,24039
06,46898,0646898,Merced city, California,1,2010,79254,45.30,68.00,9.90,39374,39880,53841,4387,8966,1162,0,43118,36136
06,47766,0647766,Milpitas city, California,1,2010,67011,47.20,78.80,8.10,34025,32986,13664,1581,40716,222,527,55549,11462
06,48256,0648256,Mission Viejo city, California,1,2010,93585,34.70,78.20,15.20,44775,48810,76867,1320,8235,90,300,82447,11138
06,48354,0648354,Modesto city, California,1,2010,201520,41.30,71.20,11.60,97625,103895,149850,8471,10688,2873,1007,129341,72179
06,49270,0649270,Moreno Valley city, California,1,2010,194592,46.20,66.30,6.20,91437,103155,117462,34793,11337,576,92,92045,102547
06,49670,0649670,Mountain View city, California,1,2010,74320,51.50,80.30,11.90,37357,36963,44726,1598,17409,0,0,57028,17292
06,50076,0650076,Murrieta city, California,1,2010,104108,42.50,68.30,10.00,51932,52176,66455,5672,14934,416,0,74951,29157
06,50258,0650258,Napa city, California,1,2010,77122,39.70,74.90,13.70,38452,38670,67477,710,2153,283,124,47058,30064
06,51182,0651182,Newport Beach city, California,1,2010,85442,40.40,82.50,17.20,42800,42642,74039,338,5718,0,67,78610,6832
06,52526,0652526,Norwalk city, California,1,2010,105686,44.70,72.10,10.30,53913,51773,42466,5246,15417,1132,43,36154,69532
06,53000,0653000,Oakland city, California,1,2010,391672,45.70,78.30,11.80,193838,197834,154794,103160,67591,2276,2594,294157,97515
06,53322,0653322,Oceanside city, California,1,2010,167680,43.30,74.80,12.20,83495,84185,115759,8158,10061,737,2406,104085,63595
06,53896,0653896,Ontario city, California,1,2010,164517,48.20,70.90,7.10,85033,79484,105986,13786,5867,2218,62,53638,110879
06,53980,0653980,Orange city, California,1,2010,136803,43.90,73.10,10.30,70505,66298,80713,2578,19204,515,62,85329,51474
06,54652,0654652,Oxnard city, California,1,2010,198484,45.90,70.60,8.10,101336,97148,146630,6718,15123,2221,84,55913,142571
06,55156,0655156,Palmdale city, California,1,2010,152944,43.80,66.10,6.20,73000,79944,59585,24944,6668,1479,593,70819,82125
06,56000,0656000,Pasadena city, California,1,2010,137294,46.40,81.00,12.50,74071,63223,94967,14504,17551,660,88,88106,49188
06,56700,0656700,Perris city, California,1,2010,68816,49.10,63.20,3.90,32597,36219,26593,5280,1817,733,0,16047,52769
06,57456,0657456,Pittsburg city, California,0,2010,63510,46.70,74.00,8.80,28998,34512,28015,13409,9411,0,1299,36262,27248
06,57792,0657792,Pleasanton city, California,1,2010,70456,38.70,71.10,10.20,33753,36703,46184,2001,17455,431,152,60611,9845
06,58072,0658072,Pomona city, California,1,2010,149225,46.50,67.40,7.60,70394,78831,83119,13089,15275,1122,80,44285,104940
06,59451,0659451,Rancho Cucamonga city, California,1,2010,165858,44.60,73.10,6.90,81730,84128,107575,14826,19690,1085,207,110005,55853
06,59920,0659920,Redding city, California,1,2010,89901,38.10,75.80,15.30,45154,44747,77816,675,2098,2095,72,81514,8387
06,59962,0659962,Redlands city, California,1,2010,68994,44.80,76.20,12.70,33513,35481,50850,2237,5704,365,0,47610,21384
06,60018,0660018,Redondo Beach city, California,1,2010,66825,44.80,78.90,9.40,32750,34075,48883,2471,7016,335,60,54407,12418
06,60102,0660102,Redwood City city, California,1,2010,77013,40.90,74.50,11.30,38386,38627,57330,1239,8888,1294,670,46723,30290
06,60466,0660466,Rialto city, California,1,2010,99530,46.90,66.50,6.70,49278,50252,63556,14048,1310,1202,0,28484,71046
06,60620,0660620,Richmond city, California,1,2010,104059,42.40,75.80,9.10,50293,53766,45887,29779,16169,185,132,63618,40441
06,62000,0662000,Riverside city, California,1,2010,305707,47.40,73.30,8.70,154463,151244,212741,22318,19917,1544,1271,156286,149421
06,62938,0662938,Roseville city, California,1,2010,119335,42.50,72.90,12.80,58055,61280,95040,1685,10791,780,356,102644,16691
06,64000,0664000,Sacramento city, California,1,2010,467503,45.20,75.10,10.90,224397,243106,241396,63594,85081,5894,4374,343042,124461
06,64224,0664224,Salinas city, California,1,2010,151031,45.90,67.00,6.60,76414,74617,117645,2548,9180,1003,102,37619,113412
06,65000,0665000,San Bernardino city, California,1,2010,210670,43.00,67.60,9.10,105441,105229,96253,28085,8729,2905,1167,79053,131617
06,65042,0665042,San Buenaventura (Ventura) city, California,1,2010,106730,41.00,77.10,13.60,53612,53118,74518,1254,2832,435,260,68901,37829
06,66000,0666000,San Diego city, California,1,2010,1311886,48.50,78.00,10.50,667048,644838,841677,85226,209527,6235,7893,929831,382055
06,67000,0667000,San Francisco city, California,1,2010,805463,49.40,86.60,13.70,408065,397398,414524,49349,269050,3985,3465,683273,122190
06,68000,0668000,San Jose city, California,1,2010,949197,44.00,75.40,10.40,477347,471850,440493,32912,307151,6770,3305,630808,318389
06,68084,0668084,San Leandro city, California,1,2010,85159,40.20,79.60,13.20,41237,43922,34717,6624,31663,417,304,64103,21056
06,68196,0668196,San Marcos city, California,1,2010,84079,45.10,72.30,9.40,39850,44229,69325,1851,6806,264,384,54950,29129
06,68252,0668252,San Mateo city, California,1,2010,97461,42.10,81.20,15.20,47173,50288,61282,1447,18839,1053,1742,72466,24995
06,68378,0668378,San Ramon city, California,1,2010,72404,39.70,71.90,9.50,35497,36907,37268,1620,28976,194,109,65732,6672
06,69000,0669000,Santa Ana city, California,1,2010,325483,49.00,68.80,6.20,162897,162586,121403,6773,33490,1445,0,71584,253899
06,69070,0669070,Santa Barbara city, California,1,2010,88579,45.40,81.00,15.20,45380,43199,64286,1076,2781,443,0,52586,35993
06,69084,0669084,Santa Clara city, California,1,2010,116864,50.10,75.50,8.40,58532,58332,49834,2844,44385,629,96,93754,23110
06,69088,0669088,Santa Clarita city, California,1,2010,176535,41.80,73.90,9.70,90299,86236,130917,2785,17497,121,0,128050,48485
06,69196,0669196,Santa Maria city, California,1,2010,99747,47.50,70.80,8.20,51031,48716,81715,2621,5319,0,101,29338,70409
06,70000,0670000,Santa Monica city, California,1,2010,89861,44.10,85.30,14.90,43509,46352,67067,5722,9040,64,47,79783,10078
06,70098,0670098,Santa Rosa city, California,1,2010,168244,41.60,74.90,12.40,82024,86220,137165,5319,8680,2681,1002,120173,48071
06,72016,0672016,Simi Valley city, California,1,2010,124596,42.30,76.70,11.10,62389,62207,97871,1294,8957,999,624,94556,30040
06,73080,0673080,South Gate city, California,1,2010,94503,47.10,70.90,7.10,46602,47901,26286,832,1744,123,0,5178,89325
06,75000,0675000,Stockton city, California,1,2010,292747,43.50,71.20,10.60,143453,149294,142565,30495,61425,4912,1595,179313,113434
06,77000,0677000,Sunnyvale city, California,1,2010,140549,45.30,78.00,10.90,70278,70271,68209,2873,57089,260,1692,117329,23220
06,78120,0678120,Temecula city, California,1,2010,100751,44.80,68.10,6.70,49423,51328,69087,3754,9875,2984,0,75046,25705
06,78582,0678582,Thousand Oaks city, California,1,2010,127041,37.40,76.20,13.30,62556,64485,101759,1374,13609,187,0,108992,18049
06,80000,0680000,Torrance city, California,1,2010,145618,39.20,77.50,16.70,71698,73920,73992,5554,48543,355,289,123247,22371
06,80238,0680238,Tracy city, California,1,2010,83223,44.20,68.00,7.20,41177,42046,47758,4862,13678,251,1045,51532,31691
06,80812,0680812,Turlock city, California,1,2010,68663,47.40,77.90,11.40,33599,35064,52529,1949,6573,231,0,47038,21625
06,80854,0680854,Tustin city, California,1,2010,75769,46.80,70.80,8.20,37656,38113,45724,1257,15397,150,411,44637,31132
06,81204,0681204,Union City city, California,1,2010,69696,41.90,71.90,10.20,33981,35715,14062,5569,35618,110,789,55380,14316
06,81344,0681344,Upland city, California,1,2010,73991,43.10,75.30,13.30,33982,40009,45835,4557,6274,323,0,48257,25734
06,81554,0681554,Vacaville city, California,1,2010,92623,45.80,78.20,9.60,51452,41171,57777,10209,7438,627,845,69294,23329
06,81666,0681666,Vallejo city, California,1,2010,116217,40.70,76.60,13.10,55026,61191,44330,28562,25770,844,1014,89390,26827
06,82590,0682590,Victorville city, California,1,2010,116305,45.50,65.70,7.60,55829,60476,79217,13769,5343,252,66,57196,59109
06,82954,0682954,Visalia city, California,1,2010,124866,43.60,70.80,11.00,61861,63005,103377,2327,5961,2590,136,64894,59972
06,82996,0682996,Vista city, California,1,2010,94170,44.10,73.90,9.10,46219,47951,73937,2664,2958,514,40,47147,47023
06,84200,0684200,West Covina city, California,1,2010,106221,43.10,74.30,13.10,47114,59107,37801,7508,23266,0,0,45700,60521
06,84550,0684550,Westminster city, California,1,2010,89971,38.00,75.90,14.40,45410,44561,32704,881,44676,67,0,70812,19159
06,85292,0685292,Whittier city, California,1,2010,85433,43.20,75.80,11.50,41996,43437,47573,1078,1693,502,0,28752,56681
06,86832,0686832,Yorba Linda city, California,0,2010,64414,37.50,75.80,12.80,33313,31101,47771,635,13011,173,0,56188,8226
08,03455,0803455,Arvada city, Colorado,1,2010,107604,39.00,76.60,12.30,53683,53921,98026,593,1829,270,0,92994,14610
08,04000,0804000,Aurora city, Colorado,1,2010,326719,43.40,71.40,8.60,162428,164291,210602,49679,16677,5894,1042,227038,99681
08,07850,0807850,Boulder city, Colorado,1,2010,97585,58.60,85.10,9.60,48995,48590,84662,1234,4676,419,45,87411,10174
08,12815,0812815,Centennial city, Colorado,1,2010,100909,35.90,74.80,12.50,49673,51236,92163,814,3984,183,0,93265,7644
08,16000,0816000,Colorado Springs city, Colorado,1,2010,419586,42.10,75.10,10.60,203157,216429,335089,27873,10941,3032,631,350432,69154
08,20000,0820000,Denver city, Colorado,1,2010,604414,48.70,78.60,10.40,302514,301900,422070,60957,19267,7125,321,411321,193093
08,27425,0827425,Fort Collins city, Colorado,1,2010,144453,53.40,79.60,8.70,72680,71773,128138,2420,4841,445,114,130788,13665
08,32155,0832155,Greeley city, Colorado,1,2010,93389,46.00,74.70,8.80,45721,47668,82122,1659,2087,621,43,62148,31241
08,36410,0836410,Highlands Ranch CDP, Colorado,0,2010,95503,40.50,68.80,5.90,48177,47326,85662,1103,4793,485,0,88314,7189
08,43000,0843000,Lakewood city, Colorado,1,2010,143230,40.70,79.90,16.00,70848,72382,124503,4048,4535,2455,0,110392,32838
08,45970,0845970,Longmont city, Colorado,1,2010,86429,41.10,74.20,9.80,42666,43763,70755,709,2150,464,0,64873,21556
08,46465,0846465,Loveland city, Colorado,1,2010,67100,41.80,76.10,11.70,31679,35421,61780,65,389,255,402,57311,9789
08,62000,0862000,Pueblo city, Colorado,1,2010,106865,39.10,75.70,15.60,52828,54037,77725,1277,1200,3801,308,54248,52617
08,77290,0877290,Thornton city, Colorado,1,2010,119324,45.30,71.50,6.60,56958,62366,97419,3205,5510,674,223,84761,34563
08,83835,0883835,Westminster city, Colorado,1,2010,106518,42.80,74.90,9.10,51952,54566,87514,1404,5351,299,0,80400,26118
09,08000,0908000,Bridgeport city, Connecticut,1,2010,144521,46.10,73.70,9.90,69799,74722,69435,53211,6435,123,0,91034,53487
09,18430,0918430,Danbury city, Connecticut,1,2010,81043,45.20,78.40,11.10,37917,43126,54223,5936,4735,42,0,61420,19623
09,37000,0937000,Hartford city, Connecticut,1,2010,124847,47.20,73.40,10.10,58121,66726,37075,47591,3516,601,0,72265,52582
09,50370,0950370,New Britain city, Connecticut,1,2010,73247,46.60,76.60,13.20,35908,37339,44464,7862,2159,49,0,48019,25228
09,52000,0952000,New Haven city, Connecticut,1,2010,129849,53.40,77.30,7.90,62706,67143,60452,48133,6035,100,171,96141,33708
09,55990,0955990,Norwalk city, Connecticut,1,2010,85793,38.20,82.90,15.20,41237,44556,60740,14299,5429,81,172,75867,9926
09,73000,0973000,Stamford city, Connecticut,1,2010,122902,44.90,77.50,12.30,61647,61255,73527,16735,8343,256,0,88078,34824
09,80000,0980000,Waterbury city, Connecticut,1,2010,110430,42.50,75.40,12.60,53086,57344,61055,21489,2018,126,0,76800,33630
10,77580,1077580,Wilmington city, Delaware,1,2010,70921,43.20,75.70,11.70,33530,37391,28136,38957,396,451,0,63894,7027
11,50000,1150000,Washington city, District of Columbia,1,2010,604453,51.50,83.20,11.50,285729,318724,242905,309221,21552,1927,233,549197,55256
12,00410,1200410,Alafaya CDP, Florida,0,2010,84809,53.80,72.30,4.80,40185,44624,68848,6753,3570,0,250,53165,31644
12,07300,1207300,Boca Raton city, Florida,1,2010,84604,35.50,82.60,22.80,43320,41284,77329,3247,1051,197,0,74729,9875
12,07875,1207875,Boynton Beach city, Florida,1,2010,68380,36.30,84.30,24.80,31160,37220,-998,-998,-998,-998,-998,62124,6256
12,08150,1208150,Brandon CDP, Florida,0,2010,102939,45.20,77.70,8.40,50076,52863,76972,16183,4193,68,141,77274,25665
12,10275,1210275,Cape Coral city, Florida,1,2010,154668,35.90,76.70,17.00,77063,77605,140149,4151,2841,740,0,124029,30639
12,12875,1212875,Clearwater city, Florida,1,2010,107697,36.00,81.70,19.40,52354,55343,90612,11793,2409,0,0,95638,12059
12,14400,1214400,Coral Springs city, Florida,1,2010,121492,41.10,74.30,8.00,58402,63090,87194,23362,4295,1418,389,89885,31607
12,16475,1216475,Davie town, Florida,1,2010,92290,41.80,74.40,8.70,44217,48073,70951,9760,4794,213,191,65185,27105
12,16725,1216725,Deerfield Beach city, Florida,1,2010,75245,38.90,85.50,21.10,38228,37017,51143,21538,417,130,0,64516,10729
12,17200,1217200,Deltona city, Florida,1,2010,85183,39.50,75.00,13.10,40422,44761,60804,10493,792,99,0,61424,23759
12,24000,1224000,Fort Lauderdale city, Florida,1,2010,166039,39.80,82.30,15.80,88625,77414,105115,51859,1459,123,0,142832,23207
12,24125,1224125,Fort Myers city, Florida,0,2010,62429,40.20,74.20,15.20,29849,32580,33047,22202,1251,0,0,49049,13380
12,25175,1225175,Gainesville city, Florida,1,2010,124433,64.60,88.60,8.80,60651,63782,82202,29345,7607,408,0,111590,12843
12,30000,1230000,Hialeah city, Florida,1,2010,225461,40.80,82.40,18.70,106419,119042,212169,5332,236,173,0,7216,218245
12,32000,1232000,Hollywood city, Florida,1,2010,141202,38.40,79.50,15.20,68752,72450,101076,26642,3984,155,263,99811,41391
12,35000,1235000,Jacksonville city, Florida,1,2010,823316,43.10,76.20,10.90,399485,423831,499732,254742,33819,1859,252,759235,64081
12,36100,1236100,Kendall CDP, Florida,0,2010,82561,38.40,80.10,17.20,38981,43580,72791,2514,4276,283,0,31441,51120
12,38250,1238250,Lakeland city, Florida,1,2010,97530,38.50,77.80,20.80,47360,50170,71874,18930,2315,118,0,84014,13516
12,39425,1239425,Largo city, Florida,1,2010,77663,33.60,83.70,25.20,36621,41042,69970,2762,2571,290,201,69086,8577
12,39550,1239550,Lauderhill city, Florida,1,2010,67100,42.00,72.30,10.80,29849,37251,9012,52634,1761,0,266,62814,4286
12,39925,1239925,Lehigh Acres CDP, Florida,0,2010,88196,38.70,73.20,14.10,42107,46089,62539,17394,758,63,0,62198,25998
12,43975,1243975,Melbourne city, Florida,1,2010,76083,37.90,81.90,19.90,37193,38890,62953,7882,1652,0,55,70009,6074
12,45000,1245000,Miami city, Florida,1,2010,400892,43.50,81.60,15.80,199043,201849,293897,81120,2612,260,0,116799,284093
12,45025,1245025,Miami Beach city, Florida,1,2010,88110,48.20,86.30,16.10,47745,40365,67266,2396,2962,0,0,41262,46848
12,45060,1245060,Miami Gardens city, Florida,1,2010,107559,43.00,72.70,10.20,48347,59212,-998,-998,-998,-998,-998,84572,22987
12,45975,1245975,Miramar city, Florida,1,2010,122438,44.50,71.90,8.00,55713,66725,48588,50569,11319,127,0,77338,45100
12,53000,1253000,Orlando city, Florida,1,2010,239037,50.20,78.60,8.80,120731,118306,138146,72230,7870,1231,247,182976,56061
12,54000,1254000,Palm Bay city, Florida,1,2010,103225,38.90,75.50,13.80,48776,54449,76654,16623,1723,672,0,85688,17537
12,54200,1254200,Palm Coast city, Florida,1,2010,77473,32.20,78.70,23.60,35995,41478,60122,9242,2300,283,396,69285,8188
12,55775,1255775,Pembroke Pines city, Florida,1,2010,155252,39.20,76.60,14.20,71253,83999,102819,30887,8721,1689,0,90140,65112
12,57425,1257425,Plantation city, Florida,1,2010,85217,39.00,80.10,16.10,39133,46084,56526,21147,3387,82,0,69301,15916
12,58050,1258050,Pompano Beach city, Florida,1,2010,100154,37.70,79.80,19.00,51176,48978,69027,28474,1452,48,0,84537,15617
12,58715,1258715,Port St. Lucie city, Florida,1,2010,165153,38.00,75.70,15.50,81906,83247,118535,26841,3720,2201,0,137113,28040
12,60950,1260950,Riverview CDP, Florida,0,2010,66415,41.00,72.40,9.10,32177,34238,48648,10140,2188,402,95,53393,13022
12,63000,1263000,St. Petersburg city, Florida,1,2010,244818,37.90,81.00,16.50,116565,128253,169184,59098,9485,491,84,226843,17975
12,68350,1268350,Spring Hill CDP, Florida,0,2010,97103,32.90,79.60,24.10,46481,50622,84697,4799,976,210,314,82773,14330
12,69700,1269700,Sunrise city, Florida,1,2010,84717,40.10,78.70,14.80,39353,45364,51295,25337,2575,566,0,63378,21339
12,70600,1270600,Tallahassee city, Florida,1,2010,181734,59.10,82.50,7.30,86503,95231,105356,63000,6512,803,0,171179,10555
12,71000,1271000,Tampa city, Florida,1,2010,336945,45.00,76.40,10.50,165425,171520,210409,88443,12335,8285,249,262395,74550
12,72145,1272145,Town 'n' Country CDP, Florida,0,2010,81175,44.60,78.60,12.80,40580,40595,64801,8523,1977,1028,0,43903,37272
12,76582,1276582,Weston city, Florida,0,2010,65528,39.40,69.80,8.60,32060,33468,56124,1208,3860,283,0,35272,30256
12,76600,1276600,West Palm Beach city, Florida,1,2010,100175,40.70,79.10,16.40,48532,51643,64289,29591,2192,165,0,78676,21499
13,01052,1301052,Albany city, Georgia,1,2010,78971,42.60,73.10,11.10,36733,42238,18636,57568,821,115,0,76853,2118
13,03440,1303440,Athens-Clarke County unified government (balance), Georgia,1,2010,115465,59.60,82.50,8.60,55248,60217,74986,30148,4595,0,0,103384,12081
13,04000,1304000,Atlanta city, Georgia,1,2010,422338,51.70,80.90,9.80,207850,214488,166001,220448,15251,435,0,396973,25365
13,04204,1304204,Augusta-Richmond County consolidated government (balance), Georgia,1,2010,196386,43.00,75.30,11.20,94257,102129,77458,107523,3122,830,4,188010,8376
13,19000,1319000,Columbus city, Georgia,1,2010,190417,42.70,74.50,11.70,90947,99470,89801,85792,4564,456,118,178162,12255
13,42425,1342425,Johns Creek city, Georgia,1,2010,77207,37.90,68.20,7.50,37760,39447,50249,8687,14553,216,155,72411,4796
13,49000,1349000,Macon city, Georgia,1,2010,91524,40.50,73.10,11.50,42609,48915,29541,57757,615,0,0,88960,2564
13,67284,1367284,Roswell city, Georgia,1,2010,88908,39.40,77.70,11.30,43379,45529,69336,7849,5101,215,0,76377,12531
13,68516,1368516,Sandy Springs city, Georgia,1,2010,94441,48.00,80.50,10.00,44926,49515,61707,20673,6007,232,80,81641,12800
13,69000,1369000,Savannah city, Georgia,1,2010,136651,49.20,79.20,10.90,66395,70256,57811,72566,4044,210,0,130348,6303
13,80508,1380508,Warner Robins city, Georgia,1,2010,66757,43.80,71.20,11.20,32721,34036,36541,23719,442,0,0,61624,5133
15,71550,1571550,Urban Honolulu CDP, Hawaii,0,2010,338909,40.10,83.30,18.70,166876,172033,60569,4765,193098,512,25401,321040,17869
16,08830,1608830,Boise City city, Idaho,1,2010,206286,43.50,78.50,12.50,102968,103318,186771,3610,7254,1295,319,191454,14832
16,52120,1652120,Meridian city, Idaho,1,2010,75324,42.70,66.40,7.60,36019,39305,-998,-998,-998,-998,-998,71302,4022
16,56260,1656260,Nampa city, Idaho,1,2010,81781,41.90,68.90,9.40,40606,41175,71525,490,765,2653,0,62397,19384
17,02154,1702154,Arlington Heights village, Illinois,1,2010,77009,36.40,79.30,18.30,38294,38715,64574,1883,7485,537,0,72395,4614
17,03012,1703012,Aurora city, Illinois,1,2010,193582,48.60,67.30,5.40,98154,95428,107964,21814,12176,268,152,105444,88138
17,06613,1706613,Bloomington city, Illinois,1,2010,76730,46.50,76.40,9.60,38128,38602,59206,8355,5605,57,0,73383,3347
17,07133,1707133,Bolingbrook village, Illinois,1,2010,73027,41.50,69.80,5.70,36288,36739,43905,14008,8232,832,0,57038,15989
17,18823,1718823,Decatur city, Illinois,1,2010,76268,37.30,77.10,16.70,34540,41728,53946,18294,708,0,0,74422,1846
17,12385,1712385,Champaign city, Illinois,1,2010,81164,63.30,84.20,7.20,39553,41611,58814,10123,9973,90,0,76150,5014
17,14000,1714000,Chicago city, Illinois,1,2010,2698831,47.90,76.60,10.10,1306010,1392821,1256175,905799,149897,6513,661,1934863,763968
17,14351,1714351,Cicero town, Illinois,1,2010,84002,46.70,67.30,5.20,42737,41265,25526,4138,206,775,328,11604,72398
17,23074,1723074,Elgin city, Illinois,1,2010,108273,42.20,71.20,9.50,53894,54379,75566,8854,5969,83,0,59331,48942
17,24582,1724582,Evanston city, Illinois,1,2010,74549,47.80,77.60,11.80,34479,40070,52205,10096,7815,0,0,66525,8024
17,38570,1738570,Joliet city, Illinois,1,2010,150856,44.50,69.80,8.10,73712,77144,105971,25783,3155,90,149,112761,38095
17,51622,1751622,Naperville city, Illinois,1,2010,141483,37.60,71.70,9.60,71505,69978,106244,6612,22825,213,609,133979,7504
17,57225,1757225,Palatine village, Illinois,1,2010,68596,42.30,76.00,9.30,33566,35030,55060,2264,7968,145,0,56683,11913
17,59000,1759000,Peoria city, Illinois,1,2010,114966,43.80,75.20,13.40,55363,59603,75686,30459,4558,65,0,108846,6120
17,65000,1765000,Rockford city, Illinois,1,2010,152220,40.20,73.30,13.70,73293,78927,104852,34253,4465,447,79,125089,27131
17,68003,1768003,Schaumburg village, Illinois,1,2010,73279,47.90,78.70,10.40,35871,37408,55674,1204,12584,24,0,67955,5324
17,70122,1770122,Skokie village, Illinois,0,2010,64861,34.40,79.30,17.00,31009,33852,41832,4913,15978,0,0,57563,7298
17,72000,1772000,Springfield city, Illinois,1,2010,116188,38.30,77.60,14.60,56063,60125,89535,21229,2458,260,0,114576,1612
17,79293,1779293,Waukegan city, Illinois,1,2010,87729,47.90,69.50,6.80,43830,43899,34329,15384,3150,613,0,41438,46291
18,05860,1805860,Bloomington city, Indiana,1,2010,81096,66.60,89.30,8.90,40961,40135,67643,2845,7408,183,0,77814,3282
18,10342,1810342,Carmel city, Indiana,1,2010,79447,35.20,70.30,9.70,38553,40894,67858,1942,7170,109,0,76280,3167
18,22000,1822000,Evansville city, Indiana,1,2010,115833,40.60,76.40,14.40,55775,60058,96195,14631,468,177,0,112214,3619
18,23278,1823278,Fishers town, Indiana,1,2010,77579,44.30,67.60,6.10,37616,39963,-998,-998,-998,-998,-998,76558,1021
18,25000,1825000,Fort Wayne city, Indiana,1,2010,253696,40.60,72.50,11.90,122815,130881,189969,39416,6945,1158,191,234120,19576
18,27000,1827000,Gary city, Indiana,1,2010,80840,35.30,74.10,14.90,38531,42309,9208,67301,84,217,195,75728,5112
18,31000,1831000,Hammond city, Indiana,1,2010,80812,44.30,73.50,10.20,39618,41194,43149,17952,1122,0,0,51182,29630
18,36003,1836003,Indianapolis city (balance), Indiana,1,2010,824199,43.90,74.90,10.30,397975,426224,523449,228180,17546,2468,0,745732,78467
18,40788,1840788,Lafayette city, Indiana,1,2010,65261,47.60,80.20,11.90,32248,33013,55554,3672,2152,42,0,57842,7419
18,51876,1851876,Muncie city, Indiana,1,2010,68651,51.60,82.90,13.10,32994,35657,57634,6433,1017,303,0,67329,1322
18,71000,1871000,South Bend city, Indiana,1,2010,107072,41.50,73.20,13.60,52483,54589,70036,28539,837,1193,82,94266,12806
19,12000,1912000,Cedar Rapids city, Iowa,1,2010,126498,40.90,77.10,13.50,60328,66170,111335,8851,2039,251,0,122451,4047
19,19000,1919000,Davenport city, Iowa,1,2010,100068,42.20,74.00,11.20,49385,50683,80942,11770,1816,382,0,92373,7695
19,21000,1921000,Des Moines city, Iowa,1,2010,204196,43.60,75.20,10.70,99020,105176,160303,20188,9190,1431,83,180364,23832
19,38595,1938595,Iowa City city, Iowa,1,2010,68027,61.10,84.70,7.60,33535,34492,56192,4122,4524,150,97,64110,3917
19,73335,1973335,Sioux City city, Iowa,1,2010,82378,40.90,73.50,13.00,40272,42106,65021,3357,2666,1905,0,68550,13828
19,82425,1982425,Waterloo city, Iowa,1,2010,68472,41.60,73.80,13.60,32488,35984,55078,10275,634,136,0,64930,3542
20,36000,2036000,Kansas City city, Kansas,1,2010,147798,42.30,72.00,10.30,72884,74914,91880,40232,3896,982,0,106687,41111
20,38900,2038900,Lawrence city, Kansas,1,2010,92718,59.30,81.60,7.60,46576,46142,75514,4054,3869,2879,0,87141,5577
20,52575,2052575,Olathe city, Kansas,1,2010,126256,44.00,70.50,6.40,63860,62396,107388,6096,8003,220,0,112300,13956
20,53775,2053775,Overland Park city, Kansas,1,2010,173909,39.10,75.60,13.80,82149,91760,147761,7822,10367,852,0,163657,10252
20,71000,2071000,Topeka city, Kansas,1,2010,127727,40.40,75.80,14.30,61083,66644,93763,14463,2176,1707,0,110015,17712
20,79000,2079000,Wichita city, Kansas,1,2010,383142,41.40,73.60,11.20,188182,194960,280244,43114,19522,3678,46,323319,59823
21,46027,2146027,Lexington-Fayette urban county, Kentucky,1,2010,296765,47.60,78.90,10.40,147746,149019,226025,40708,9693,837,240,276164,20601
21,48006,2148006,Louisville/Jefferson County metro government (balance), Kentucky,1,2010,598230,40.80,76.10,12.50,288707,309523,431593,136025,12831,1263,184,570454,27776
22,05000,2205000,Baton Rouge city, Louisiana,1,2010,229859,48.20,78.90,11.00,109942,119917,90411,124218,7517,281,0,221400,8459
22,39475,2239475,Kenner city, Louisiana,1,2010,66681,41.30,80.60,12.50,34027,32654,47778,11896,1131,961,0,52209,14472
22,40735,2240735,Lafayette city, Louisiana,1,2010,120871,45.70,80.60,13.10,60562,60309,81262,35170,3051,214,0,116953,3918
22,41155,2241155,Lake Charles city, Louisiana,1,2010,72163,41.30,78.20,13.40,34107,38056,35590,33077,1604,690,181,70405,1758
22,50115,2250115,Metairie CDP, Louisiana,0,2010,132938,38.40,81.40,17.70,63635,69303,105695,14784,4984,1296,0,115753,17185
22,55000,2255000,New Orleans city, Louisiana,1,2010,347858,45.30,78.80,11.10,168746,179112,114660,207696,9420,1536,217,329599,18259
22,70000,2270000,Shreveport city, Louisiana,1,2010,198934,42.10,75.60,12.90,93514,105420,82885,106185,2742,646,1248,193671,5263
23,60545,2360545,Portland city, Maine,1,2010,66150,48.10,83.40,11.80,31970,34180,57349,3863,3651,0,0,63509,2641
24,04000,2404000,Baltimore city, Maryland,1,2010,620583,45.20,78.60,11.80,292446,328137,188657,392953,14284,2389,202,594552,26031
24,19125,2419125,Columbia CDP, Maryland,0,2010,102239,43.90,77.60,11.70,51195,51044,56043,28593,11439,170,0,93249,8990
24,26000,2426000,Ellicott City CDP, Maryland,0,2010,67241,38.60,73.20,10.70,31849,35392,-998,-998,-998,-998,-998,64646,2595
24,30325,2430325,Frederick city, Maryland,0,2010,65439,46.60,78.70,10.90,33003,32436,44870,10231,4549,1128,621,55640,9799
24,32025,2432025,Germantown CDP, Maryland,0,2010,83372,47.70,74.20,5.20,42068,41304,40313,20247,15610,644,0,69949,13423
24,72450,2472450,Silver Spring CDP, Maryland,0,2010,76534,51.60,77.00,8.10,35947,40587,33514,21388,5140,1445,0,54161,22373
24,81175,2481175,Waldorf CDP, Maryland,0,2010,68961,44.20,71.60,6.50,32479,36482,27501,35805,1905,127,0,65806,3155
25,07000,2507000,Boston city, Massachusetts,1,2010,621383,55.40,83.40,10.10,296201,325182,336981,154711,56760,1516,133,516516,104867
25,09000,2509000,Brockton city, Massachusetts,1,2010,93973,43.20,74.80,11.70,44346,49627,45903,36204,1459,520,0,84508,9465
25,11000,2511000,Cambridge city, Massachusetts,1,2010,105337,57.90,87.60,12.30,49895,55442,70927,11420,16128,185,0,97907,7430
25,23000,2523000,Fall River city, Massachusetts,1,2010,88894,43.20,80.30,15.20,41233,47661,81754,1981,1303,236,0,81204,7690
25,24960,2524960,Framingham CDP, Massachusetts,0,2010,68461,45.50,79.10,12.20,32747,35714,51280,7023,4623,121,0,60339,8122
25,34550,2534550,Lawrence city, Massachusetts,1,2010,76526,44.30,70.70,8.00,36667,39859,23734,2832,2667,631,0,18516,58010
25,37000,2537000,Lowell city, Massachusetts,1,2010,106730,46.60,77.00,8.80,52085,54645,62246,4802,25035,0,0,88454,18276
25,37490,2537490,Lynn city, Massachusetts,1,2010,90511,46.00,74.40,10.90,41366,49145,62912,10353,6347,90,0,62679,27832
25,45000,2545000,New Bedford city, Massachusetts,1,2010,95138,40.90,74.70,14.30,43615,51523,73561,6152,1047,339,76,81043,14095
25,45560,2545560,Newton city, Massachusetts,1,2010,85302,38.80,78.40,16.50,40287,45015,68423,1352,12386,0,0,80772,4530
25,55745,2555745,Quincy city, Massachusetts,1,2010,92486,43.80,83.70,16.10,44079,48407,64038,6831,19409,242,0,89458,3028
25,62535,2562535,Somerville city, Massachusetts,1,2010,75900,62.20,83.40,6.10,36772,39128,59215,5545,5104,658,0,69586,6314
25,67000,2567000,Springfield city, Massachusetts,1,2010,153115,44.50,73.30,11.00,73794,79321,76259,34312,4581,634,0,90955,62160
25,82000,2582000,Worcester city, Massachusetts,1,2010,181264,46.10,78.50,12.20,84008,97256,139498,19451,10610,500,0,145979,35285
26,03000,2603000,Ann Arbor city, Michigan,1,2010,114101,59.20,84.70,10.50,56165,57936,83795,8363,13896,342,0,107705,6396
26,21000,2621000,Dearborn city, Michigan,1,2010,97895,39.20,70.60,11.50,46088,51807,87265,3028,2447,29,63,92015,5880
26,22000,2622000,Detroit city, Michigan,1,2010,711910,41.30,73.40,11.50,338958,372952,77423,589659,6549,2799,34,666330,45580
26,27440,2627440,Farmington Hills city, Michigan,1,2010,79768,36.20,78.00,14.70,38234,41534,52956,14557,8341,134,63,76922,2846
26,29000,2629000,Flint city, Michigan,1,2010,102231,41.00,72.50,11.60,48607,53624,42661,53285,368,686,0,98681,3550
26,34000,2634000,Grand Rapids city, Michigan,1,2010,188214,47.10,73.30,10.40,90614,97600,127354,42866,3695,1723,0,157555,30659
26,42160,2642160,Kalamazoo city, Michigan,1,2010,74382,54.10,79.50,9.10,34806,39576,55494,14506,1565,601,0,68962,5420
26,46000,2646000,Lansing city, Michigan,1,2010,114017,46.00,76.00,9.30,56147,57870,68437,27106,3978,934,0,98982,15035
26,49000,2649000,Livonia city, Michigan,1,2010,96684,34.90,76.60,16.90,47716,48968,89398,2721,2505,269,0,94346,2338
26,69035,2669035,Rochester Hills city, Michigan,1,2010,71022,38.80,77.10,12.70,32810,38212,58935,4576,6169,186,0,69511,1511
26,74900,2674900,Southfield city, Michigan,1,2010,71785,37.20,80.70,18.20,31473,40312,19799,49339,1199,0,0,71051,734
26,76460,2676460,Sterling Heights city, Michigan,1,2010,129734,39.10,77.40,14.10,62427,67307,114417,4919,6524,39,0,127249,2485
26,80700,2680700,Troy city, Michigan,1,2010,81037,35.30,76.10,13.40,40986,40051,-998,-998,-998,-998,-998,80047,990
26,84000,2684000,Warren city, Michigan,1,2010,134075,38.80,76.30,17.00,63416,70659,103177,18860,8300,75,0,129854,4221
26,86000,2686000,Westland city, Michigan,1,2010,83860,41.30,78.80,14.50,38609,45251,62054,16392,2930,694,0,82190,1670
26,88940,2688940,Wyoming city, Michigan,1,2010,72209,44.50,75.00,10.30,35764,36445,59455,3958,3896,345,0,62160,10049
27,06616,2706616,Bloomington city, Minnesota,1,2010,83054,36.60,77.70,17.90,38719,44335,68456,4948,6221,451,0,77764,5290
27,07966,2707966,Brooklyn Park city, Minnesota,1,2010,75936,42.90,66.70,8.10,36593,39343,40055,16310,13145,0,0,68105,7831
27,17000,2717000,Duluth city, Minnesota,1,2010,86230,47.10,81.20,14.60,43061,43169,79251,2559,1044,1381,0,85339,891
27,43000,2743000,Minneapolis city, Minnesota,1,2010,383280,52.20,81.30,8.00,194796,188484,265661,64583,21484,6447,190,348776,34504
27,51730,2751730,Plymouth city, Minnesota,1,2010,70710,38.50,74.70,12.30,33851,36859,59956,4345,3539,551,40,67484,3226
27,54880,2754880,Rochester city, Minnesota,1,2010,106963,41.30,74.90,13.00,51922,55041,89095,6127,6633,87,72,101479,5484
27,56896,2756896,St. Cloud city, Minnesota,0,2010,65885,50.20,84.30,10.60,33400,32485,57090,4858,1586,764,0,64067,1818
27,58000,2758000,St. Paul city, Minnesota,1,2010,285439,48.20,75.60,8.80,138770,146669,180332,42639,42225,2209,50,256714,28725
28,29700,2829700,Gulfport city, Mississippi,1,2010,68042,44.10,76.60,12.40,36188,31854,40601,23958,982,474,0,63040,5002
28,36000,2836000,Jackson city, Mississippi,1,2010,173315,43.00,71.60,10.10,79986,93329,-998,-998,-998,-998,-998,170019,3296
29,15670,2915670,Columbia city, Missouri,1,2010,108872,57.50,81.20,9.20,50721,58151,86064,11492,6034,247,172,105206,3666
29,35000,2935000,Independence city, Missouri,1,2010,117027,38.70,74.90,15.40,56946,60081,97679,9287,1783,574,99,108950,8077
29,38000,2938000,Kansas City city, Missouri,1,2010,460665,42.70,75.10,10.60,219990,240675,269743,139811,10263,1978,1099,410865,49800
29,41348,2941348,Lee's Summit city, Missouri,1,2010,91229,38.50,73.90,12.80,43826,47403,80781,4985,2456,0,519,89580,1649
29,54074,2954074,O'Fallon city, Missouri,1,2010,79565,42.10,69.00,9.20,38680,40885,-998,-998,-998,-998,-998,77228,2337
29,64082,2964082,St. Charles city, Missouri,0,2010,65993,40.10,81.90,14.90,32625,33368,58635,5011,495,78,0,63260,2733
29,64550,2964550,St. Joseph city, Missouri,1,2010,74853,41.30,76.80,13.90,37141,37712,65251,5559,662,299,0,70164,4689
29,65000,2965000,St. Louis city, Missouri,1,2010,319156,46.60,78.80,11.10,154585,164571,143898,157759,8717,535,0,307949,11207
29,70000,2970000,Springfield city, Missouri,1,2010,159643,46.20,81.80,14.60,77317,82326,141427,5931,3077,1178,0,153332,6311
30,06550,3006550,Billings city, Montana,1,2010,104491,38.90,76.00,15.20,51422,53069,93662,743,1289,5018,0,98931,5560
30,50200,3050200,Missoula city, Montana,1,2010,66905,51.80,82.10,10.80,34911,31994,62353,357,638,2145,101,64560,2345
31,28000,3128000,Lincoln city, Nebraska,1,2010,259041,46.80,77.00,10.80,129404,129637,229073,9540,10604,1453,1216,243034,16007
31,37000,3137000,Omaha city, Nebraska,1,2010,410269,43.40,74.90,11.00,201168,209101,316463,55287,8397,3539,244,356608,53661
32,23770,3223770,Enterprise CDP, Nevada,0,2010,118697,52.50,75.00,4.80,61408,57289,68582,11988,22043,817,2168,96626,22071
32,31900,3231900,Henderson city, Nevada,1,2010,258138,37.80,76.90,13.50,128839,129299,204576,15542,21362,1180,1836,220606,37532
32,40000,3240000,Las Vegas city, Nevada,1,2010,584641,41.90,75.90,12.60,296812,287829,401776,61508,38210,3075,3680,402718,181923
32,51800,3251800,North Las Vegas city, Nevada,1,2010,217304,46.30,67.20,6.10,107006,110298,112571,49844,16015,1032,775,134220,83084
32,54600,3254600,Paradise CDP, Nevada,0,2010,215586,44.40,77.80,12.50,109520,106066,151348,20915,15726,794,2832,144997,70589
32,60600,3260600,Reno city, Nevada,1,2010,225818,44.00,77.10,12.20,116337,109481,185581,7039,13313,2709,427,171661,54157
32,68400,3268400,Sparks city, Nevada,1,2010,90504,44.80,72.00,8.50,43653,46851,71527,2027,6647,997,179,61120,29384
32,68585,3268585,Spring Valley CDP, Nevada,0,2010,179830,45.50,78.10,11.20,88837,90993,120508,13126,28832,725,2151,145290,34540
32,71400,3271400,Sunrise Manor CDP, Nevada,0,2010,185286,42.40,68.00,9.50,91513,93773,115903,19168,11180,612,448,90486,94800
33,45140,3345140,Manchester city, New Hampshire,1,2010,109655,43.30,79.30,11.50,53801,55854,91985,4887,5473,386,0,99588,10067
33,50260,3350260,Nashua city, New Hampshire,1,2010,86570,41.70,76.10,11.80,43733,42837,76255,1240,5176,93,0,78785,7785
34,10000,3410000,Camden city, New Jersey,1,2010,77331,44.10,69.10,8.00,36811,40520,10637,35046,962,780,0,40604,36727
34,13690,3413690,Clifton city, New Jersey,1,2010,84249,42.20,77.00,13.50,40786,43463,56608,3072,7573,0,0,52592,31657
34,19390,3419390,East Orange city, New Jersey,0,2010,64299,44.30,76.90,11.00,28604,35695,-998,-998,-998,-998,-998,57145,7154
34,21000,3421000,Elizabeth city, New Jersey,1,2010,125222,46.80,72.60,7.40,61676,63546,65810,23378,2775,104,0,49877,75345
34,36000,3436000,Jersey City city, New Jersey,1,2010,248005,50.90,78.10,8.30,123042,124963,82432,64987,58578,606,0,178132,69873
34,51000,3451000,Newark city, New Jersey,1,2010,277232,48.40,73.70,8.40,138580,138652,71202,145187,4440,2141,40,184703,92529
34,56550,3456550,Passaic city, New Jersey,1,2010,69870,45.80,68.80,7.70,37242,32628,26278,3992,851,159,0,17747,52123
34,57000,3457000,Paterson city, New Jersey,1,2010,146377,45.80,72.40,8.60,70803,75574,78946,47809,6969,495,0,69373,77004
34,73110,3473110,Toms River CDP, New Jersey,0,2010,89390,38.00,77.30,15.10,42529,46861,80875,1752,4150,0,0,81464,7926
34,74000,3474000,Trenton city, New Jersey,1,2010,85015,47.70,73.90,9.20,41154,43861,25851,42990,1054,591,0,55944,29071
34,74630,3474630,Union City city, New Jersey,1,2010,66560,50.00,75.50,8.50,32196,34364,40014,2260,3289,291,0,15855,50705
35,02000,3502000,Albuquerque city, New Mexico,1,2010,547585,42.70,76.00,12.10,266622,280963,383124,18601,13884,21924,0,288438,259147
35,39380,3539380,Las Cruces city, New Mexico,1,2010,98239,44.30,77.00,13.20,47091,51148,88302,1461,1112,1621,0,40988,57251
35,63460,3563460,Rio Rancho city, New Mexico,1,2010,87954,38.80,71.30,11.40,42027,45927,72721,3083,1354,3224,180,55973,31981
35,70500,3570500,Santa Fe city, New Mexico,1,2010,68157,32.90,80.80,18.60,32752,35405,59885,440,910,207,0,35163,32994
36,01000,3601000,Albany city, New York,1,2010,97737,52.00,81.70,12.70,47554,50183,53959,32791,4340,484,0,89450,8287
36,11000,3611000,Buffalo city, New York,1,2010,261210,45.20,77.20,11.40,123608,137602,135264,99988,9856,1496,104,239525,21685
36,15000,3615000,Cheektowaga CDP, New York,0,2010,75018,35.90,82.10,19.60,36411,38607,66784,5273,497,539,0,73216,1802
36,49121,3649121,Mount Vernon city, New York,1,2010,67397,41.10,74.00,10.90,31171,36226,19132,42215,699,131,0,57261,10136
36,50617,3650617,New Rochelle city, New York,1,2010,77177,40.80,77.80,15.90,36466,40711,52066,14247,1645,62,0,58244,18933
36,51000,3651000,New York city, New York,1,2010,8184899,45.50,78.40,12.20,3887304,4297595,3649022,2048482,1046126,33179,3883,5838073,2346826
36,63000,3663000,Rochester city, New York,1,2010,210595,47.50,75.00,8.60,100160,110435,91654,89317,7322,1252,0,176330,34265
36,65508,3665508,Schenectady city, New York,1,2010,66202,43.70,74.30,11.10,32018,34184,41228,15116,3699,534,0,59350,6852
36,73000,3673000,Syracuse city, New York,1,2010,145216,49.40,76.40,9.50,69341,75875,83806,41947,6848,416,49,132202,13014
37,12000,3712000,Charlotte city, North Carolina,1,2010,734418,46.80,74.60,8.70,353327,381091,390251,255557,37416,4135,152,638172,96246
36,84000,3684000,Yonkers city, New York,1,2010,196277,40.90,76.80,14.10,91694,104583,100977,34687,13724,133,0,128119,68158
37,02140,3702140,Asheville city, North Carolina,1,2010,83570,42.60,82.90,16.90,40715,42855,70885,9521,871,299,35,78816,4754
37,10740,3710740,Cary town, North Carolina,1,2010,135418,43.80,72.70,7.30,65719,69699,97806,8588,16327,326,0,119756,15662
37,14100,3714100,Concord city, North Carolina,1,2010,79330,42.30,73.60,10.40,38902,40428,62458,11007,2340,120,54,68208,11122
37,19000,3719000,Durham city, North Carolina,1,2010,229029,49.30,77.20,9.40,107619,121410,98538,90408,10035,178,65,195776,33253
37,22920,3722920,Fayetteville city, North Carolina,1,2010,201077,47.00,75.90,9.90,100049,101028,94939,81367,4931,1187,402,180431,20646
37,25580,3725580,Gastonia city, North Carolina,1,2010,71782,40.60,75.10,12.30,33625,38157,43977,18545,2220,187,0,62584,9198
37,28000,3728000,Greensboro city, North Carolina,1,2010,270357,45.60,78.30,12.20,127295,143062,142079,102102,10772,626,0,252382,17975
37,28080,3728080,Greenville city, North Carolina,1,2010,84879,58.80,81.90,8.50,38498,46381,49147,30358,2037,0,0,82172,2707
37,31400,3731400,High Point city, North Carolina,1,2010,103672,40.80,71.30,10.50,48902,54770,51098,39885,7075,739,0,94667,9005
37,34200,3734200,Jacksonville city, North Carolina,1,2010,70705,59.70,76.70,6.40,39986,30719,50339,13465,2734,386,224,61777,8928
37,55000,3755000,Raleigh city, North Carolina,1,2010,406609,50.40,77.40,8.30,196072,210537,252036,117594,16276,1600,112,361247,45362
37,74440,3774440,Wilmington city, North Carolina,1,2010,106819,45.30,80.70,13.50,51369,55450,80402,22036,1207,118,0,99356,7463
37,75000,3775000,Winston-Salem city, North Carolina,1,2010,230044,44.10,75.00,11.80,107510,122534,126631,78481,5347,403,130,195281,34763
38,25700,3825700,Fargo city, North Dakota,1,2010,106600,51.10,79.70,9.70,54408,52192,97724,1890,2809,1182,0,104098,2502
39,01000,3901000,Akron city, Ohio,1,2010,199030,41.10,75.90,12.60,95259,103771,123870,60946,4567,130,0,195040,3990
39,12000,3912000,Canton city, Ohio,1,2010,72958,38.60,72.30,13.30,34824,38134,48310,19757,200,106,0,70968,1990
39,15000,3915000,Cincinnati city, Ohio,1,2010,296907,46.80,78.40,10.50,143338,153569,146964,132993,5938,1348,0,288197,8710
39,16000,3916000,Cleveland city, Ohio,1,2010,396240,41.20,76.40,12.40,187130,209110,158119,211256,5547,1867,49,360173,36067
39,18000,3918000,Columbus city, Ohio,1,2010,789939,49.60,76.30,8.30,382982,406957,495942,219996,35529,1510,304,746663,43276
39,21000,3921000,Dayton city, Ohio,1,2010,141501,44.30,76.80,11.20,69634,71867,74803,61522,1231,230,0,138321,3180
39,44856,3944856,Lorain city, Ohio,0,2010,64128,35.80,71.30,11.00,30652,33476,38152,15018,974,240,0,48772,15356
39,61000,3961000,Parma city, Ohio,1,2010,81481,36.50,79.80,18.60,40239,41242,76126,1290,882,55,0,77300,4181
39,77000,3977000,Toledo city, Ohio,1,2010,286979,43.20,75.30,11.30,137574,149405,188690,76463,3237,696,441,265633,21346
39,88000,3988000,Youngstown city, Ohio,1,2010,66835,38.70,81.10,18.20,33987,32848,33272,29847,938,49,0,60353,6482
40,09050,4009050,Broken Arrow city, Oklahoma,1,2010,98523,41.70,72.90,10.20,49408,49115,81635,3099,1957,3761,0,91048,7475
40,23200,4023200,Edmond city, Oklahoma,1,2010,81696,43.10,75.80,9.60,39993,41703,65612,6272,4817,1431,0,79390,2306
40,41850,4041850,Lawton city, Oklahoma,1,2010,97832,48.10,75.10,9.80,50803,47029,58023,20720,2839,4863,786,85441,12391
40,52500,4052500,Norman city, Oklahoma,1,2010,111398,50.10,80.60,9.90,55715,55683,90353,3668,3718,4774,79,103937,7461
40,55000,4055000,Oklahoma City city, Oklahoma,1,2010,582278,42.70,74.80,11.60,287763,294515,384072,86539,20415,17743,747,480813,101465
40,75000,4075000,Tulsa city, Oklahoma,1,2010,393577,41.60,75.60,12.80,187877,205700,263536,62671,9757,16702,357,338311,55266
41,05350,4105350,Beaverton city, Oregon,1,2010,90150,44.30,77.30,9.80,44204,45946,68438,1561,11200,242,0,79026,11124
41,05800,4105800,Bend city, Oregon,1,2010,76723,42.20,78.30,14.30,36607,40116,72202,465,1195,298,0,72692,4031
41,23850,4123850,Eugene city, Oregon,1,2010,156299,46.90,82.60,14.40,77734,78565,136241,2286,6483,325,342,144204,12095
41,31250,4131250,Gresham city, Oregon,1,2010,105973,42.90,76.20,10.90,51948,54025,88530,3924,4537,1113,241,89180,16793
41,34100,4134100,Hillsboro city, Oregon,1,2010,91954,47.70,72.50,8.50,44877,47077,60448,1849,5941,2493,167,62169,29785
41,47000,4147000,Medford city, Oregon,1,2010,75007,38.20,79.10,17.50,35356,39651,69148,290,586,869,0,66044,8963
41,59000,4159000,Portland city, Oregon,1,2010,585429,48.30,80.50,10.60,290792,294637,445947,38867,43399,4486,3510,526443,58986
41,64900,4164900,Salem city, Oregon,1,2010,155004,40.20,76.90,12.80,76581,78423,122679,2132,4749,2016,2273,123404,31600
42,02000,4202000,Allentown city, Pennsylvania,1,2010,118240,43.50,73.30,11.80,57786,60454,81330,14313,1800,910,0,68647,49593
42,06088,4206088,Bethlehem city, Pennsylvania,1,2010,75233,45.10,80.50,14.70,35416,39817,58926,5284,2259,273,0,55883,19350
42,24000,4224000,Erie city, Pennsylvania,1,2010,101821,45.30,75.30,12.00,47241,54580,79269,16855,1405,68,0,95713,6108
42,60000,4260000,Philadelphia city, Pennsylvania,1,2010,1528306,45.70,77.50,12.20,721806,806500,634294,668961,97916,4659,224,1339803,188503
42,61000,4261000,Pittsburgh city, Pennsylvania,1,2010,305759,48.30,82.40,13.80,145942,159817,207892,72516,12342,391,43,298477,7282
42,63624,4263624,Reading city, Pennsylvania,1,2010,88175,45.10,68.90,9.90,43265,44910,47806,10070,947,456,0,37126,51049
42,69000,4269000,Scranton city, Pennsylvania,1,2010,76068,38.80,79.10,17.50,35698,40370,66279,4058,1936,132,190,68433,7635
44,19180,4419180,Cranston city, Rhode Island,1,2010,80424,37.60,79.40,14.40,39395,41029,69996,4390,2789,153,0,73724,6700
44,54640,4454640,Pawtucket city, Rhode Island,1,2010,71204,41.80,79.40,13.80,33723,37481,43175,15314,820,0,0,58228,12976
44,59000,4459000,Providence city, Rhode Island,1,2010,178162,54.70,77.20,8.60,86777,91385,86887,23338,11663,747,488,101517,76645
44,74300,4474300,Warwick city, Rhode Island,1,2010,82643,35.20,82.50,19.20,39418,43225,76413,981,2967,170,0,79877,2766
45,13330,4513330,Charleston city, South Carolina,1,2010,119834,49.70,82.50,13.50,56303,63531,85657,30599,1259,0,238,117289,2545
45,16000,4516000,Columbia city, South Carolina,1,2010,129139,56.60,84.00,8.90,66454,62685,68035,53725,3265,134,498,125188,3951
45,48535,4548535,Mount Pleasant town, South Carolina,1,2010,68112,39.90,76.20,10.80,32790,35322,-998,-998,-998,-998,-998,66919,1193
45,50875,4550875,North Charleston city, South Carolina,1,2010,95548,47.90,72.90,8.50,47096,48452,42831,43624,884,126,0,82238,13310
45,61405,4561405,Rock Hill city, South Carolina,1,2010,66395,48.50,77.10,10.70,31264,35131,-998,-998,-998,-998,-998,64417,1978
46,52980,4652980,Rapid City city, South Dakota,1,2010,68221,39.00,77.80,15.70,33731,34490,57534,828,243,6770,0,65527,2694
46,59020,4659020,Sioux Falls city, South Dakota,1,2010,153959,43.90,75.90,11.50,76757,77202,134156,6776,3507,4199,0,146813,7146
47,14000,4714000,Chattanooga city, Tennessee,1,2010,168075,42.10,78.70,14.70,79875,88200,99043,57097,4165,773,0,158019,10056
47,15160,4715160,Clarksville city, Tennessee,1,2010,133669,48.80,70.90,7.60,64762,68907,90168,30823,3348,1290,96,121647,12022
47,37640,4737640,Jackson city, Tennessee,0,2010,65279,42.30,74.40,12.90,30652,34627,30541,32456,510,37,290,62198,3081
47,40000,4740000,Knoxville city, Tennessee,1,2010,179226,46.20,80.80,14.20,85012,94214,136322,33164,2780,294,0,171322,7904
47,48000,4748000,Memphis city, Tennessee,1,2010,647870,43.30,74.60,10.40,308906,338964,192392,413002,9532,2047,44,607274,40596
47,51560,4751560,Murfreesboro city, Tennessee,1,2010,109220,52.90,77.70,8.90,52935,56285,82878,18068,4065,1174,0,104127,5093
47,52006,4752006,Nashville-Davidson metropolitan government (balance), Tennessee,1,2010,602618,47.20,78.40,10.30,291520,311098,370668,171881,17104,1196,0,541406,61212
48,01000,4801000,Abilene city, Texas,1,2010,119688,45.90,78.10,12.30,60757,58931,96443,11710,1270,475,37,89501,30187
48,01924,4801924,Allen city, Texas,1,2010,84888,42.80,69.00,5.60,39891,44997,63437,8714,9184,782,0,77700,7188
48,03000,4803000,Amarillo city, Texas,1,2010,194161,41.80,73.30,11.40,97566,96595,162264,13717,5589,941,406,138545,55616
48,04000,4804000,Arlington city, Texas,1,2010,367185,45.70,72.10,8.00,183376,183809,238985,70154,24122,941,152,259026,108159
48,04462,4804462,Atascocita CDP, Texas,0,2010,71245,48.90,70.40,5.40,36874,34371,49722,14875,2168,262,0,51320,19925
48,05000,4805000,Austin city, Texas,1,2010,795518,52.90,77.50,7.10,402614,392904,567292,63504,46891,4010,268,507388,288130
48,06128,4806128,Baytown city, Texas,1,2010,72418,44.00,73.30,8.20,36103,36315,46964,12100,862,931,0,41037,31381
48,07000,4807000,Beaumont city, Texas,1,2010,118355,44.50,75.30,12.20,58544,59811,49101,53747,3600,235,63,98914,19441
48,10768,4810768,Brownsville city, Texas,1,2010,175831,41.10,62.80,9.60,81698,94133,163125,344,1409,263,0,12627,163204
48,10912,4810912,Bryan city, Texas,1,2010,76541,50.50,74.90,8.70,38344,38197,52888,14675,430,359,0,49849,26692
48,13024,4813024,Carrollton city, Texas,1,2010,119759,41.30,74.10,9.30,58180,61579,85106,11045,14774,1329,184,82867,36892
48,15976,4815976,College Station city, Texas,1,2010,94246,71.40,86.40,5.00,49592,44654,73355,6093,8823,307,112,80360,13886
48,17000,4817000,Corpus Christi city, Texas,1,2010,305442,41.00,74.00,11.70,150686,154756,264705,13415,5287,625,375,124463,180979
48,19000,4819000,Dallas city, Texas,1,2010,1202797,46.80,73.70,9.10,605261,597536,641183,296743,34216,4567,397,690820,511977
48,19972,4819972,Denton city, Texas,1,2010,114100,59.00,82.70,7.80,56276,57824,86670,13055,5681,322,0,90625,23475
48,22660,4822660,Edinburg city, Texas,1,2010,77613,47.60,70.10,7.60,38300,39313,69024,1649,1520,408,0,9433,68180
48,24000,4824000,El Paso city, Texas,1,2010,652113,42.30,71.50,11.30,312507,339606,520798,22264,7400,4054,137,129022,523091
48,26232,4826232,Flower Mound town, Texas,0,2010,66238,37.40,65.40,4.40,30962,35276,-998,-998,-998,-998,-998,59109,7129
48,27000,4827000,Fort Worth city, Texas,1,2010,744114,45.10,71.00,8.10,367308,376806,466299,143169,26996,4386,137,494042,250072
48,27684,4827684,Frisco city, Texas,1,2010,117839,45.50,62.70,4.50,59651,58188,87340,10593,10281,323,116,99014,18825
48,29000,4829000,Garland city, Texas,1,2010,227604,42.50,71.20,8.30,111016,116588,106681,33003,18857,591,307,138713,88891
48,30464,4830464,Grand Prairie city, Texas,1,2010,176090,43.70,68.30,7.30,86389,89701,111491,27946,15281,887,0,101524,74566
48,32372,4832372,Harlingen city, Texas,0,2010,65124,39.60,74.10,14.10,31653,33471,59349,1003,1340,0,0,13546,51578
48,35000,4835000,Houston city, Texas,1,2010,2107208,46.40,74.30,9.20,1061518,1045690,1193414,500359,131075,10314,740,1189215,917993
48,37000,4837000,Irving city, Texas,1,2010,217139,50.30,70.90,6.10,106476,110663,142813,24989,28266,906,118,121179,95960
48,39148,4839148,Killeen city, Texas,1,2010,129070,50.80,69.50,5.00,62544,66526,67667,41429,5353,273,912,96394,32676
48,41464,4841464,Laredo city, Texas,1,2010,237244,45.00,64.90,7.60,114913,122331,221509,321,2123,610,0,10186,227058
48,41980,4841980,League City city, Texas,1,2010,83848,45.70,70.70,6.90,43421,40427,70839,6267,3321,0,0,68068,15780
48,42508,4842508,Lewisville city, Texas,1,2010,95691,49.20,75.60,6.70,48354,47337,72492,7598,7135,209,111,68617,27074
48,43888,4843888,Longview city, Texas,1,2010,80238,39.70,74.10,13.60,39161,41077,55478,18406,843,764,0,66527,13711
48,45000,4845000,Lubbock city, Texas,1,2010,230734,48.10,77.20,11.50,115461,115273,175848,18848,6239,1045,102,156070,74664
48,45384,4845384,McAllen city, Texas,1,2010,130767,44.30,72.50,10.60,64239,66528,114817,2067,4061,414,0,22059,108708
48,45744,4845744,McKinney city, Texas,1,2010,132147,45.30,67.60,7.10,62740,69407,109721,11306,4190,287,0,105090,27057
48,47892,4847892,Mesquite city, Texas,1,2010,140293,43.30,70.20,9.60,64668,75625,87271,36714,4642,392,0,100541,39752
48,48072,4848072,Midland city, Texas,1,2010,111238,42.30,71.20,11.10,53217,58021,93333,8589,1668,607,0,66788,44450
48,48768,4848768,Mission city, Texas,1,2010,77586,41.90,61.80,9.00,37526,40060,-998,-998,-998,-998,-998,8478,69108
48,48804,4848804,Missouri City city, Texas,1,2010,69052,41.10,71.00,7.80,32727,36325,29238,27474,8181,495,0,53296,15756
48,52356,4852356,North Richland Hills city, Texas,0,2010,63656,40.80,75.10,11.90,29406,34250,53646,1987,2770,33,0,54101,9555
48,53388,4853388,Odessa city, Texas,1,2010,99554,43.50,70.40,10.90,48518,51036,81677,6083,478,1815,61,50622,48932
48,56000,4856000,Pasadena city, Texas,1,2010,149722,41.90,69.10,9.10,71128,78594,100372,4750,3539,1389,0,55959,93763
48,56348,4856348,Pearland city, Texas,1,2010,90811,43.60,68.60,6.30,43849,46962,61479,13047,12802,296,53,70305,20506
48,57200,4857200,Pharr city, Texas,1,2010,70888,42.10,66.60,11.80,33358,37530,-998,-998,-998,-998,-998,4071,66817
48,58016,4858016,Plano city, Texas,1,2010,261697,40.20,74.50,8.80,129796,131901,180649,18883,45010,1521,271,222116,39581
48,61796,4861796,Richardson city, Texas,1,2010,99721,45.30,78.70,11.30,50306,49415,66108,8046,15751,972,0,87184,12537
48,63500,4863500,Round Rock city, Texas,1,2010,102441,46.40,68.00,5.20,50431,52010,86133,6623,2464,811,155,70451,31990
48,64472,4864472,San Angelo city, Texas,1,2010,93804,43.20,77.00,14.10,44980,48824,80476,4445,1108,168,330,57524,36280
48,65000,4865000,San Antonio city, Texas,1,2010,1334359,43.70,73.30,10.60,649633,684726,1013972,83132,29928,12549,1099,480705,853654
48,70808,4870808,Sugar Land city, Texas,1,2010,79472,36.10,76.40,10.20,39742,39730,42146,5745,28597,236,0,70958,8514
48,72176,4872176,Temple city, Texas,0,2010,66686,37.60,73.90,15.20,32542,34144,47703,12820,1429,0,17,53360,13326
48,72656,4872656,The Woodlands CDP, Texas,0,2010,92076,34.80,73.10,10.80,46223,45853,81376,1085,4936,197,0,79443,12633
48,74144,4874144,Tyler city, Texas,1,2010,97271,40.60,78.30,15.90,46314,50957,69500,21652,1319,79,0,75668,21603
48,76000,4876000,Waco city, Texas,1,2010,125410,47.30,74.60,11.40,58911,66499,90902,25393,1832,1055,0,84895,40515
48,79000,4879000,Wichita Falls city, Texas,1,2010,104699,44.30,76.40,12.60,55150,49549,82781,14110,2837,793,0,83545,21154
49,43660,4943660,Layton city, Utah,1,2010,67612,42.70,69.20,9.30,34689,32923,62076,671,1033,795,0,62848,4764
49,55980,4955980,Ogden city, Utah,1,2010,83171,47.00,72.00,9.50,42448,40723,62362,2098,1150,1273,337,61082,22089
49,57300,4957300,Orem city, Utah,1,2010,88929,49.90,69.90,7.90,43631,45298,77248,564,1340,392,930,74615,14314
49,62470,4962470,Provo city, Utah,1,2010,113196,66.40,77.80,5.60,56782,56414,97408,1573,1629,1654,1318,98592,14604
49,65330,4965330,St. George city, Utah,1,2010,73078,39.00,70.80,18.30,35914,37164,66395,77,1113,1097,393,64934,8144
49,67000,4967000,Salt Lake City city, Utah,1,2010,187215,50.00,75.30,10.80,92378,94837,150286,5644,5031,3276,1675,141664,45551
49,67440,4967440,Sandy city, Utah,1,2010,87818,41.30,71.80,9.10,44181,43637,-998,-998,-998,-998,-998,78569,9249
49,82950,4982950,West Jordan city, Utah,1,2010,104145,48.00,66.00,4.60,52518,51627,94520,164,2239,445,1138,85136,19009
49,83470,4983470,West Valley City city, Utah,1,2010,130026,43.00,66.40,7.30,64953,65073,101665,3428,7003,1626,4214,92325,37701
51,01000,5101000,Alexandria city, Virginia,1,2010,140912,51.20,82.90,9.10,69045,71867,89157,30208,8203,691,141,118199,22713
51,03000,5103000,Arlington CDP, Virginia,0,2010,209457,54.70,84.30,8.50,104870,104587,147171,17623,18944,1019,280,177720,31737
51,14440,5114440,Centreville CDP, Virginia,0,2010,77022,49.70,70.70,4.70,37912,39110,41636,6519,16607,2930,72,61897,15125
51,16000,5116000,Chesapeake city, Virginia,1,2010,222986,40.10,74.30,10.50,108448,114538,139675,67715,7354,1319,64,213286,9700
51,21088,5121088,Dale City CDP, Virginia,0,2010,62021,43.10,72.30,6.50,31448,30573,27857,17368,5124,255,0,46829,15192
51,35000,5135000,Hampton city, Virginia,1,2010,137381,42.30,77.30,12.40,65709,71672,59604,69332,3229,476,0,131117,6264
51,47672,5147672,Lynchburg city, Virginia,1,2010,75686,49.70,79.50,13.20,36504,39182,48099,22050,2244,47,0,74087,1599
51,56000,5156000,Newport News city, Virginia,1,2010,180712,45.00,75.90,10.50,87138,93574,90783,70643,3694,896,1674,167119,13593
51,57000,5157000,Norfolk city, Virginia,1,2010,243135,51.50,79.20,9.70,126067,117068,116707,107983,8352,746,884,226914,16221
51,64000,5164000,Portsmouth city, Virginia,1,2010,95696,41.20,76.40,13.40,46150,49546,39718,50598,1245,159,0,92682,3014
51,67000,5167000,Richmond city, Virginia,1,2010,204389,49.90,81.40,11.10,97377,107012,88900,101128,4811,697,0,191592,12797
51,68000,5168000,Roanoke city, Virginia,1,2010,96967,40.40,78.40,14.30,45860,51107,64439,27977,1124,88,0,91609,5358
51,76432,5176432,Suffolk city, Virginia,1,2010,84906,39.10,73.90,11.80,41328,43578,-998,-998,-998,-998,-998,84066,840
51,82000,5182000,Virginia Beach city, Virginia,1,2010,439172,44.00,76.00,10.70,214873,224299,303393,81771,27303,387,788,409966,29206
53,03180,5303180,Auburn city, Washington,1,2010,70873,42.00,76.10,8.50,35509,35364,48254,6984,6124,889,968,62340,8533
53,05210,5305210,Bellevue city, Washington,1,2010,122808,43.00,78.00,14.10,60383,62425,76220,4077,34879,782,339,115287,7521
53,05280,5305280,Bellingham city, Washington,1,2010,81067,54.00,83.80,12.30,40616,40451,70871,1187,2663,1557,48,74133,6934
53,22640,5322640,Everett city, Washington,1,2010,103321,47.40,77.60,8.60,51414,51907,76215,5713,7429,1133,269,83497,19824
53,57745,5357745,Renton city, Washington,1,2010,91259,47.10,77.00,9.20,46100,45159,42744,7016,16918,482,35,70602,20657
53,23515,5323515,Federal Way city, Washington,1,2010,89622,42.90,76.80,11.80,43631,45991,58468,6379,17440,634,736,78505,11117
53,35275,5335275,Kennewick city, Washington,1,2010,74455,42.60,70.50,9.90,36883,37572,55313,1115,1678,648,115,55361,19094
53,35415,5335415,Kent city, Washington,1,2010,92722,45.90,73.20,9.20,42865,49857,58844,7956,15312,638,2044,76456,16266
53,70000,5370000,Tacoma city, Washington,1,2010,198506,42.60,77.20,12.80,94236,104270,135145,22242,16343,2092,4102,177453,21053
53,63000,5363000,Seattle city, Washington,1,2010,610710,51.10,84.40,10.30,302316,308394,426223,49351,89475,5317,2841,573849,36861
53,67000,5367000,Spokane city, Washington,1,2010,209334,42.60,78.20,14.30,98976,110358,180843,6386,5828,3681,189,198320,11014
53,67167,5367167,Spokane Valley city, Washington,1,2010,89927,38.20,76.20,14.10,44407,45520,82913,386,1213,391,178,85634,4293
53,74060,5374060,Vancouver city, Washington,1,2010,162430,41.00,75.40,12.60,78100,84330,135664,4973,6791,1058,1762,146822,15608
53,80010,5380010,Yakima city, Washington,1,2010,91525,39.30,70.70,14.50,44964,46561,59381,912,580,2348,45,52627,38898
55,02375,5502375,Appleton city, Wisconsin,1,2010,71747,40.90,73.20,10.50,35192,36555,65231,141,3789,230,0,68603,3144
55,22300,5522300,Eau Claire city, Wisconsin,0,2010,65489,50.60,80.50,10.70,31857,33632,-998,-998,-998,-998,-998,64003,1486
55,31000,5531000,Green Bay city, Wisconsin,1,2010,104266,42.80,73.40,11.10,51805,52461,86044,2878,3574,3894,0,91692,12574
55,39225,5539225,Kenosha city, Wisconsin,1,2010,99362,44.00,73.80,11.00,47633,51729,81273,9534,1753,157,0,84742,14620
55,48000,5548000,Madison city, Wisconsin,1,2010,233777,53.60,82.00,9.30,115744,118033,188677,18063,16738,645,0,219715,14062
55,53000,5553000,Milwaukee city, Wisconsin,1,2010,595587,46.60,73.40,9.00,286670,308917,276773,233056,23229,2633,405,490968,104619
55,60500,5560500,Oshkosh city, Wisconsin,0,2010,66110,51.60,80.10,11.40,34790,31320,60454,2741,990,786,0,63340,2770
55,66000,5566000,Racine city, Wisconsin,1,2010,78906,42.70,71.00,11.10,38342,40564,50514,14472,418,123,0,62270,16636
55,84250,5584250,Waukesha city, Wisconsin,1,2010,70741,45.40,77.00,8.60,34332,36409,63602,1123,2488,0,0,63278,7463
72,10334,7210334,Caguas zona urbana, Puerto Rico,0,2010,81589,39.10,76.60,17.40,35280,46309,61829,4621,87,0,0,667,80922
72,14290,7214290,Carolina zona urbana, Puerto Rico,0,2010,160324,40.10,77.10,16.50,73458,86866,107516,22365,2510,707,0,2897,157427
72,32522,7232522,Guaynabo zona urbana, Puerto Rico,0,2010,72315,38.90,79.10,16.30,33456,38859,53519,6076,0,232,0,1204,71111
72,63820,7263820,Ponce zona urbana, Puerto Rico,0,2010,134788,39.20,75.30,16.20,62871,71917,93637,5637,129,0,0,861,133927
72,76770,7276770,San Juan zona urbana, Puerto Rico,0,2010,382900,40.00,78.60,17.10,175308,207592,229914,70821,5851,782,0,8856,374044
72,52431,7252431,Mayagüez zona urbana, Puerto Rico,0,2010,71129,43.10,79.40,18.40,33331,37798,36084,2980,357,0,0,1453,69676
72,06593,7206593,Bayamón zona urbana, Puerto Rico,0,2010,187219,40.20,77.50,16.80,88240,98979,106310,20964,773,276,0,2483,184736
32,60600,3260600,Reno city, Nevada,1,2011,227509,43.80,77.10,12.10,117029,110480,171546,7905,13114,2055,1828,169911,57598
32,68400,3268400,Sparks city, Nevada,1,2011,91202,38.90,75.90,13.70,46436,44766,68663,2138,5401,1876,708,66029,25173
32,68585,3268585,Spring Valley CDP, Nevada,0,2011,191336,49.20,78.90,10.10,94592,96744,124842,16892,31343,732,1416,145723,45613
32,71400,3271400,Sunrise Manor CDP, Nevada,0,2011,181940,44.10,70.60,8.80,92688,89252,107767,21225,10148,1493,216,90611,91329
33,45140,3345140,Manchester city, New Hampshire,1,2011,109835,44.10,79.50,12.20,56156,53679,95486,4969,3752,307,27,100225,9610
33,50260,3350260,Nashua city, New Hampshire,1,2011,86702,38.50,77.70,12.70,42164,44538,73355,2383,5563,49,0,77695,9007
34,10000,3410000,Camden city, New Jersey,1,2011,77277,45.60,71.00,9.30,35903,41374,12427,34172,1251,124,47,38975,38302
34,13690,3413690,Clifton city, New Jersey,1,2011,84262,43.30,77.80,13.80,43398,40864,61141,4729,7460,300,242,56531,27731
34,19390,3419390,East Orange city, New Jersey,0,2011,64363,44.00,77.00,13.00,25046,39317,2945,58046,673,0,0,61002,3361
34,21000,3421000,Elizabeth city, New Jersey,1,2011,125662,45.80,72.60,9.80,61108,64554,52603,25087,3197,134,610,46499,79163
34,36000,3436000,Jersey City city, New Jersey,1,2011,250317,51.50,80.40,9.70,125168,125149,86009,62893,62771,1233,51,180757,69560
34,51000,3451000,Newark city, New Jersey,1,2011,277545,47.60,74.00,7.80,140926,136619,77546,142195,4318,792,108,185843,91702
34,56550,3456550,Passaic city, New Jersey,1,2011,69906,45.00,68.70,7.50,35008,34898,28302,5700,2922,787,0,17834,52072
34,57000,3457000,Paterson city, New Jersey,1,2011,146426,44.70,71.50,8.60,68561,77865,74676,45883,5192,451,83,63616,82810
34,73110,3473110,Toms River CDP, New Jersey,0,2011,89032,38.80,79.30,16.30,42823,46209,81047,1107,4440,159,0,80617,8415
34,74000,3474000,Trenton city, New Jersey,1,2011,84912,46.10,74.20,7.90,42710,42202,22752,45552,369,137,0,56409,28503
34,74630,3474630,Union City city, New Jersey,1,2011,67176,46.70,74.30,9.70,34536,32640,48195,1414,1190,120,0,9051,58125
35,02000,3502000,Albuquerque city, New Mexico,1,2011,552801,42.20,76.30,12.30,268747,284054,380518,18881,11796,25328,558,293192,259609
35,39380,3539380,Las Cruces city, New Mexico,1,2011,99661,45.60,76.40,13.00,48914,50747,89495,2812,1584,1021,3,41485,58176
35,63460,3563460,Rio Rancho city, New Mexico,1,2011,89214,38.80,72.00,11.20,44257,44957,72163,5913,1693,1040,0,54088,35126
35,70500,3570500,Santa Fe city, New Mexico,1,2011,68634,36.10,80.00,18.20,32210,36424,57874,770,1990,1021,0,36150,32484
36,01000,3601000,Albany city, New York,1,2011,97664,51.70,82.50,12.10,46115,51549,54083,31363,5853,352,0,90200,7464
36,11000,3611000,Buffalo city, New York,1,2011,261004,44.70,77.20,11.10,124748,136256,131274,96909,8238,1317,62,234640,26364
36,15000,3615000,Cheektowaga CDP, New York,0,2011,76902,39.50,81.30,17.50,35494,41408,66346,7650,1293,380,0,74433,2469
36,49121,3649121,Mount Vernon city, New York,1,2011,67789,42.90,74.70,12.00,29821,37968,14954,41254,1431,154,0,56622,11167
36,50617,3650617,New Rochelle city, New York,1,2011,77591,37.30,78.40,15.90,37837,39754,51557,14446,3265,140,0,59607,17984
36,51000,3651000,New York city, New York,1,2011,8244910,45.20,78.50,12.30,3925290,4319620,3618421,2054101,1051946,27390,4321,5871606,2373304
36,63000,3663000,Rochester city, New York,1,2011,210850,46.80,75.20,8.80,101831,109019,94135,84858,6412,1169,61,174656,36194
36,65508,3665508,Schenectady city, New York,1,2011,66276,44.10,75.20,12.30,32897,33379,42510,13822,3226,64,0,58233,8043
36,73000,3673000,Syracuse city, New York,1,2011,145150,47.30,77.60,11.20,68475,76675,82693,41500,8772,1773,33,134924,10226
36,84000,3684000,Yonkers city, New York,1,2011,197397,41.30,77.80,14.30,95733,101664,108837,36630,13340,415,0,127478,69919
37,02140,3702140,Asheville city, North Carolina,1,2011,84458,42.60,79.60,15.10,38771,45687,68767,10998,1576,631,66,78429,6029
37,10740,3710740,Cary town, North Carolina,1,2011,138926,41.40,73.60,10.10,68426,70500,98871,10413,20246,943,0,124810,14116
37,12000,3712000,Charlotte city, North Carolina,1,2011,751074,46.60,74.70,9.00,360553,390521,405266,256410,37653,2238,349,651216,99858
37,14100,3714100,Concord city, North Carolina,1,2011,80604,41.20,72.60,10.40,38397,42207,58697,15488,2597,473,0,71403,9201
37,19000,3719000,Durham city, North Carolina,1,2011,233210,47.80,76.90,9.10,109615,123595,113206,94775,10877,1292,0,200535,32675
37,22920,3722920,Fayetteville city, North Carolina,1,2011,203922,46.20,73.50,9.90,99206,104716,98577,83083,6923,1731,1171,182790,21132
37,25580,3725580,Gastonia city, North Carolina,1,2011,72061,41.80,74.30,11.80,34304,37757,42042,19445,615,512,0,61508,10553
37,28000,3728000,Greensboro city, North Carolina,1,2011,273419,46.10,78.00,11.40,127597,145822,136542,112753,9596,1468,306,253442,19977
37,28080,3728080,Greenville city, North Carolina,1,2011,86024,60.40,82.40,7.30,37671,48353,48771,30733,2822,621,0,82684,3340
37,31400,3731400,High Point city, North Carolina,1,2011,107089,42.80,74.70,11.50,49791,57298,62496,31501,8466,286,0,95872,11217
37,34200,3734200,Jacksonville city, North Carolina,1,2011,70797,61.10,75.40,5.80,42010,28787,47184,17677,949,503,396,60886,9911
37,55000,3755000,Raleigh city, North Carolina,1,2011,416126,51.00,76.20,7.90,201006,215120,253036,129952,13883,425,0,369502,46624
37,74440,3774440,Wilmington city, North Carolina,1,2011,108305,47.20,81.40,13.60,51343,56962,77803,26378,1042,476,77,102961,5344
37,75000,3775000,Winston-Salem city, North Carolina,1,2011,232397,41.80,75.70,13.50,108495,123902,140383,80196,4372,544,0,196209,36188
38,25700,3825700,Fargo city, North Dakota,1,2011,107325,51.30,80.10,9.40,50950,56375,96519,2651,3056,2112,0,104130,3195
39,01000,3901000,Akron city, Ohio,1,2011,198415,41.90,77.60,12.60,94249,104166,121675,62416,4735,1001,0,194221,4194
39,12000,3912000,Canton city, Ohio,1,2011,72925,38.50,72.30,12.30,32834,40091,-998,-998,-998,-998,-998,71242,1683
39,15000,3915000,Cincinnati city, Ohio,1,2011,296236,44.70,77.80,11.50,139314,156922,147940,131806,6440,465,0,287979,8257
39,16000,3916000,Cleveland city, Ohio,1,2011,393804,41.00,77.70,12.60,188327,205477,162831,203289,5805,1130,256,356130,37674
39,18000,3918000,Columbus city, Ohio,1,2011,796014,49.00,76.70,8.90,388935,407079,495089,220045,31297,1885,73,752364,43650
39,21000,3921000,Dayton city, Ohio,1,2011,142154,45.10,78.90,13.10,68962,73192,77090,57300,1711,684,0,137258,4896
39,44856,3944856,Lorain city, Ohio,0,2011,64155,35.60,74.50,14.90,31131,33024,45379,9019,525,174,105,48193,15962
39,61000,3961000,Parma city, Ohio,1,2011,80980,38.60,77.30,16.80,39436,41544,74937,1198,1585,28,0,76591,4389
39,77000,3977000,Toledo city, Ohio,1,2011,286033,42.10,75.90,12.60,139578,146455,184418,75953,3148,783,79,265252,20781
39,88000,3988000,Youngstown city, Ohio,1,2011,66545,37.50,79.00,16.20,32136,34409,32491,30024,499,265,0,60890,5655
40,09050,4009050,Broken Arrow city, Oklahoma,1,2011,103118,38.70,73.80,11.00,51007,52111,79269,6376,3342,4504,170,96677,6441
40,23200,4023200,Edmond city, Oklahoma,1,2011,82961,40.90,76.30,12.00,41532,41429,68414,5453,2436,1649,0,76870,6091
40,41850,4041850,Lawton city, Oklahoma,1,2011,98180,48.10,74.80,10.40,50018,48162,59233,20479,2854,3526,87,84661,13519
40,52500,4052500,Norman city, Oklahoma,1,2011,113274,52.30,80.40,10.80,55487,57787,90063,5757,3492,5085,35,106353,6921
40,55000,4055000,Oklahoma City city, Oklahoma,1,2011,591912,42.50,74.20,11.00,293977,297935,399643,86804,24302,20532,752,488572,103340
40,75000,4075000,Tulsa city, Oklahoma,1,2011,396039,41.70,75.60,12.30,191456,204583,267336,59529,9186,17605,369,337780,58259
41,05350,4105350,Beaverton city, Oregon,1,2011,91641,46.20,75.20,10.20,43121,48520,63993,3646,11412,299,553,77316,14325
41,05800,4105800,Bend city, Oregon,1,2011,77907,39.60,80.00,15.70,38954,38953,68659,383,1728,183,532,70649,7258
41,23850,4123850,Eugene city, Oregon,1,2011,156921,50.00,82.20,13.40,77287,79634,137625,1237,6009,2715,213,144421,12500
41,31250,4131250,Gresham city, Oregon,1,2011,107439,40.10,73.70,11.30,51565,55874,86825,2828,4017,691,3429,89189,18250
41,34100,4134100,Hillsboro city, Oregon,1,2011,93452,49.20,75.10,7.70,45342,48110,65815,1166,6949,2713,1929,69308,24144
41,47000,4147000,Medford city, Oregon,1,2011,75509,41.80,78.30,15.50,36433,39076,69193,693,1127,586,567,66679,8830
41,59000,4159000,Portland city, Oregon,1,2011,595325,48.10,80.50,10.20,295365,299960,459255,38559,45977,5184,1254,535024,60301
41,64900,4164900,Salem city, Oregon,1,2011,156265,40.50,73.30,12.70,76298,79967,121717,2724,4728,1662,1224,126187,30078
42,02000,4202000,Allentown city, Pennsylvania,1,2011,119142,43.60,73.30,11.30,56847,62295,81372,15492,2653,0,0,68937,50205
42,06088,4206088,Bethlehem city, Pennsylvania,1,2011,76124,44.70,79.80,15.50,37042,39082,60609,4533,1636,159,0,57256,18868
42,24000,4224000,Erie city, Pennsylvania,1,2011,101791,42.30,77.40,12.80,49119,52672,77860,15831,2058,489,0,94392,7399
42,60000,4260000,Philadelphia city, Pennsylvania,1,2011,1536471,45.50,77.50,12.10,725192,811279,643228,651692,99154,2814,478,1342937,193534
42,61000,4261000,Pittsburgh city, Pennsylvania,1,2011,307498,47.50,83.40,14.40,149140,158358,201448,81062,14404,581,136,300186,7312
42,63624,4263624,Reading city, Pennsylvania,1,2011,88422,43.00,70.00,10.50,42072,46350,46171,11874,479,197,29,36755,51667
42,69000,4269000,Scranton city, Pennsylvania,1,2011,75995,40.60,80.70,17.00,35072,40923,65497,5076,2254,22,0,69682,6313
44,19180,4419180,Cranston city, Rhode Island,1,2011,80401,39.30,78.60,14.90,40759,39642,64272,5061,3203,1262,0,70171,10230
44,54640,4454640,Pawtucket city, Rhode Island,1,2011,71151,39.40,76.80,13.60,35325,35826,47539,10025,1814,162,0,56882,14269
44,59000,4459000,Providence city, Rhode Island,1,2011,178059,52.60,77.40,8.70,85247,92812,91939,27329,10760,1889,172,109000,69059
44,74300,4474300,Warwick city, Rhode Island,1,2011,82354,37.20,80.00,16.60,39094,43260,75661,1386,2221,57,0,78696,3658
45,13330,4513330,Charleston city, South Carolina,1,2011,123240,50.10,81.30,11.40,56593,66647,81797,36299,2120,236,404,119680,3560
45,16000,4516000,Columbia city, South Carolina,1,2011,130092,57.20,84.70,10.40,66780,63312,65883,54037,2590,214,7,122824,7268
45,48535,4548535,Mount Pleasant town, South Carolina,1,2011,69353,40.40,73.70,13.90,34025,35328,-998,-998,-998,-998,-998,67587,1766
45,50875,4550875,North Charleston city, South Carolina,1,2011,101478,46.70,76.00,8.20,50141,51337,49088,45617,2528,678,0,93165,8313
45,61405,4561405,Rock Hill city, South Carolina,1,2011,67411,49.70,75.80,9.50,30428,36983,38858,24389,775,200,0,62557,4854
46,52980,4652980,Rapid City city, South Dakota,1,2011,69202,38.40,74.90,14.80,33012,36190,55216,505,291,8124,46,66362,2840
46,59020,4659020,Sioux Falls city, South Dakota,1,2011,156284,43.80,75.80,11.50,77106,79178,136091,6810,2869,3689,0,149208,7076
47,14000,4714000,Chattanooga city, Tennessee,1,2011,170136,40.90,78.40,15.00,81028,89108,97766,59884,3862,809,86,159285,10851
47,15160,4715160,Clarksville city, Tennessee,1,2011,136237,49.50,73.40,8.70,65632,70605,90295,31571,3049,2000,667,122867,13370
47,37640,4737640,Jackson city, Tennessee,0,2011,65189,41.00,74.80,13.00,30457,34732,31533,30563,1135,36,76,61929,3260
47,40000,4740000,Knoxville city, Tennessee,1,2011,180753,48.20,81.70,13.20,89578,91175,140807,30213,2742,331,41,170615,10138
47,48000,4748000,Memphis city, Tennessee,1,2011,652078,44.20,75.00,10.40,310415,341663,193044,406606,13323,1180,0,604799,47279
47,51560,4751560,Murfreesboro city, Tennessee,1,2011,111337,50.90,80.30,10.60,55356,55981,87924,17082,2209,95,0,106139,5198
47,52006,4752006,Nashville-Davidson metropolitan government (balance), Tennessee,1,2011,609637,46.90,78.10,10.30,295606,314031,367204,173224,18054,1922,310,547815,61822
48,01000,4801000,Abilene city, Texas,1,2011,123471,46.30,78.30,12.20,63742,59729,100588,13207,2559,425,0,94743,28728
48,01924,4801924,Allen city, Texas,1,2011,87476,39.50,72.30,7.10,40460,47016,63446,5356,11477,377,81,77401,10075
48,03000,4803000,Amarillo city, Texas,1,2011,194701,41.30,72.90,12.20,95524,99177,160918,12498,6114,1265,286,136117,58584
48,04000,4804000,Arlington city, Texas,1,2011,373681,46.40,72.20,7.80,185705,187976,239090,74329,32228,1874,285,261659,112022
48,04462,4804462,Atascocita CDP, Texas,0,2011,72363,51.30,71.70,6.80,35648,36715,45648,19207,2147,0,0,59376,12987
48,05000,4805000,Austin city, Texas,1,2011,820601,53.00,78.00,7.00,414143,406458,576084,65132,52658,6387,243,522800,297801
48,06128,4806128,Baytown city, Texas,1,2011,71819,40.70,68.50,8.80,34546,37273,45722,15234,931,358,128,39771,32048
48,07000,4807000,Beaumont city, Texas,1,2011,118532,39.90,75.60,12.90,57119,61413,47198,57219,4487,120,104,102798,15734
48,10768,4810768,Brownsville city, Texas,1,2011,178448,40.70,66.30,10.30,85807,92641,159324,218,1768,470,0,11979,166469
48,10912,4810912,Bryan city, Texas,1,2011,77315,47.70,77.70,9.70,39321,37994,51658,14396,1727,158,0,47187,30128
48,13024,4813024,Carrollton city, Texas,1,2011,122656,43.50,76.70,9.60,61539,61117,85458,10901,15774,513,0,81772,40884
48,15976,4815976,College Station city, Texas,1,2011,95147,73.30,84.10,3.70,49685,45462,74586,5784,9060,0,0,83534,11613
48,17000,4817000,Corpus Christi city, Texas,1,2011,307954,40.90,74.10,11.60,150145,157809,265310,13712,5092,1752,85,122112,185842
48,19000,4819000,Dallas city, Texas,1,2011,1223378,46.20,73.50,8.90,613811,609567,693636,288824,31117,3821,213,686564,536814
48,19972,4819972,Denton city, Texas,1,2011,117177,56.80,80.40,8.10,56785,60392,87272,14125,5324,192,441,88768,28409
48,22660,4822660,Edinburg city, Texas,1,2011,79156,48.00,69.30,5.60,42222,36934,71248,1331,1779,0,0,8610,70546
48,24000,4824000,El Paso city, Texas,1,2011,665577,42.30,71.70,11.20,317490,348087,543742,20308,8712,2527,1164,131232,534345
48,26232,4826232,Flower Mound town, Texas,0,2011,67209,36.80,65.90,5.20,33010,34199,-998,-998,-998,-998,-998,64260,2949
48,27000,4827000,Fort Worth city, Texas,1,2011,760758,44.90,70.20,8.30,363677,397081,534458,135076,24996,9808,503,495739,265019
48,27684,4827684,Frisco city, Texas,1,2011,121389,47.90,65.80,4.90,61611,59778,95602,10540,8658,1058,0,108550,12839
48,29000,4829000,Garland city, Texas,1,2011,231596,42.90,68.50,9.50,114138,117458,95290,27537,24679,305,151,136155,95441
48,30464,4830464,Grand Prairie city, Texas,1,2011,179067,45.90,70.20,6.30,93436,85631,113883,36045,11316,1019,39,107016,72051
48,32372,4832372,Harlingen city, Texas,0,2011,66124,41.00,67.00,11.90,31964,34160,61962,1220,267,53,0,14006,52118
48,35000,4835000,Houston city, Texas,1,2011,2145933,46.40,74.30,9.10,1073270,1072663,1241459,494272,120373,7295,1375,1192419,953514
48,37000,4837000,Irving city, Texas,1,2011,220699,48.90,73.60,7.40,112389,108310,126072,29382,31677,745,26,133046,87653
48,39148,4839148,Killeen city, Texas,1,2011,130005,49.10,69.10,4.60,62007,67998,68116,38941,5323,1692,248,100527,29478
48,41464,4841464,Laredo city, Texas,1,2011,241350,44.20,65.70,8.30,116681,124669,224378,316,2344,1541,0,11642,229708
48,41980,4841980,League City city, Texas,1,2011,83999,40.80,69.70,8.00,42555,41444,68462,8491,4041,0,0,71451,12548
48,42508,4842508,Lewisville city, Texas,1,2011,98489,45.10,71.50,8.40,48103,50386,78433,4886,6260,0,0,64193,34296
48,43888,4843888,Longview city, Texas,1,2011,82278,42.40,73.70,14.30,40840,41438,59154,19148,1275,237,0,68091,14187
48,45000,4845000,Lubbock city, Texas,1,2011,233735,48.20,76.70,11.10,115582,118153,181677,18405,5800,1785,293,156267,77468
48,45384,4845384,McAllen city, Texas,1,2011,133756,44.30,71.80,11.90,64421,69335,119181,1675,3694,489,0,24627,109129
48,45744,4845744,McKinney city, Texas,1,2011,136073,42.80,68.70,6.60,66047,70026,105599,15532,9477,795,0,109634,26439
48,47892,4847892,Mesquite city, Texas,1,2011,142574,43.30,70.70,8.20,63971,78603,90732,36468,5695,564,0,99990,42584
48,48072,4848072,Midland city, Texas,1,2011,113928,41.70,72.80,11.70,54858,59070,93617,9901,2518,302,10,69982,43946
48,48768,4848768,Mission city, Texas,1,2011,79375,42.30,66.60,11.00,38142,41233,-998,-998,-998,-998,-998,8368,71007
48,48804,4848804,Missouri City city, Texas,1,2011,68776,36.30,71.90,10.70,32801,35975,24108,31108,10623,363,0,58846,9930
48,52356,4852356,North Richland Hills city, Texas,0,2011,64786,42.00,75.40,11.60,31370,33416,59042,2305,1047,210,0,53264,11522
48,53388,4853388,Odessa city, Texas,1,2011,102841,42.00,71.10,9.40,51856,50985,87648,6140,526,403,48,49805,53036
48,56000,4856000,Pasadena city, Texas,1,2011,152295,43.80,70.00,7.70,77152,75143,109354,4541,5381,2790,0,62002,90293
48,56348,4856348,Pearland city, Texas,1,2011,95644,40.40,70.90,9.40,46376,49268,62633,11041,14500,773,0,74229,21415
48,57200,4857200,Pharr city, Texas,1,2011,72513,46.30,66.30,8.80,34681,37832,-998,-998,-998,-998,-998,4567,67946
48,58016,4858016,Plano city, Texas,1,2011,271380,41.90,74.60,9.80,138001,133379,187349,19388,51580,851,209,235888,35492
48,61796,4861796,Richardson city, Texas,1,2011,101731,45.10,75.50,10.40,51919,49812,66137,4223,16711,208,974,80416,21315
48,63500,4863500,Round Rock city, Texas,1,2011,106128,45.40,69.90,4.60,49268,56860,84651,10728,4885,1023,0,72267,33861
48,64472,4864472,San Angelo city, Texas,1,2011,95818,43.40,76.10,13.60,47033,48785,81477,5130,1089,723,0,58982,36836
48,65000,4865000,San Antonio city, Texas,1,2011,1359730,43.80,73.60,10.80,660182,699548,1028684,92378,26871,8113,1346,509384,850346
48,70808,4870808,Sugar Land city, Texas,1,2011,81698,36.10,75.70,10.40,39716,41982,42429,6321,27807,266,0,68999,12699
01,37000,0137000,Huntsville city, Alabama,1,2011,182354,41.30,78.60,14.10,87509,94845,114080,55038,3313,1070,28,170714,11640
01,07000,0107000,Birmingham city, Alabama,1,2011,211458,41.30,78.70,13.20,96988,114470,50140,156177,2594,751,0,206136,5322
01,21184,0121184,Dothan city, Alabama,0,2011,66384,38.80,76.20,15.20,31562,34822,42748,20539,652,285,17,64766,1618
01,35896,0135896,Hoover city, Alabama,1,2011,80553,39.30,76.50,12.00,38826,41727,59020,7241,5355,525,0,72434,8119
01,50000,0150000,Mobile city, Alabama,1,2011,194887,42.10,76.50,13.50,93181,101706,89656,98966,2286,302,112,189599,5288
01,51000,0151000,Montgomery city, Alabama,1,2011,213132,43.50,74.80,11.90,99465,113667,83403,120140,4839,1045,0,204979,8153
01,77256,0177256,Tuscaloosa city, Alabama,1,2011,91604,57.00,84.20,11.30,40897,50707,-998,-998,-998,-998,-998,87926,3678
02,03000,0203000,Anchorage municipality, Alaska,1,2011,295570,45.00,74.30,7.70,148299,147271,196444,16294,23872,19194,6145,272295,23275
04,04720,0404720,Avondale city, Arizona,1,2011,77526,50.00,67.40,6.10,36926,40600,-998,-998,-998,-998,-998,33738,43788
04,10670,0410670,Casas Adobes CDP, Arizona,0,2011,67496,37.00,78.90,17.30,31751,35745,61269,874,2104,233,58,55687,11809
04,12000,0412000,Chandler city, Arizona,1,2011,240098,43.60,72.10,7.60,119460,120638,195297,13698,15075,2797,262,184261,55837
04,23620,0423620,Flagstaff city, Arizona,0,2011,65904,56.20,78.40,6.40,32208,33696,46911,1242,1241,8112,42,53359,12545
04,27400,0427400,Gilbert town, Arizona,1,2011,211964,44.80,65.80,6.10,105466,106498,180564,6630,15131,1278,219,168587,43377
04,27820,0427820,Glendale city, Arizona,1,2011,230466,45.10,74.40,8.90,115974,114492,174808,9681,8234,1303,0,145276,85190
04,28380,0428380,Goodyear city, Arizona,0,2011,66312,38.50,81.00,18.00,33299,33013,52616,6860,3349,340,0,51505,14807
04,46000,0446000,Mesa city, Arizona,1,2011,446498,40.10,75.00,14.40,219468,227030,362570,21188,7929,9764,2270,331357,115141
04,54050,0454050,Peoria city, Arizona,1,2011,156634,38.60,76.60,13.60,76777,79857,138662,5275,4179,1288,0,129957,26677
04,55000,0455000,Phoenix city, Arizona,1,2011,1469484,44.80,72.40,8.60,739978,729506,1147215,94911,49531,29628,3030,878340,591144
04,64210,0464210,San Tan Valley CDP, Arizona,0,2011,83217,47.50,64.20,3.70,44261,38956,63801,5012,0,4226,0,66329,16888
04,65000,0465000,Scottsdale city, Arizona,1,2011,221007,33.90,82.90,23.40,103935,117072,198187,3354,8140,3028,0,198609,22398
04,71510,0471510,Surprise city, Arizona,1,2011,119494,38.30,65.80,16.40,57023,62471,-998,-998,-998,-998,-998,95962,23532
04,73000,0473000,Tempe city, Arizona,1,2011,164264,56.80,81.10,7.40,82935,81329,127556,10375,11790,1759,1388,130333,33931
04,77000,0477000,Tucson city, Arizona,1,2011,525798,44.90,77.70,12.00,262747,263051,403863,27174,14131,10484,735,303709,222089
04,85540,0485540,Yuma city, Arizona,1,2011,94543,44.80,71.70,13.60,47399,47144,66309,2910,1842,1096,54,40997,53546
05,23290,0523290,Fayetteville city, Arkansas,1,2011,75109,58.10,83.10,8.70,38204,36905,63458,3887,3710,1089,52,71507,3602
05,24550,0524550,Fort Smith city, Arkansas,1,2011,87146,39.10,74.70,12.80,43404,43742,67868,7431,4747,608,227,72691,14455
05,35710,0535710,Jonesboro city, Arkansas,1,2011,68541,46.40,74.50,11.00,33333,35208,-998,-998,-998,-998,-998,66078,2463
05,41000,0541000,Little Rock city, Arkansas,1,2011,195310,42.30,76.40,11.60,90708,104602,96447,86184,6046,277,108,185256,10054
05,66080,0566080,Springdale city, Arkansas,1,2011,73153,40.90,67.10,9.30,37320,35833,46331,1490,1184,1530,5224,44662,28491
06,00562,0600562,Alameda city, California,1,2011,74770,41.10,80.40,12.20,37167,37603,37530,6044,23652,86,29,65381,9389
06,00884,0600884,Alhambra city, California,1,2011,83703,40.00,81.70,14.00,39846,43857,23363,1403,44697,167,178,57486,26217
06,02000,0602000,Anaheim city, California,1,2011,341348,45.10,73.30,10.00,171201,170147,214952,9183,51707,1457,640,156853,184495
06,02252,0602252,Antioch city, California,1,2011,104027,42.20,74.90,8.40,49606,54421,60651,15737,7520,719,269,71246,32781
06,02364,0602364,Apple Valley town, California,1,2011,70173,37.40,72.20,13.70,32728,37445,57299,5502,1892,250,0,50993,19180
06,02553,0602553,Arden-Arcade CDP, California,0,2011,91977,37.00,78.50,15.30,44897,47080,67360,6405,6206,1005,53,75981,15996
06,03526,0603526,Bakersfield city, California,1,2011,352429,44.20,68.90,8.10,176625,175804,248289,28606,24328,3936,927,189935,162494
06,03666,0603666,Baldwin Park city, California,1,2011,75937,49.10,71.90,8.30,37372,38565,29162,545,14034,593,58,16554,59383
06,04982,0604982,Bellflower city, California,1,2011,77179,45.80,68.00,6.90,35942,41237,29837,12929,7071,223,589,35571,41608
06,06000,0606000,Berkeley city, California,1,2011,113893,54.30,87.50,13.90,56611,57282,73164,9894,22126,240,196,102714,11179
06,08786,0608786,Buena Park city, California,1,2011,81754,43.60,75.00,12.40,40679,41075,48000,4106,22202,49,535,51176,30578
06,08954,0608954,Burbank city, California,1,2011,104096,44.20,79.10,13.90,48478,55618,77361,1163,13130,87,24,74772,29324
06,10046,0610046,Camarillo city, California,0,2011,65904,37.60,73.10,15.30,31558,34346,49198,830,4952,195,182,47775,18129
06,11194,0611194,Carlsbad city, California,1,2011,106895,37.40,76.50,16.00,54052,52843,91253,359,8522,524,0,91899,14996
06,11530,0611530,Carson city, California,1,2011,92387,40.80,77.10,13.80,43546,48841,31468,18492,19833,359,1471,52983,39404
06,13014,0613014,Chico city, California,1,2011,86287,50.60,80.40,11.20,41147,45140,70255,2194,2701,615,75,71589,14698
06,13210,0613210,Chino city, California,1,2011,79061,47.30,74.70,10.40,40100,38961,46574,4133,12094,861,148,41619,37442
06,13214,0613214,Chino Hills city, California,1,2011,75931,40.50,71.70,6.60,39449,36482,44559,3156,19447,358,178,50451,25480
06,13392,0613392,Chula Vista city, California,1,2011,247514,44.50,73.60,10.10,118413,129101,163601,9768,39608,2114,584,105193,142321
06,13588,0613588,Citrus Heights city, California,1,2011,84342,41.20,76.60,11.30,39262,45080,64186,2103,2106,1043,2442,68087,16255
06,14218,0614218,Clovis city, California,1,2011,96909,40.10,72.00,10.10,46057,50852,66742,1963,12007,1187,54,72809,24100
06,15044,0615044,Compton city, California,1,2011,97166,45.30,68.20,7.80,46630,50536,39525,28295,555,0,288,31755,65411
06,16000,0616000,Concord city, California,1,2011,124059,41.80,76.40,11.50,63511,60548,85916,3911,16319,983,1473,89624,34435
06,16350,0616350,Corona city, California,1,2011,155884,45.40,71.10,7.50,77945,77939,107921,9741,17967,753,2373,93861,62023
06,16532,0616532,Costa Mesa city, California,1,2011,111603,48.10,78.90,9.50,53111,58492,75935,1428,8532,126,230,74818,36785
06,17918,0617918,Daly City city, California,1,2011,102368,44.10,80.80,13.90,53270,49098,23757,2951,62551,326,109,81329,21039
06,18100,0618100,Davis city, California,0,2011,66011,58.30,84.40,8.20,32276,33735,39274,1206,15613,451,254,56653,9358
06,19766,0619766,Downey city, California,1,2011,112578,43.60,73.20,9.80,56342,56236,74346,4398,5654,181,0,32065,80513
06,20802,0620802,East Los Angeles CDP, California,0,2011,131741,49.50,70.40,8.30,67452,64289,78336,1043,810,488,0,2900,128841
06,21712,0621712,El Cajon city, California,1,2011,100931,43.10,74.80,12.40,49631,51300,86238,3888,2105,290,695,73836,27095
06,22020,0622020,Elk Grove city, California,1,2011,154920,42.20,72.80,10.30,75207,79713,75547,17186,36178,383,1235,125090,29830
06,22230,0622230,El Monte city, California,1,2011,114294,46.70,73.90,10.70,56803,57491,59758,1007,29588,498,0,34646,79648
06,22804,0622804,Escondido city, California,1,2011,146021,45.60,73.80,8.70,74701,71320,120742,3320,9247,388,130,72324,73697
06,23182,0623182,Fairfield city, California,1,2011,106116,45.60,73.00,10.40,50467,55649,47394,19159,18445,314,1316,79144,26972
06,24477,0624477,Florence-Graham CDP, California,0,2011,68626,49.00,64.50,5.70,33098,35528,49622,4426,53,257,0,4786,63840
06,24638,0624638,Folsom city, California,1,2011,72991,44.20,77.10,7.80,40563,32428,54934,2937,7396,90,112,60244,12747
06,24680,0624680,Fontana city, California,1,2011,199024,47.60,70.40,6.40,100883,98141,127543,16583,10410,640,42,62546,136478
06,26000,0626000,Fremont city, California,1,2011,216912,42.30,74.60,10.40,108853,108059,66993,8247,105587,1291,600,178897,38015
06,27000,0627000,Fresno city, California,1,2011,501365,45.00,70.30,9.20,249398,251967,249032,35612,63800,4221,1561,257031,244334
06,28000,0628000,Fullerton city, California,1,2011,137174,42.70,75.50,13.00,65777,71397,75831,2718,32675,730,150,89934,47240
06,29000,0629000,Garden Grove city, California,1,2011,173490,44.50,74.80,9.90,88141,85349,81697,3308,70470,872,1894,112380,61110
06,30000,0630000,Glendale city, California,1,2011,193113,38.80,81.60,15.90,92185,100928,152920,1640,29563,846,52,158555,34558
06,32548,0632548,Hawthorne city, California,1,2011,84897,49.60,71.20,6.60,39003,45894,49766,21299,3435,243,1047,37038,47859
06,33000,0633000,Hayward city, California,1,2011,146083,45.20,76.70,9.40,71031,75052,57244,15970,33303,349,6321,87393,58690
06,33182,0633182,Hemet city, California,1,2011,80459,32.90,76.80,25.60,39058,41401,57209,4550,2091,671,79,51249,29210
06,33434,0633434,Hesperia city, California,1,2011,91549,39.00,67.30,9.30,47982,43567,59072,8980,1417,1903,130,51445,40104
06,36000,0636000,Huntington Beach city, California,1,2011,192868,38.70,81.50,15.70,94760,98108,148558,1615,20876,1570,293,157539,35329
06,39496,0639496,Lake Forest city, California,1,2011,78460,42.00,74.40,9.40,37220,41240,48307,1401,15025,130,536,60621,17839
06,36448,0636448,Indio city, California,1,2011,77789,38.70,69.20,13.60,36229,41560,46924,951,1207,1380,0,24615,53174
06,36546,0636546,Inglewood city, California,1,2011,110463,42.90,72.40,9.70,51575,58888,34098,48324,2578,548,224,55181,55282
06,36770,0636770,Irvine city, California,1,2011,215511,48.60,77.00,7.30,104508,111003,114571,3780,79380,1305,286,193148,22363
06,39892,0639892,Lakewood city, California,1,2011,80648,41.90,77.00,11.30,38477,42171,40753,5783,12449,374,525,51809,28839
06,40130,0640130,Lancaster city, California,1,2011,157698,43.40,71.30,7.80,81658,76040,100799,30153,6790,855,192,94826,62872
06,41992,0641992,Livermore city, California,1,2011,82056,39.20,75.00,11.00,43818,38238,65197,1764,10502,21,131,69664,12392
06,43000,0643000,Long Beach city, California,1,2011,465584,46.20,74.80,9.30,227873,237711,243830,65958,54359,2518,4812,275878,189706
06,44000,0644000,Los Angeles city, California,1,2011,3819708,47.00,77.60,10.70,1900599,1919109,2043821,353111,442855,19263,7091,1968304,1851404
06,44574,0644574,Lynwood city, California,1,2011,70259,48.90,67.40,6.60,34640,35619,22311,5295,520,428,0,6367,63892
06,45484,0645484,Manteca city, California,1,2011,68254,40.30,68.20,9.90,33372,34882,49180,3183,4390,352,607,43573,24681
06,46842,0646842,Menifee city, California,1,2011,79321,36.90,78.20,17.80,40477,38844,62313,2907,7478,306,177,60803,18518
06,46898,0646898,Merced city, California,1,2011,80234,48.60,69.70,8.70,38833,41401,50049,4980,10732,778,91,40858,39376
06,47766,0647766,Milpitas city, California,1,2011,67811,43.70,78.20,9.80,35288,32523,14596,2254,41309,525,655,56481,11330
06,48256,0648256,Mission Viejo city, California,1,2011,94714,37.90,78.70,14.80,47016,47698,77728,1166,7961,202,37,77650,17064
06,48354,0648354,Modesto city, California,1,2011,202761,41.00,72.80,12.10,97439,105322,151965,8486,14102,2760,1855,129144,73617
06,49270,0649270,Moreno Valley city, California,1,2011,197838,44.40,67.00,6.50,96136,101702,131461,36468,9451,2957,450,85778,112060
06,49670,0649670,Mountain View city, California,1,2011,75230,47.10,78.70,12.70,38705,36525,48279,1889,18470,187,391,58771,16459
06,50076,0650076,Murrieta city, California,1,2011,105847,41.70,69.50,9.90,48128,57719,73957,11631,3715,838,0,74876,30971
06,50258,0650258,Napa city, California,1,2011,77868,40.90,76.30,12.80,38845,39023,67766,483,2354,559,60,48075,29793
06,51182,0651182,Newport Beach city, California,1,2011,86485,36.30,80.50,18.70,44521,41964,73891,66,8079,113,0,79714,6771
06,52526,0652526,Norwalk city, California,1,2011,106308,47.10,73.30,9.10,55211,51097,39349,5929,13692,972,0,33729,72579
06,53000,0653000,Oakland city, California,1,2011,395811,44.90,79.10,11.90,188122,207689,161558,110837,70886,2827,1832,299080,96731
06,53322,0653322,Oceanside city, California,1,2011,169565,45.90,76.80,11.80,90537,79028,107148,9211,13627,1235,3595,109977,59588
06,53896,0653896,Ontario city, California,1,2011,166412,48.10,71.10,6.30,75664,90748,103162,10084,6889,680,0,44660,121752
06,53980,0653980,Orange city, California,1,2011,138405,45.20,77.70,11.40,70211,68194,87129,1527,17361,681,0,85833,52572
06,54652,0654652,Oxnard city, California,1,2011,199917,46.80,70.10,7.20,101034,98883,140722,6689,14656,1212,36,52105,147812
06,55156,0655156,Palmdale city, California,1,2011,153874,45.60,66.80,5.90,75091,78783,61745,22183,7995,351,20,70381,83493
06,55282,0655282,Palo Alto city, California,0,2011,65419,41.60,77.40,16.60,33121,32298,44240,1914,14893,357,0,59372,6047
06,56000,0656000,Pasadena city, California,1,2011,138086,46.00,81.50,13.90,70015,68071,89368,13715,25437,534,0,93869,44217
06,56700,0656700,Perris city, California,1,2011,69973,44.80,58.80,3.70,33138,36835,31059,8255,2579,1712,0,17532,52441
06,57456,0657456,Pittsburg city, California,0,2011,64307,46.80,76.30,8.80,31250,33057,23570,10526,10192,103,891,37102,27205
06,57792,0657792,Pleasanton city, California,1,2011,71206,36.70,74.70,11.60,36333,34873,51144,1791,15511,0,0,63509,7697
06,58072,0658072,Pomona city, California,1,2011,150126,47.20,73.00,9.10,76026,74100,93498,12377,12248,1209,0,47075,103051
06,59444,0659444,Rancho Cordova city, California,0,2011,65614,45.10,73.10,11.00,31940,33674,40174,8099,6788,437,111,53765,11849
06,59451,0659451,Rancho Cucamonga city, California,1,2011,167698,47.40,75.80,9.90,86382,81316,109393,13777,17736,1195,456,111956,55742
06,59920,0659920,Redding city, California,1,2011,90142,38.30,76.70,16.20,44306,45836,77652,1419,1535,1723,241,82443,7699
06,59962,0659962,Redlands city, California,1,2011,69744,41.80,77.50,13.20,34079,35665,49073,3274,5199,383,397,50272,19472
06,60018,0660018,Redondo Beach city, California,1,2011,67231,42.80,79.50,11.00,31443,35788,52795,2408,7723,0,192,55442,11789
06,60102,0660102,Redwood City city, California,1,2011,77750,41.70,74.50,11.70,38283,39467,58465,1793,8379,301,72,49179,28571
06,60466,0660466,Rialto city, California,1,2011,100680,45.20,66.60,6.80,49115,51565,60447,11626,2764,198,1828,28380,72300
06,60620,0660620,Richmond city, California,1,2011,105389,42.70,73.60,9.10,52555,52834,50180,25975,12435,830,569,61701,43688
06,62000,0662000,Riverside city, California,1,2011,310654,47.30,73.60,9.50,155223,155431,205326,19896,23526,5218,515,149528,161126
06,62938,0662938,Roseville city, California,1,2011,121755,39.20,73.10,14.00,58375,63380,98550,1248,11256,610,273,104292,17463
06,64000,0664000,Sacramento city, California,1,2011,472169,44.60,74.40,11.00,232917,239252,228198,63119,99538,6491,5806,344579,127590
06,64224,0664224,Salinas city, California,1,2011,152995,46.40,68.20,7.80,77600,75395,111906,1559,9322,892,318,37496,115499
06,65000,0665000,San Bernardino city, California,1,2011,213008,45.30,68.30,7.50,105824,107184,110446,32316,9074,2540,115,88866,124142
06,65042,0665042,San Buenaventura (Ventura) city, California,1,2011,107507,41.30,79.00,13.40,55405,52102,87461,2745,4427,704,195,71218,36289
06,66000,0666000,San Diego city, California,1,2011,1326183,47.70,78.20,10.50,669251,656932,849647,94862,210468,5998,3934,923305,402878
06,67000,0667000,San Francisco city, California,1,2011,812826,48.80,86.60,13.80,412823,400003,408583,48564,272088,2791,3703,687577,125249
06,68000,0668000,San Jose city, California,1,2011,967478,44.10,75.90,10.40,486623,480855,457275,29661,320225,6935,4381,645984,321494
06,68084,0668084,San Leandro city, California,1,2011,86067,41.50,76.60,12.20,41248,44819,41995,12183,22676,364,780,58858,27209
06,68196,0668196,San Marcos city, California,1,2011,85009,47.10,71.90,11.00,40349,44660,63727,3525,9181,258,0,54005,31004
06,68252,0668252,San Mateo city, California,1,2011,98403,42.50,81.40,14.00,49666,48737,65723,2045,19017,184,3353,73100,25303
06,68378,0668378,San Ramon city, California,1,2011,73338,41.80,69.10,6.50,35285,38053,37305,2127,27407,657,375,63206,10132
06,69000,0669000,Santa Ana city, California,1,2011,329405,49.40,70.30,7.50,165622,163783,172283,4653,31739,1762,499,67640,261765
06,69070,0669070,Santa Barbara city, California,1,2011,89058,47.60,81.00,13.10,43436,45622,67392,1200,2560,245,117,50328,38730
06,69084,0669084,Santa Clara city, California,1,2011,118247,48.20,76.20,9.90,57833,60414,61387,3892,41837,617,414,90321,27926
06,69088,0669088,Santa Clarita city, California,1,2011,177589,42.40,72.40,9.40,89926,87663,127873,4681,17860,780,427,117363,60226
06,69196,0669196,Santa Maria city, California,1,2011,100272,44.40,68.40,9.20,50280,49992,79885,761,6905,1050,140,31832,68440
06,70000,0670000,Santa Monica city, California,1,2011,90373,50.70,86.90,14.50,42407,47966,73379,3489,8577,118,0,76888,13485
06,70098,0670098,Santa Rosa city, California,1,2011,169302,39.60,76.00,13.20,87823,81479,131948,4460,10038,1693,1107,122025,47277
06,72016,0672016,Simi Valley city, California,1,2011,125546,41.60,75.00,9.70,61975,63571,94485,1265,11991,1445,356,93546,32000
06,73080,0673080,South Gate city, California,1,2011,95088,45.20,70.40,8.40,46594,48494,42190,499,692,0,126,3494,91594
06,75000,0675000,Stockton city, California,1,2011,296367,44.00,69.40,9.10,144348,152019,139399,35629,62491,3044,1540,168301,128066
06,77000,0677000,Sunnyvale city, California,1,2011,142299,45.50,77.60,10.70,71005,71294,67323,1883,59279,116,0,113235,29064
06,78120,0678120,Temecula city, California,1,2011,102471,37.10,67.10,8.90,50201,52270,75786,2392,7010,3209,1329,73565,28906
06,78582,0678582,Thousand Oaks city, California,1,2011,127994,33.50,77.40,16.70,59103,68891,98234,2083,15204,114,104,105744,22250
06,80000,0680000,Torrance city, California,1,2011,146467,38.30,78.10,15.80,68454,78013,75635,4334,49891,266,360,120808,25659
06,80238,0680238,Tracy city, California,1,2011,84252,41.00,69.70,8.00,43949,40303,47942,8031,11403,438,907,53669,30583
06,80812,0680812,Turlock city, California,1,2011,69095,46.90,72.00,9.90,36047,33048,55487,1816,3918,739,627,42501,26594
06,80854,0680854,Tustin city, California,1,2011,76699,49.20,74.70,7.40,37907,38792,52215,857,16551,87,1221,50239,26460
06,81204,0681204,Union City city, California,1,2011,70441,43.40,76.50,11.90,34595,35846,14246,3670,38537,220,962,56178,14263
06,81344,0681344,Upland city, California,1,2011,74854,40.90,76.80,11.30,33220,41634,45085,2713,5336,951,261,46187,28667
06,81554,0681554,Vacaville city, California,1,2011,93076,43.90,77.70,10.40,49757,43319,60836,7766,4997,389,437,68162,24914
06,81666,0681666,Vallejo city, California,1,2011,116829,37.30,77.70,12.80,56206,60623,48005,24302,28845,1340,1408,87644,29185
06,82590,0682590,Victorville city, California,1,2011,117596,44.10,66.40,8.40,58956,58640,64235,11811,10343,865,67,57177,60419
06,82954,0682954,Visalia city, California,1,2011,126421,41.60,71.00,10.80,63478,62943,104880,3651,6792,1657,78,69797,56624
06,82996,0682996,Vista city, California,1,2011,95211,48.10,73.90,10.40,46730,48481,79926,3079,4264,419,273,49827,45384
06,83346,0683346,Walnut Creek city, California,0,2011,65232,31.60,83.20,27.10,30211,35021,48756,3731,9397,92,0,57843,7389
06,84200,0684200,West Covina city, California,1,2011,106864,40.80,75.40,12.60,50343,56521,43599,6575,26579,229,246,50697,56167
06,84550,0684550,Westminster city, California,1,2011,91078,38.30,78.20,15.40,44627,46451,30489,1259,40197,75,1687,68458,22620
06,85292,0685292,Whittier city, California,1,2011,85933,44.40,74.50,11.30,43071,42862,46505,1518,3366,1340,111,33629,52304
06,86832,0686832,Yorba Linda city, California,0,2011,65220,36.70,74.90,11.80,31615,33605,52246,656,9605,348,0,52417,12803
06,86972,0686972,Yuba City city, California,0,2011,65041,41.90,73.90,13.20,32542,32499,40708,2131,12136,732,236,47214,17827
08,03455,0803455,Arvada city, Colorado,1,2011,107326,36.00,77.50,14.50,51822,55504,99026,963,2880,987,0,92683,14643
08,04000,0804000,Aurora city, Colorado,1,2011,332551,45.20,72.70,8.70,165152,167399,221596,50335,17751,2965,1258,233907,98644
08,07850,0807850,Boulder city, Colorado,1,2011,98903,59.10,86.70,8.40,48972,49931,89591,668,3946,140,0,92099,6804
08,12815,0812815,Centennial city, Colorado,1,2011,102621,36.20,76.30,13.10,49518,53103,89523,3797,5027,442,58,94422,8199
08,16000,0816000,Colorado Springs city, Colorado,1,2011,426406,42.30,75.00,11.00,211851,214555,346531,26402,10596,2334,1738,355009,71397
08,20000,0820000,Denver city, Colorado,1,2011,619968,48.60,78.30,10.40,310377,309591,445187,59801,23046,8364,765,422850,197118
08,27425,0827425,Fort Collins city, Colorado,1,2011,146777,55.10,80.50,7.80,73104,73673,134175,1655,3083,614,114,130821,15956
08,32155,0832155,Greeley city, Colorado,1,2011,94966,48.30,76.60,11.60,46666,48300,86130,607,996,560,50,59484,35482
08,36410,0836410,Highlands Ranch CDP, Colorado,0,2011,109365,41.80,65.90,7.80,53359,56006,98613,1513,5026,390,0,102400,6965
08,43000,0843000,Lakewood city, Colorado,1,2011,144414,39.50,80.50,15.60,72753,71661,130601,2293,3664,725,35,114785,29629
08,45970,0845970,Longmont city, Colorado,1,2011,87695,40.50,75.60,11.80,43423,44272,75584,809,3962,776,0,64136,23559
08,46465,0846465,Loveland city, Colorado,1,2011,68203,37.80,75.90,14.30,33511,34692,58983,416,3479,1070,0,61700,6503
08,62000,0862000,Pueblo city, Colorado,1,2011,107584,39.00,76.80,15.30,52698,54886,85603,2278,951,3885,82,55041,52543
08,77290,0877290,Thornton city, Colorado,1,2011,121449,45.00,68.80,6.60,61359,60090,104743,1753,4217,852,0,86372,35077
08,83835,0883835,Westminster city, Colorado,1,2011,107950,44.40,78.30,9.50,54143,53807,90127,2332,6627,343,0,83483,24467
09,08000,0908000,Bridgeport city, Connecticut,1,2011,145634,46.10,74.50,9.50,68581,77053,65788,50531,5866,365,44,84314,61320
09,18430,0918430,Danbury city, Connecticut,1,2011,81684,46.50,79.40,10.70,41965,39719,53806,5626,3070,226,80,59416,22268
09,37000,0937000,Hartford city, Connecticut,1,2011,124863,50.70,75.00,9.20,61240,63623,47298,46238,2334,228,267,67295,57568
09,50370,0950370,New Britain city, Connecticut,1,2011,73279,41.90,76.70,12.20,32661,40618,42867,9395,2065,324,0,46748,26531
09,52000,0952000,New Haven city, Connecticut,1,2011,129591,51.40,77.20,11.00,62779,66812,58592,39435,6504,417,328,89117,40474
09,55990,0955990,Norwalk city, Connecticut,1,2011,86467,40.90,84.20,13.70,43624,42843,67613,11338,2079,319,0,69244,17223
09,73000,0973000,Stamford city, Connecticut,1,2011,123871,44.40,77.30,12.90,62634,61237,67976,20073,11147,324,0,92398,31473
09,80000,0980000,Waterbury city, Connecticut,1,2011,110196,41.60,76.30,10.90,51524,58672,62070,20451,1701,145,29,75816,34380
10,77580,1077580,Wilmington city, Delaware,1,2011,71317,43.20,75.90,11.70,33990,37327,24329,39400,662,0,0,61256,10061
11,50000,1150000,Washington city, District of Columbia,1,2011,617996,51.30,82.90,11.30,292283,325713,246505,309845,22510,1956,0,559252,58744
12,00410,1200410,Alafaya CDP, Florida,0,2011,67743,48.70,73.40,5.20,32867,34876,-998,-998,-998,-998,-998,42478,25265
12,07300,1207300,Boca Raton city, Florida,1,2011,85334,34.70,82.90,21.60,42392,42942,74416,6372,2141,140,0,74367,10967
12,07875,1207875,Boynton Beach city, Florida,1,2011,68997,36.90,81.80,20.80,32866,36131,45461,19599,1356,122,0,62228,6769
12,08150,1208150,Brandon CDP, Florida,0,2011,106312,47.70,79.20,10.00,51551,54761,83982,14327,2399,97,205,81328,24984
12,10275,1210275,Cape Coral city, Florida,1,2011,157476,32.70,76.40,18.70,79415,78061,143907,5576,2999,312,0,133279,24197
12,12875,1212875,Clearwater city, Florida,1,2011,107774,32.80,81.00,22.30,50740,57034,93953,9036,1908,96,0,95990,11784
12,14400,1214400,Coral Springs city, Florida,1,2011,123336,42.10,71.90,9.70,61431,61905,84568,25606,6072,758,0,97377,25959
12,16475,1216475,Davie town, Florida,1,2011,93686,43.10,76.20,9.40,43852,49834,74411,5426,5444,230,0,65527,28159
12,16725,1216725,Deerfield Beach city, Florida,1,2011,76392,38.10,81.60,20.60,35863,40529,-998,-998,-998,-998,-998,63596,12796
12,17200,1217200,Deltona city, Florida,1,2011,85212,35.40,78.20,16.70,43806,41406,56175,11540,719,1466,0,59418,25794
12,24000,1224000,Fort Lauderdale city, Florida,1,2011,168527,39.40,84.30,15.80,89956,78571,106543,51369,1699,916,75,140929,27598
12,24125,1224125,Fort Myers city, Florida,0,2011,63528,41.40,77.80,17.50,30874,32654,-998,-998,-998,-998,-998,48626,14902
12,25175,1225175,Gainesville city, Florida,1,2011,125325,65.90,87.90,7.90,59799,65526,81309,29940,9694,211,132,112368,12957
12,30000,1230000,Hialeah city, Florida,1,2011,229967,40.20,80.70,19.10,109303,120664,218181,3626,1102,401,0,15753,214214
12,32000,1232000,Hollywood city, Florida,1,2011,143351,38.80,77.50,15.60,69198,74153,102108,25369,3362,236,0,95614,47737
12,35000,1235000,Jacksonville city, Florida,1,2011,827909,42.90,76.40,11.30,401910,425999,502661,251281,34542,2880,464,760275,67634
12,36100,1236100,Kendall CDP, Florida,0,2011,75893,39.80,83.10,19.10,37609,38284,-998,-998,-998,-998,-998,22818,53075
12,38250,1238250,Lakeland city, Florida,1,2011,98608,38.40,81.30,20.90,46417,52191,71992,19521,1705,436,0,84108,14500
12,39425,1239425,Largo city, Florida,1,2011,77720,35.00,86.00,24.80,38079,39641,63041,8586,3186,40,0,69605,8115
12,39550,1239550,Lauderhill city, Florida,1,2011,68115,41.40,76.70,11.50,30798,37317,-998,-998,-998,-998,-998,62456,5659
12,39925,1239925,Lehigh Acres CDP, Florida,0,2011,98100,38.60,71.10,11.90,49067,49033,61611,20105,2103,782,0,66487,31613
12,43975,1243975,Melbourne city, Florida,1,2011,76089,35.40,82.10,20.90,36119,39970,65128,6965,1323,25,0,71212,4877
12,45000,1245000,Miami city, Florida,1,2011,408760,41.90,81.10,16.00,197819,210941,302767,80310,4557,837,153,121030,287730
12,45025,1245025,Miami Beach city, Florida,1,2011,89845,46.20,82.90,15.10,47323,42522,62419,7293,993,1301,0,41484,48361
12,45060,1245060,Miami Gardens city, Florida,1,2011,109672,44.40,76.30,11.50,50169,59503,-998,-998,-998,-998,-998,87948,21724
12,45975,1245975,Miramar city, Florida,1,2011,124285,44.30,73.70,7.60,61755,62530,53983,56120,6465,0,0,78544,45741
12,53000,1253000,Orlando city, Florida,1,2011,243209,47.30,78.20,10.60,117664,125545,139908,68298,11372,453,0,173948,69261
12,54000,1254000,Palm Bay city, Florida,1,2011,103234,35.70,74.90,14.90,47977,55257,77333,15546,1308,1095,0,90168,13066
12,54200,1254200,Palm Coast city, Florida,1,2011,79538,32.80,80.00,23.80,37809,41729,61490,10725,843,0,0,71258,8280
12,55775,1255775,Pembroke Pines city, Florida,1,2011,157612,39.30,77.80,14.30,75912,81700,109657,28427,9320,974,0,85410,72202
12,60950,1260950,Riverview CDP, Florida,0,2011,62319,48.00,74.40,9.10,30604,31715,43964,8030,2559,102,0,49288,13031
12,57425,1257425,Plantation city, Florida,1,2011,86516,39.00,77.20,11.90,40434,46082,59208,17723,4036,0,0,70111,16405
12,58050,1258050,Pompano Beach city, Florida,1,2011,101632,37.80,81.10,18.60,49159,52473,66970,31455,714,108,0,84684,16948
12,58715,1258715,Port St. Lucie city, Florida,1,2011,166162,36.80,75.30,15.50,85155,81007,122251,23331,2623,553,0,130925,35237
12,63000,1263000,St. Petersburg city, Florida,1,2011,244995,38.30,80.10,14.70,117319,127676,167288,62567,4944,575,508,232070,12925
12,68350,1268350,Spring Hill CDP, Florida,0,2011,106718,30.50,77.20,22.90,53022,53696,96282,5704,1217,265,0,93113,13605
12,69700,1269700,Sunrise city, Florida,1,2011,85990,40.90,77.90,13.90,39995,45995,49111,27967,3926,193,0,57221,28769
12,70600,1270600,Tallahassee city, Florida,1,2011,182955,59.60,84.00,7.70,88787,94168,103048,65423,7108,686,0,170460,12495
12,71000,1271000,Tampa city, Florida,1,2011,346064,46.40,78.20,10.90,171733,174331,218418,97089,10539,1950,414,273101,72963
12,72145,1272145,Town 'n' Country CDP, Florida,0,2011,78227,43.50,81.20,12.20,38783,39444,62567,5551,3986,717,0,43794,34433
12,76582,1276582,Weston city, Florida,0,2011,66545,36.40,68.80,8.50,33046,33499,59941,1928,1584,0,0,38603,27942
12,76600,1276600,West Palm Beach city, Florida,1,2011,101065,44.60,82.80,17.20,50930,50135,62186,31646,2325,605,91,75958,25107
13,01052,1301052,Albany city, Georgia,1,2011,78701,45.00,74.00,11.30,35386,43315,-998,-998,-998,-998,-998,76357,2344
13,03440,1303440,Athens-Clarke County unified government (balance), Georgia,1,2011,115939,61.20,83.30,8.40,55150,60789,77354,29326,4790,171,16,103736,12203
13,04000,1304000,Atlanta city, Georgia,1,2011,432425,52.60,81.40,9.30,214220,218205,172034,233506,14796,1065,231,404430,27995
13,04204,1304204,Augusta-Richmond County consolidated government (balance), Georgia,1,2011,194928,43.20,75.50,11.70,94628,100300,78331,104951,3755,330,319,186374,8554
13,19000,1319000,Columbus city, Georgia,1,2011,194107,43.20,74.80,11.30,93780,100327,89062,86643,4538,502,267,181171,12936
13,42425,1342425,Johns Creek city, Georgia,1,2011,79183,40.00,72.20,9.50,39888,39295,-998,-998,-998,-998,-998,76616,2567
13,49000,1349000,Macon city, Georgia,1,2011,92138,43.20,71.70,10.90,41234,50904,-998,-998,-998,-998,-998,90037,2101
13,67284,1367284,Roswell city, Georgia,1,2011,91165,42.70,75.00,10.80,46933,44232,70598,13554,4108,0,0,77779,13386
13,68516,1368516,Sandy Springs city, Georgia,1,2011,96859,42.10,76.50,10.40,46707,50152,67197,20875,5019,109,637,81373,15486
13,69000,1369000,Savannah city, Georgia,1,2011,139499,46.70,76.20,11.60,65688,73811,58518,74067,3150,73,248,133359,6140
13,80508,1380508,Warner Robins city, Georgia,1,2011,68315,46.20,74.20,10.30,32698,35617,38148,22961,2639,62,0,64179,4136
15,71550,1571550,Urban Honolulu CDP, Hawaii,0,2011,340931,40.20,81.50,18.20,166748,174183,60964,7943,181604,504,28755,324522,16409
16,08830,1608830,Boise City city, Idaho,1,2011,210151,45.40,78.20,10.90,105331,104820,188235,2504,7347,539,0,192248,17903
16,52120,1652120,Meridian city, Idaho,1,2011,76742,35.70,68.50,11.60,37434,39308,-998,-998,-998,-998,-998,73579,3163
16,56260,1656260,Nampa city, Idaho,1,2011,82759,40.70,68.50,11.80,40475,42284,75902,324,1127,917,336,62596,20163
17,02154,1702154,Arlington Heights village, Illinois,1,2011,76755,36.00,81.70,17.70,37556,39199,65096,1130,7066,0,0,71762,4993
17,03012,1703012,Aurora city, Illinois,1,2011,193398,48.00,69.70,6.80,95621,97777,108846,15595,11997,421,109,115765,77633
17,06613,1706613,Bloomington city, Illinois,1,2011,77078,45.60,75.40,9.00,38156,38922,59864,9124,5525,432,0,72025,5053
17,07133,1707133,Bolingbrook village, Illinois,1,2011,72719,46.20,72.20,6.80,35112,37607,46889,14318,6779,45,0,53407,19312
17,12385,1712385,Champaign city, Illinois,1,2011,81296,61.30,83.90,8.90,40180,41116,56487,12606,10554,95,0,77194,4102
17,14000,1714000,Chicago city, Illinois,1,2011,2707123,48.20,77.20,10.20,1317085,1390038,1296264,873749,143049,6340,320,1917658,789465
17,14351,1714351,Cicero town, Illinois,1,2011,84263,50.80,67.20,6.00,41212,43051,-998,-998,-998,-998,-998,10187,74076
17,18823,1718823,Decatur city, Illinois,1,2011,74617,36.70,77.80,17.10,35546,39071,53152,18286,1307,0,100,73199,1418
17,23074,1723074,Elgin city, Illinois,1,2011,116108,43.50,72.40,8.50,55929,60179,77736,4914,8066,611,0,62929,53179
17,24582,1724582,Evanston city, Illinois,1,2011,74791,45.50,82.10,12.60,37222,37569,52437,13529,5158,46,0,66972,7819
17,38570,1738570,Joliet city, Illinois,1,2011,152902,44.40,69.90,8.70,74804,78098,101864,24673,2938,560,0,106598,46304
17,51622,1751622,Naperville city, Illinois,1,2011,143289,39.10,72.70,11.00,69689,73600,106112,5762,27036,43,37,132777,10512
17,57225,1757225,Palatine village, Illinois,1,2011,68815,39.20,71.50,12.30,33354,35461,51170,2537,10389,0,0,56877,11938
17,59000,1759000,Peoria city, Illinois,1,2011,113715,42.20,74.70,14.50,52652,61063,71363,32738,6169,587,0,108072,5643
17,65000,1765000,Rockford city, Illinois,1,2011,152485,38.40,72.60,14.50,74330,78155,106019,32745,4331,348,145,125632,26853
17,68003,1768003,Schaumburg village, Illinois,1,2011,74198,44.60,80.20,9.90,37038,37160,53919,3651,13907,29,0,69507,4691
17,70122,1770122,Skokie village, Illinois,0,2011,65070,33.60,81.60,21.10,30026,35044,42212,5796,15593,12,0,59025,6045
17,72000,1772000,Springfield city, Illinois,1,2011,117178,38.60,79.10,14.30,56687,60491,88730,22168,2674,553,0,114633,2545
17,79293,1779293,Waukegan city, Illinois,1,2011,92734,45.50,69.80,7.30,46058,46676,54824,15262,3873,297,0,40869,51865
18,05860,1805860,Bloomington city, Indiana,1,2011,81033,69.40,88.20,8.40,40923,40110,66469,2647,7385,171,0,77637,3396
18,10342,1810342,Carmel city, Indiana,1,2011,81534,36.10,69.30,12.00,38560,42974,67720,2409,8078,104,0,78073,3461
18,22000,1822000,Evansville city, Indiana,1,2011,118117,39.60,78.80,15.20,55901,62216,99657,13569,239,55,0,114693,3424
18,23278,1823278,Fishers town, Indiana,1,2011,78756,44.20,66.90,4.70,39396,39360,69078,2836,3335,206,0,75493,3263
18,25000,1825000,Fort Wayne city, Indiana,1,2011,258803,40.80,73.10,11.70,123762,135041,196074,41079,7302,1256,69,239042,19761
18,27000,1827000,Gary city, Indiana,1,2011,80125,37.80,73.20,13.90,36194,43931,9419,67145,1014,57,112,76263,3862
18,31000,1831000,Hammond city, Indiana,1,2011,80758,41.00,71.50,9.50,40204,40554,41782,15990,508,472,0,49524,31234
18,36003,1836003,Indianapolis city (balance), Indiana,1,2011,824232,43.70,74.90,10.40,394578,429654,513900,228829,16032,1121,126,746446,77786
18,40788,1840788,Lafayette city, Indiana,1,2011,66105,47.30,76.30,10.50,32528,33577,58373,4652,868,205,0,57240,8865
18,51876,1851876,Muncie city, Indiana,1,2011,69131,52.30,83.70,13.20,32440,36691,57047,5907,1356,0,0,67102,2029
18,71000,1871000,South Bend city, Indiana,1,2011,101103,40.40,74.00,13.50,49578,51525,63312,28306,1156,247,0,88146,12957
19,12000,1912000,Cedar Rapids city, Iowa,1,2011,127902,42.80,77.60,13.40,63442,64460,112749,7031,2190,388,0,123952,3950
19,19000,1919000,Davenport city, Iowa,1,2011,100805,42.40,75.30,11.90,47305,53500,82546,11499,2543,420,0,92672,8133
19,21000,1921000,Des Moines city, Iowa,1,2011,206577,44.60,74.50,11.00,99748,106829,160999,22215,10057,528,121,182020,24557
19,38595,1938595,Iowa City city, Iowa,1,2011,68940,60.70,84.80,9.20,34190,34750,57744,3562,4303,205,0,66762,2178
19,73335,1973335,Sioux City city, Iowa,1,2011,81453,41.20,73.80,13.40,39426,42027,63590,2318,1919,1700,0,67547,13906
19,82425,1982425,Waterloo city, Iowa,1,2011,68646,43.20,76.20,14.10,33542,35104,52727,11040,1459,148,0,63951,4695
20,36000,2036000,Kansas City city, Kansas,1,2011,146198,41.70,71.50,10.70,73008,73190,83829,38344,4414,1236,32,104956,41242
20,38900,2038900,Lawrence city, Kansas,1,2011,89851,61.70,83.10,7.70,45566,44285,74349,4718,4239,1950,0,83791,6060
20,52575,2052575,Olathe city, Kansas,1,2011,127902,43.20,71.20,8.40,64635,63267,107410,7226,6664,489,0,115915,11987
20,53775,2053775,Overland Park city, Kansas,1,2011,176182,39.50,73.40,11.70,82790,93392,147180,9696,10336,1030,0,163072,13110
20,71000,2071000,Topeka city, Kansas,1,2011,128194,39.10,76.00,14.20,61416,66778,98968,15720,1646,1529,0,110858,17336
20,79000,2079000,Wichita city, Kansas,1,2011,384439,40.80,73.70,11.90,189484,194955,285434,39827,17492,3648,237,324514,59925
21,46027,2146027,Lexington-Fayette urban county, Kentucky,1,2011,301569,47.00,79.00,10.60,148736,152833,229703,44513,10662,620,44,280528,21041
21,48006,2148006,Louisville/Jefferson County metro government (balance), Kentucky,1,2011,602037,40.20,76.50,13.00,289734,312303,426236,134666,14558,1092,84,573811,28226
22,05000,2205000,Baton Rouge city, Louisiana,1,2011,230148,47.20,78.50,12.00,109831,120317,91470,125206,8529,177,0,219874,10274
22,39475,2239475,Kenner city, Louisiana,1,2011,66725,37.70,76.30,13.50,31350,35375,44031,18132,1985,0,0,55388,11337
22,40735,2240735,Lafayette city, Louisiana,1,2011,122128,45.20,78.60,13.30,59817,62311,75764,41797,2093,289,0,116208,5920
22,41155,2241155,Lake Charles city, Louisiana,1,2011,72475,38.80,77.00,15.10,34515,37960,-998,-998,-998,-998,-998,70227,2248
22,50115,2250115,Metairie CDP, Louisiana,0,2011,137775,39.80,80.20,16.80,69751,68024,110501,14478,5184,401,0,117009,20766
22,55000,2255000,New Orleans city, Louisiana,1,2011,360740,44.70,78.60,11.20,173821,186919,123436,216539,10649,761,147,341813,18927
22,70000,2270000,Shreveport city, Louisiana,1,2011,201871,41.60,75.00,12.80,94728,107143,79752,113167,1295,941,0,196573,5298
23,60545,2360545,Portland city, Maine,1,2011,66368,46.90,83.60,11.70,32259,34109,-998,-998,-998,-998,-998,64863,1505
24,04000,2404000,Baltimore city, Maryland,1,2011,619493,44.70,78.40,11.70,291984,327509,186050,390096,14561,1760,733,592655,26838
24,19125,2419125,Columbia CDP, Maryland,0,2011,104643,43.30,74.90,9.70,49998,54645,55960,24869,13943,239,137,96097,8546
24,26000,2426000,Ellicott City CDP, Maryland,0,2011,68010,35.60,73.30,13.80,33751,34259,-998,-998,-998,-998,-998,65056,2954
24,30325,2430325,Frederick city, Maryland,0,2011,66165,42.00,75.90,10.70,33122,33043,43364,13457,3354,566,0,54423,11742
24,32025,2432025,Germantown CDP, Maryland,0,2011,84447,46.20,74.00,5.10,39011,45436,36310,21195,18860,264,0,69109,15338
24,32650,2432650,Glen Burnie CDP, Maryland,0,2011,69026,44.10,80.30,9.50,32277,36749,44674,17795,2664,262,0,62077,6949
24,72450,2472450,Silver Spring CDP, Maryland,0,2011,78430,48.20,75.40,8.40,39113,39317,34053,23355,4770,173,0,59046,19384
24,81175,2481175,Waldorf CDP, Maryland,0,2011,71674,45.70,70.90,6.50,33074,38600,21966,39419,4595,0,90,67779,3895
25,07000,2507000,Boston city, Massachusetts,1,2011,624969,55.30,83.20,10.30,296744,328225,333558,161596,56844,1594,60,510228,114741
25,09000,2509000,Brockton city, Massachusetts,1,2011,94312,41.00,74.30,12.60,45336,48976,42120,34485,2437,206,45,82874,11438
25,11000,2511000,Cambridge city, Massachusetts,1,2011,106039,61.00,87.70,9.70,50282,55757,69524,11798,17604,238,44,99403,6636
25,23000,2523000,Fall River city, Massachusetts,1,2011,88964,42.50,77.80,14.90,41123,47841,78293,2678,2618,0,0,82825,6139
25,24960,2524960,Framingham CDP, Massachusetts,0,2011,68986,42.10,76.30,12.30,32142,36844,52201,6297,5073,120,0,59128,9858
25,34550,2534550,Lawrence city, Massachusetts,1,2011,76971,45.80,73.20,8.10,36832,40139,27332,4427,2308,0,0,21478,55493
25,37000,2537000,Lowell city, Massachusetts,1,2011,107582,46.70,78.30,11.70,51315,56267,66194,7178,19096,439,88,92074,15508
25,37490,2537490,Lynn city, Massachusetts,1,2011,91035,44.90,75.40,12.50,42983,48052,48153,10224,6606,413,28,60268,30767
25,45000,2545000,New Bedford city, Massachusetts,1,2011,95180,41.60,78.20,14.50,45782,49398,70801,9967,1019,326,0,79990,15190
25,45560,2545560,Newton city, Massachusetts,1,2011,85946,38.80,80.30,17.20,39895,46051,70538,3123,10422,68,0,81935,4011
25,55745,2555745,Quincy city, Massachusetts,1,2011,92914,43.80,83.10,13.40,45913,47001,64364,4979,19882,233,0,89217,3697
25,62535,2562535,Somerville city, Massachusetts,1,2011,76529,63.00,86.40,7.90,38249,38280,55947,6915,8433,19,0,66598,9931
25,67000,2567000,Springfield city, Massachusetts,1,2011,153157,42.80,72.80,11.20,74274,78883,84313,32118,2911,1010,9,90685,62472
25,82000,2582000,Worcester city, Massachusetts,1,2011,181641,45.20,77.80,12.10,84173,97468,131184,21096,13985,856,106,145714,35927
26,03000,2603000,Ann Arbor city, Michigan,1,2011,114932,60.80,88.60,10.60,58181,56751,85867,6937,17287,267,0,108869,6063
26,21000,2621000,Dearborn city, Michigan,1,2011,97131,42.70,71.60,10.80,48829,48302,88285,2454,1758,232,0,94540,2591
26,22000,2622000,Detroit city, Michigan,1,2011,706640,41.00,73.90,11.90,336931,369709,86625,578298,7914,1790,76,655138,51502
26,27440,2627440,Farmington Hills city, Michigan,1,2011,80255,38.20,79.10,16.00,37887,42368,54245,13413,9319,135,0,78442,1813
26,29000,2629000,Flint city, Michigan,1,2011,101568,42.20,73.70,11.70,48738,52830,40445,56018,683,1071,28,96737,4831
26,34000,2634000,Grand Rapids city, Michigan,1,2011,189813,47.40,76.00,11.60,93297,96516,130404,41971,2974,640,0,162377,27436
26,42160,2642160,Kalamazoo city, Michigan,1,2011,74743,55.70,80.20,9.20,38713,36030,50409,17424,2042,142,114,69987,4756
26,46000,2646000,Lansing city, Michigan,1,2011,114738,47.00,78.60,9.90,55212,59526,70396,24246,6954,593,0,99464,15274
26,49000,2649000,Livonia city, Michigan,1,2011,95947,34.10,80.50,19.30,47117,48830,87381,3633,2840,362,65,93390,2557
26,69035,2669035,Rochester Hills city, Michigan,1,2011,71457,36.80,76.40,13.80,35323,36134,57461,3745,7467,326,0,67497,3960
26,74900,2674900,Southfield city, Michigan,1,2011,72201,35.20,79.00,17.30,30308,41893,16038,50837,1059,171,0,71101,1100
26,76460,2676460,Sterling Heights city, Michigan,1,2011,129884,37.50,78.90,17.60,64214,65670,108542,8280,9736,231,0,128536,1348
26,80700,2680700,Troy city, Michigan,1,2011,81507,36.00,75.70,13.20,39115,42392,58361,3919,16160,25,0,78778,2729
26,84000,2684000,Warren city, Michigan,1,2011,134250,37.70,80.50,16.40,65669,68581,108845,13888,7175,1184,57,133379,871
26,86000,2686000,Westland city, Michigan,1,2011,83235,40.30,77.10,14.10,37577,45658,57350,19011,3751,439,0,80660,2575
26,88940,2688940,Wyoming city, Michigan,1,2011,72839,46.70,73.40,6.40,36265,36574,61726,3518,1279,132,0,57579,15260
27,06616,2706616,Bloomington city, Minnesota,1,2011,84060,38.00,82.50,19.10,41246,42814,67757,6465,4761,883,0,79111,4949
27,07966,2707966,Brooklyn Park city, Minnesota,1,2011,76830,45.20,72.10,7.60,37431,39399,41328,19165,11190,121,0,72846,3984
27,17000,2717000,Duluth city, Minnesota,1,2011,86284,47.10,79.90,14.00,42956,43328,79069,1845,1427,1439,47,85451,833
27,43000,2743000,Minneapolis city, Minnesota,1,2011,387736,50.40,80.00,9.50,194953,192783,260411,72030,20282,6954,120,346810,40926
27,51730,2751730,Plymouth city, Minnesota,1,2011,71561,37.60,75.90,10.90,34282,37279,59600,2199,5797,560,0,68860,2701
27,54880,2754880,Rochester city, Minnesota,1,2011,107887,40.50,74.90,13.20,52538,55349,89429,7173,7390,379,0,101857,6030
27,56896,2756896,St. Cloud city, Minnesota,0,2011,68066,51.90,80.90,9.70,34800,33266,56031,6323,2566,209,0,66931,1135
27,58000,2758000,St. Paul city, Minnesota,1,2011,288437,46.80,75.50,9.00,141202,147235,177353,42836,42046,2991,138,259923,28514
28,29700,2829700,Gulfport city, Mississippi,1,2011,69221,43.40,74.80,12.30,35666,33555,-998,-998,-998,-998,-998,65783,3438
28,36000,2836000,Jackson city, Mississippi,1,2011,175607,44.20,72.80,10.20,81588,94019,33314,139293,398,0,0,172271,3336
29,15670,2915670,Columbia city, Missouri,1,2011,110432,57.10,81.50,9.00,53664,56768,85828,12706,6011,289,17,105930,4502
29,35000,2935000,Independence city, Missouri,1,2011,117210,36.70,78.40,18.00,53306,63904,97658,9144,1328,217,397,106215,10995
29,38000,2938000,Kansas City city, Missouri,1,2011,463156,43.60,76.30,10.70,225330,237826,278420,129146,13430,1976,811,416600,46556
29,41348,2941348,Lee's Summit city, Missouri,1,2011,91352,38.90,68.30,9.90,43997,47355,72687,11761,998,64,0,88459,2893
29,54074,2954074,O'Fallon city, Missouri,1,2011,80534,42.50,67.50,8.90,40588,39946,-998,-998,-998,-998,-998,79832,702
29,64082,2964082,St. Charles city, Missouri,0,2011,66600,46.60,82.00,11.80,31910,34690,59630,2882,1240,266,0,62390,4210
29,64550,2964550,St. Joseph city, Missouri,1,2011,77095,42.20,77.60,13.40,38131,38964,66880,4462,501,264,248,72843,4252
29,65000,2965000,St. Louis city, Missouri,1,2011,318069,46.20,78.80,11.00,154173,163896,144377,152646,7381,481,329,306625,11444
29,70000,2970000,Springfield city, Missouri,1,2011,160662,48.10,83.50,15.00,78978,81684,144519,6158,2363,408,571,154650,6012
30,06550,3006550,Billings city, Montana,1,2011,105623,38.50,78.40,15.40,50417,55206,94843,273,494,4606,511,99926,5697
30,50200,3050200,Missoula city, Montana,1,2011,67297,50.30,82.30,12.50,33397,33900,62006,502,484,2669,36,65054,2243
31,28000,3128000,Lincoln city, Nebraska,1,2011,262350,47.10,77.60,11.30,131777,130573,230615,10066,10799,2044,0,245531,16819
31,37000,3137000,Omaha city, Nebraska,1,2011,415076,42.80,75.50,11.40,202234,212842,311639,52035,11065,3072,234,358227,56849
32,23770,3223770,Enterprise CDP, Nevada,0,2011,120194,48.70,73.70,6.70,60683,59511,73906,14569,22893,1310,167,95834,24360
32,31900,3231900,Henderson city, Nevada,1,2011,260072,37.30,77.60,16.20,120505,139567,200761,21424,21678,900,2428,225974,34098
32,40000,3240000,Las Vegas city, Nevada,1,2011,589340,41.20,74.20,12.50,303067,286273,393218,68577,39130,5044,4588,400722,188618
32,51800,3251800,North Las Vegas city, Nevada,1,2011,219017,46.30,69.70,8.50,110585,108432,122532,38496,7759,345,2547,125720,93297
32,54600,3254600,Paradise CDP, Nevada,0,2011,216387,44.10,79.10,11.90,109091,107296,155864,16070,21482,1487,542,154794,61593
48,72176,4872176,Temple city, Texas,0,2011,67183,39.10,75.90,15.50,34195,32988,54307,7615,2430,13,24,52245,14938
48,72656,4872656,The Woodlands CDP, Texas,0,2011,112858,37.60,69.00,9.70,55946,56912,95073,4458,6363,0,0,92600,20258
48,74144,4874144,Tyler city, Texas,1,2011,98573,45.00,76.40,14.30,45404,53169,66316,24630,2368,481,76,78142,20431
48,76000,4876000,Waco city, Texas,1,2011,126691,47.60,74.40,10.70,61266,65425,90276,28364,2170,129,57,87884,38807
48,79000,4879000,Wichita Falls city, Texas,1,2011,103932,43.30,77.00,12.10,53261,50671,81816,12722,2696,756,70,83087,20845
49,43660,4943660,Layton city, Utah,1,2011,68488,44.10,69.50,7.90,34767,33721,60339,2442,1129,98,359,61318,7170
49,55980,4955980,Ogden city, Utah,1,2011,83950,46.00,70.60,8.30,42101,41849,62530,1085,1303,926,202,59776,24174
49,57300,4957300,Orem city, Utah,1,2011,90719,48.10,67.30,7.90,45987,44732,82141,1536,983,427,549,78310,12409
49,62470,4962470,Provo city, Utah,1,2011,115324,65.00,76.80,4.70,57288,58036,101694,1139,3634,312,1452,93254,22070
49,65330,4965330,St. George city, Utah,1,2011,74776,39.90,67.60,18.00,38478,36298,68804,236,401,1771,1054,62684,12092
49,67000,4967000,Salt Lake City city, Utah,1,2011,189906,50.90,76.20,8.50,97530,92376,141084,5382,9255,3097,5363,153905,36001
49,67440,4967440,Sandy city, Utah,1,2011,89191,40.80,72.20,11.40,45103,44088,80129,419,2140,228,514,82881,6310
49,82950,4982950,West Jordan city, Utah,1,2011,105694,45.00,64.60,3.90,52643,53051,94180,1084,2692,1021,934,88819,16875
49,83470,4983470,West Valley City city, Utah,1,2011,131928,45.50,69.10,6.50,69224,62704,101985,4156,8735,913,3473,85226,46702
51,01000,5101000,Alexandria city, Virginia,1,2011,144301,51.00,82.50,8.70,70047,74254,93723,30380,8547,310,0,120592,23709
51,03000,5103000,Arlington CDP, Virginia,0,2011,216004,55.80,84.10,8.90,107590,108414,152764,18017,20711,1443,237,183211,32793
51,14440,5114440,Centreville CDP, Virginia,0,2011,77602,46.20,72.60,3.60,40528,37074,37842,5249,24122,0,0,65193,12409
51,16000,5116000,Chesapeake city, Virginia,1,2011,225050,40.30,74.70,10.70,109746,115304,140666,65759,7439,609,391,214721,10329
51,21088,5121088,Dale City CDP, Virginia,0,2011,65174,44.10,73.90,7.10,33434,31740,27883,22834,5746,0,0,49255,15919
51,35000,5135000,Hampton city, Virginia,1,2011,136401,41.90,77.20,12.30,65934,70467,59098,68574,3086,560,39,129936,6465
51,47672,5147672,Lynchburg city, Virginia,1,2011,76503,48.20,82.60,15.50,35935,40568,51780,20921,1930,229,0,73585,2918
51,56000,5156000,Newport News city, Virginia,1,2011,179611,44.80,75.70,11.00,86048,93563,91478,72777,5172,581,264,165877,13734
51,57000,5157000,Norfolk city, Virginia,1,2011,242628,50.70,79.10,9.40,125041,117587,115500,102621,8528,917,418,225914,16714
51,64000,5164000,Portsmouth city, Virginia,1,2011,95684,41.80,76.10,13.00,45963,49721,39758,50965,643,70,0,92572,3112
51,67000,5167000,Richmond city, Virginia,1,2011,205533,49.10,81.00,11.10,98856,106677,89030,101361,4904,286,31,192495,13038
51,68000,5168000,Roanoke city, Virginia,1,2011,96714,39.90,78.30,14.30,46393,50321,62443,24781,1933,188,0,91293,5421
51,76432,5176432,Suffolk city, Virginia,1,2011,84930,38.90,74.80,11.70,40585,44345,44314,34648,664,103,0,82238,2692
51,82000,5182000,Virginia Beach city, Virginia,1,2011,442707,43.90,76.40,10.90,217227,225480,302996,86949,28736,1705,240,411769,30938
53,03180,5303180,Auburn city, Washington,1,2011,70724,40.70,77.40,12.20,34067,36657,50990,2942,6112,1646,1167,60672,10052
53,05210,5305210,Bellevue city, Washington,1,2011,124790,41.40,80.80,13.50,64431,60359,82043,1926,30183,372,584,116931,7859
53,05280,5305280,Bellingham city, Washington,1,2011,81865,53.00,83.90,12.90,39976,41889,72310,1040,3889,770,0,74355,7510
53,22640,5322640,Everett city, Washington,1,2011,104304,44.60,80.10,10.30,52311,51993,79903,3196,10554,1156,1170,90892,13412
53,23515,5323515,Federal Way city, Washington,1,2011,91079,42.20,77.20,10.10,44373,46706,60267,8971,9125,1599,1848,72413,18666
53,35275,5335275,Kennewick city, Washington,1,2011,76219,39.90,68.60,8.50,39455,36764,56888,2299,2046,112,0,57866,18353
53,35415,5335415,Kent city, Washington,1,2011,120919,42.80,72.00,8.90,62357,58562,68629,11054,21345,612,3477,100319,20600
53,57745,5357745,Renton city, Washington,1,2011,92827,44.80,77.80,10.70,45963,46864,52047,10008,19853,660,287,83870,8957
53,63000,5363000,Seattle city, Washington,1,2011,620778,50.50,84.10,11.20,309128,311650,433436,45994,95955,4523,1361,583143,37635
53,67000,5367000,Spokane city, Washington,1,2011,210107,43.80,78.10,13.80,101677,108430,183697,5621,5737,3854,536,198324,11783
53,67167,5367167,Spokane Valley city, Washington,1,2011,90282,38.80,76.40,15.20,44940,45342,79424,1331,903,2384,490,86048,4234
53,70000,5370000,Tacoma city, Washington,1,2011,200677,43.90,78.20,12.10,98736,101941,132653,21038,20980,2370,964,176219,24458
53,74060,5374060,Vancouver city, Washington,1,2011,164774,42.20,77.00,13.30,78445,86329,134114,5290,9306,2038,1622,150161,14613
53,80010,5380010,Yakima city, Washington,1,2011,92521,42.70,74.80,14.30,48119,44402,66893,993,996,756,0,53598,38923
55,02375,5502375,Appleton city, Wisconsin,1,2011,72395,37.10,75.10,13.80,35837,36558,64547,579,4155,499,30,68217,4178
55,22300,5522300,Eau Claire city, Wisconsin,0,2011,65973,50.70,80.50,11.40,31541,34432,59925,171,3046,322,0,65277,696
55,31000,5531000,Green Bay city, Wisconsin,1,2011,105815,42.80,74.30,10.90,50322,55493,87221,4422,4461,2652,25,93141,12674
55,39225,5539225,Kenosha city, Wisconsin,1,2011,99743,43.60,73.40,10.90,49191,50552,84430,10631,1049,588,0,82388,17355
55,48000,5548000,Madison city, Wisconsin,1,2011,236889,54.70,81.90,9.10,115647,121242,190145,15082,18927,1010,0,218639,18250
55,53000,5553000,Milwaukee city, Wisconsin,1,2011,597884,46.30,73.50,9.20,286738,311146,284607,233507,20552,3333,349,493154,104730
55,60500,5560500,Oshkosh city, Wisconsin,0,2011,66339,51.30,81.10,11.10,35062,31277,60548,2342,1668,498,0,64270,2069
55,66000,5566000,Racine city, Wisconsin,1,2011,78847,42.20,72.00,10.90,37546,41301,53752,17925,1054,92,0,62228,16619
55,84250,5584250,Waukesha city, Wisconsin,1,2011,70872,46.70,75.30,9.90,35129,35743,63198,1239,1843,321,0,60359,10513
72,10334,7210334,Caguas zona urbana, Puerto Rico,0,2011,87617,41.10,74.60,15.30,39871,47746,69700,6541,100,55,0,374,87243
72,14290,7214290,Carolina zona urbana, Puerto Rico,0,2011,156916,40.40,76.90,17.10,71820,85096,93016,34334,387,1020,0,1836,155080
72,32522,7232522,Guaynabo zona urbana, Puerto Rico,0,2011,77821,39.70,78.80,16.70,35791,42030,61314,3807,167,390,0,1514,76307
72,63820,7263820,Ponce zona urbana, Puerto Rico,0,2011,133464,39.30,75.70,16.00,62813,70651,91316,7331,51,87,0,181,133283
72,76770,7276770,San Juan zona urbana, Puerto Rico,0,2011,373584,39.60,78.70,17.80,170575,203009,232289,62028,3757,1204,0,7591,365993
72,06593,7206593,Bayamón zona urbana, Puerto Rico,0,2011,184282,40.30,78.50,17.40,86945,97337,109110,17369,327,1319,0,1623,182659
72,52431,7252431,Mayagüez zona urbana, Puerto Rico,0,2011,68888,43.40,79.70,17.00,33212,35676,39318,3415,11,0,0,608,68280
01,07000,0107000,Birmingham city, Alabama,1,2012,212835,42.70,78.00,12.00,97165,115670,47736,156390,2715,117,132,202823,10012
01,21184,0121184,Dothan city, Alabama,0,2012,68104,39.00,75.00,14.50,32389,35715,42431,23371,712,50,0,66215,1889
01,35896,0135896,Hoover city, Alabama,1,2012,81627,40.80,72.20,12.60,39770,41857,60744,12290,4563,0,74,77054,4573
01,37000,0137000,Huntsville city, Alabama,1,2012,183076,42.20,78.00,14.20,91227,91849,113590,58439,3884,527,253,173067,10009
01,50000,0150000,Mobile city, Alabama,1,2012,194823,41.00,76.80,13.80,92531,102292,85239,103503,2417,1004,44,191818,3005
01,51000,0151000,Montgomery city, Alabama,1,2012,205285,42.90,75.40,12.00,96393,108892,78369,115936,4977,77,96,197435,7850
01,77256,0177256,Tuscaloosa city, Alabama,1,2012,93351,56.70,82.40,10.10,45060,48291,52784,37621,1892,286,52,89455,3896
02,03000,0203000,Anchorage municipality, Alaska,1,2012,298610,45.40,74.90,8.00,151752,146858,196090,18866,27691,19165,5977,274017,24593
04,04720,0404720,Avondale city, Arizona,1,2012,78274,48.60,66.10,6.40,37383,40891,57783,9485,2723,1283,218,34796,43478
04,10670,0410670,Casas Adobes CDP, Arizona,0,2012,71976,35.80,75.20,18.90,34718,37258,61753,1387,2591,1161,0,55610,16366
04,12000,0412000,Chandler city, Arizona,1,2012,245642,44.40,73.30,8.90,122484,123158,190170,12157,20086,4051,592,190195,55447
04,23620,0423620,Flagstaff city, Arizona,0,2012,67472,58.30,78.90,6.00,33773,33699,50596,1906,1348,7870,82,54713,12759
04,27400,0427400,Gilbert town, Arizona,1,2012,221136,42.80,68.20,7.60,107354,113782,187591,5792,12334,1646,560,185258,35878
04,27820,0427820,Glendale city, Arizona,1,2012,232118,44.00,74.10,9.40,114099,118019,181779,15421,7510,3620,258,143717,88401
04,28380,0428380,Goodyear city, Arizona,0,2012,69631,38.80,73.10,13.00,32540,37091,58187,4955,1623,734,0,48474,21157
04,46000,0446000,Mesa city, Arizona,1,2012,452068,39.40,75.00,15.80,220768,231300,375765,14982,8021,9780,1138,326599,125469
04,54050,0454050,Peoria city, Arizona,1,2012,159761,38.00,72.90,14.40,76732,83029,135820,6417,7662,616,459,128447,31314
04,55000,0455000,Phoenix city, Arizona,1,2012,1488759,44.70,72.90,9.20,743172,745587,1141686,105152,51432,29472,2772,888308,600451
04,64210,0464210,San Tan Valley CDP, Arizona,0,2012,82760,41.40,64.60,6.90,41569,41191,68821,2604,2301,1941,302,65613,17147
04,65000,0465000,Scottsdale city, Arizona,1,2012,223517,37.50,82.60,20.50,109243,114274,201917,5342,9901,1320,399,203029,20488
04,71510,0471510,Surprise city, Arizona,1,2012,121276,35.10,70.20,20.40,61288,59988,100905,10938,2554,1021,322,99705,21571
04,73000,0473000,Tempe city, Arizona,1,2012,166862,59.40,84.80,8.40,87008,79854,120196,6835,12331,4372,532,126552,40310
04,77000,0477000,Tucson city, Arizona,1,2012,524278,45.70,77.70,12.40,260034,264244,384306,27562,13327,11165,755,295768,228510
04,85540,0485540,Yuma city, Arizona,1,2012,95424,45.00,72.20,13.30,49685,45739,66806,3295,2121,885,656,40537,54887
05,23290,0523290,Fayetteville city, Arkansas,1,2012,76892,58.50,82.90,8.70,38830,38062,63768,4702,1948,930,213,70944,5948
05,24550,0524550,Fort Smith city, Arkansas,1,2012,87437,40.80,73.40,13.20,43528,43909,67162,7562,5251,1910,209,72894,14543
05,35710,0535710,Jonesboro city, Arkansas,1,2012,70183,44.50,76.80,11.60,33964,36219,54205,13398,804,144,0,66480,3703
05,41000,0541000,Little Rock city, Arkansas,1,2012,196530,43.80,78.00,12.70,93400,103130,103201,82170,7063,1036,0,183676,12854
05,66080,0566080,Springdale city, Arkansas,1,2012,76480,43.50,64.10,7.40,37250,39230,48349,2168,2141,326,4425,50007,26473
06,00562,0600562,Alameda city, California,1,2012,75632,42.10,78.90,13.20,36485,39147,37726,5179,23429,521,704,66680,8952
06,00884,0600884,Alhambra city, California,1,2012,84322,42.40,81.70,12.20,42413,41909,22519,1465,40841,153,141,52678,31644
06,02000,0602000,Anaheim city, California,1,2012,343241,44.80,73.60,9.90,170755,172486,233546,7450,52130,1057,2313,160795,182446
06,02252,0602252,Antioch city, California,1,2012,105495,39.90,72.80,8.90,52428,53067,50421,16971,11378,2098,493,69139,36356
06,02364,0602364,Apple Valley town, California,1,2012,70682,38.20,73.80,16.70,35154,35528,55944,6872,789,2034,0,47262,23420
06,02553,0602553,Arden-Arcade CDP, California,0,2012,88995,39.00,78.50,16.70,41862,47133,62130,7418,5066,1329,185,71739,17256
06,03526,0603526,Bakersfield city, California,1,2012,358600,44.30,69.10,9.00,177627,180973,227512,32587,25949,5545,334,194676,163924
06,03666,0603666,Baldwin Park city, California,1,2012,76437,46.40,74.30,8.80,39534,36903,24435,1643,11530,335,352,17667,58770
06,04982,0604982,Bellflower city, California,1,2012,77334,44.40,71.30,10.00,36987,40347,39859,11293,10262,201,0,37147,40187
06,06000,0606000,Berkeley city, California,1,2012,115417,54.70,87.20,13.00,57679,57738,72460,8986,20924,741,243,100568,14849
06,08786,0608786,Buena Park city, California,1,2012,82152,41.50,74.80,13.40,40154,41998,49808,2067,23341,711,664,48969,33183
06,08954,0608954,Burbank city, California,1,2012,104380,46.80,79.60,12.10,50995,53385,79642,2433,10892,179,93,74578,29802
06,10046,0610046,Camarillo city, California,0,2012,65972,37.60,82.80,19.60,32366,33606,50220,2241,6307,247,81,48759,17213
06,11194,0611194,Carlsbad city, California,1,2012,109333,36.90,79.40,14.10,53388,55945,92829,1606,7703,623,0,93296,16037
06,11530,0611530,Carson city, California,1,2012,92992,43.20,77.70,14.60,44935,48057,29205,14637,22099,863,2638,51744,41248
06,13014,0613014,Chico city, California,1,2012,87712,53.20,80.30,12.10,42640,45072,74941,1628,3344,387,153,74293,13419
06,13210,0613210,Chino city, California,1,2012,80181,45.00,78.60,10.10,42052,38129,45171,4067,9021,1313,122,41274,38907
06,13214,0613214,Chino Hills city, California,1,2012,76462,43.10,75.50,7.50,38416,38046,41194,2372,25148,192,0,55075,21387
06,13392,0613392,Chula Vista city, California,1,2012,252424,44.10,73.30,10.60,128245,124179,173959,12625,35082,878,1765,108333,144091
06,13588,0613588,Citrus Heights city, California,1,2012,84862,40.80,78.60,13.80,41802,43060,71151,2158,2333,650,0,68733,16129
06,14218,0614218,Clovis city, California,1,2012,98626,43.90,70.30,9.90,47881,50745,74354,1216,9027,1309,248,68105,30521
06,15044,0615044,Compton city, California,1,2012,97560,46.60,66.20,6.60,46654,50906,15913,30554,524,283,267,33052,64508
06,16000,0616000,Concord city, California,1,2012,124717,42.80,77.90,12.20,62400,62317,82972,8078,16254,607,1393,86801,37916
06,16350,0616350,Corona city, California,1,2012,158388,45.90,70.60,7.40,78142,80246,113387,8748,17969,1347,605,90567,67821
06,16532,0616532,Costa Mesa city, California,1,2012,111910,46.00,78.80,9.20,58018,53892,74348,1827,9704,214,140,73031,38879
06,17918,0617918,Daly City city, California,1,2012,103677,42.40,81.00,14.20,50005,53672,20761,1954,64398,346,205,81815,21862
06,18100,0618100,Davis city, California,0,2012,66009,58.10,83.50,8.80,32846,33163,40897,2226,14662,201,84,56499,9510
06,19766,0619766,Downey city, California,1,2012,112878,43.10,74.00,12.10,53865,59013,73025,4529,10239,72,67,35756,77122
06,20802,0620802,East Los Angeles CDP, California,0,2012,126918,46.90,69.50,9.20,60453,66465,70748,1029,1598,553,33,3780,123138
06,21712,0621712,El Cajon city, California,1,2012,101449,45.10,74.80,10.20,48765,52684,71529,6629,5325,197,2121,72628,28821
06,22020,0622020,Elk Grove city, California,1,2012,159064,42.20,69.80,9.10,78482,80582,71280,17192,44859,630,1592,129450,29614
06,22230,0622230,El Monte city, California,1,2012,115113,44.10,74.30,10.20,55566,59547,58308,429,33146,422,592,39010,76103
06,22804,0622804,Escondido city, California,1,2012,147556,42.70,71.40,11.20,70473,77083,120409,2847,9110,1541,13,83843,63713
06,23182,0623182,Fairfield city, California,1,2012,107676,44.00,75.70,10.20,52352,55324,51527,12926,20059,662,1096,80232,27444
06,24477,0624477,Florence-Graham CDP, California,0,2012,63284,49.50,65.80,5.90,32269,31015,35250,4885,68,978,8,5467,57817
06,24638,0624638,Folsom city, California,1,2012,73381,41.10,74.50,10.80,40160,33221,53465,3466,9979,627,298,64729,8652
06,24680,0624680,Fontana city, California,1,2012,201817,47.10,67.40,5.20,98638,103179,114607,18479,10460,2977,1070,67386,134431
06,26000,0626000,Fremont city, California,1,2012,222001,43.50,75.50,10.30,110093,111908,67213,8251,115288,1534,964,195073,26928
06,27000,0627000,Fresno city, California,1,2012,505870,44.30,70.30,9.70,249701,256169,245070,43739,68813,6128,935,268695,237175
06,28000,0628000,Fullerton city, California,1,2012,138589,46.10,79.20,12.50,70074,68515,75571,2632,39130,400,157,95057,43532
06,29000,0629000,Garden Grove city, California,1,2012,174401,41.60,75.80,11.70,87050,87351,76936,2087,68143,679,388,112115,62286
06,30000,0630000,Glendale city, California,1,2012,194501,39.80,80.00,18.40,92391,102110,144148,3367,30594,657,104,160779,33722
06,32548,0632548,Hawthorne city, California,1,2012,85682,50.10,71.70,7.20,41839,43843,34330,25803,6102,154,760,42008,43674
06,33000,0633000,Hayward city, California,1,2012,149398,43.50,75.90,12.10,71935,77463,58768,21503,35000,1166,2837,90034,59364
06,33182,0633182,Hemet city, California,1,2012,81041,35.20,71.30,19.90,39508,41533,53659,7371,1150,522,157,53568,27473
06,33434,0633434,Hesperia city, California,1,2012,92066,42.30,71.60,10.20,46535,45531,66291,6511,1745,1486,477,48041,44025
06,36000,0636000,Huntington Beach city, California,1,2012,194712,42.30,79.90,13.70,94876,99836,150990,1644,20659,790,501,155259,39453
06,36448,0636448,Indio city, California,1,2012,79308,40.10,70.80,13.80,39287,40021,39738,3228,1579,719,90,26780,52528
06,36546,0636546,Inglewood city, California,1,2012,111174,44.00,73.50,9.80,52203,58971,32872,48566,1178,705,800,55868,55306
06,36770,0636770,Irvine city, California,1,2012,230005,49.10,76.70,9.70,117386,112619,115796,3894,93022,315,173,204432,25573
06,37692,0637692,Jurupa Valley city, California,0,2012,97419,45.20,72.90,8.90,49057,48362,53546,2708,2469,2161,613,30213,67206
06,39496,0639496,Lake Forest city, California,1,2012,78853,41.00,75.40,8.40,39428,39425,54126,879,11673,43,472,58730,20123
06,39892,0639892,Lakewood city, California,1,2012,80835,39.70,77.20,12.20,38606,42229,46904,5776,15544,364,765,57513,23322
06,40130,0640130,Lancaster city, California,1,2012,159041,44.10,69.70,8.40,81918,77123,109865,27353,6956,273,950,93483,65558
06,41992,0641992,Livermore city, California,1,2012,83541,41.40,78.70,11.90,41560,41981,66568,2328,6265,585,695,65166,18375
06,43000,0643000,Long Beach city, California,1,2012,467888,45.50,75.40,9.80,230532,237356,253647,61983,56805,3831,2841,272174,195714
06,44000,0644000,Los Angeles city, California,1,2012,3857786,46.50,77.50,11.00,1918378,1939408,2013642,360124,442498,16392,4853,1989027,1868759
06,44574,0644574,Lynwood city, California,1,2012,70720,47.40,64.40,5.90,34013,36707,17256,6864,300,408,0,8543,62177
06,45484,0645484,Manteca city, California,1,2012,71070,42.70,73.60,10.30,33938,37132,47664,2106,5722,216,0,43507,27563
06,46842,0646842,Menifee city, California,1,2012,81467,38.20,73.70,18.30,39112,42355,64840,4412,2237,252,97,52078,29389
06,46898,0646898,Merced city, California,1,2012,80799,45.20,68.30,9.50,39516,41283,46325,3396,10397,668,0,39920,40879
06,47766,0647766,Milpitas city, California,1,2012,68807,40.50,78.40,10.40,36015,32792,12936,1128,46126,187,116,59887,8920
06,48256,0648256,Mission Viejo city, California,1,2012,95289,35.60,75.70,13.60,46248,49041,79713,717,7269,272,314,81458,13831
06,48354,0648354,Modesto city, California,1,2012,203560,41.70,74.50,12.10,98031,105529,146283,7178,13681,1303,1143,124566,78994
06,49270,0649270,Moreno Valley city, California,1,2012,199561,47.10,71.10,7.80,97667,101894,111335,33734,8539,1571,1000,86426,113135
06,49670,0649670,Mountain View city, California,1,2012,76612,48.60,80.70,10.10,41646,34966,48728,1150,18913,198,400,57810,18802
06,50076,0650076,Murrieta city, California,1,2012,106809,41.90,71.70,10.50,50828,55981,74260,6415,9548,888,717,79074,27735
06,50258,0650258,Napa city, California,1,2012,78332,40.20,76.00,13.60,37952,40380,64641,436,1699,592,0,48122,30210
06,51182,0651182,Newport Beach city, California,1,2012,87060,37.20,82.40,18.70,43470,43590,72694,497,4874,63,347,77208,9852
06,52526,0652526,Norwalk city, California,1,2012,106286,43.10,75.80,12.90,52561,53725,62699,5342,16111,586,1346,36743,69543
06,53000,0653000,Oakland city, California,1,2012,400740,45.00,78.50,11.30,194880,205860,164376,102456,64663,2536,2570,293461,107279
06,53322,0653322,Oceanside city, California,1,2012,171272,41.80,76.20,13.40,86278,84994,109963,7936,11577,771,2076,109675,61597
06,53896,0653896,Ontario city, California,1,2012,167207,44.80,72.90,8.20,82667,84540,95983,7469,9470,1349,0,45149,122058
06,53980,0653980,Orange city, California,1,2012,139425,46.40,79.70,11.60,68762,70663,92068,2461,16859,746,1665,87792,51633
06,54652,0654652,Oxnard city, California,1,2012,201565,46.40,71.60,9.00,104241,97324,150691,6272,15163,1754,773,50548,151017
06,55156,0655156,Palmdale city, California,1,2012,155660,43.50,67.90,8.20,76224,79436,70519,17176,4694,596,149,59591,96069
06,55282,0655282,Palo Alto city, California,0,2012,66359,35.40,77.80,16.80,32030,34329,42502,800,19788,49,0,61574,4785
06,56000,0656000,Pasadena city, California,1,2012,138553,45.60,81.70,15.70,67221,71332,85532,16124,21230,695,112,98724,39829
06,56700,0656700,Perris city, California,1,2012,71327,48.10,61.40,5.10,34511,36816,37602,11195,3485,436,0,23302,48025
06,57456,0657456,Pittsburg city, California,0,2012,65655,43.30,71.10,8.80,31109,34546,23213,13899,9731,140,995,39584,26071
06,57792,0657792,Pleasanton city, California,1,2012,72326,35.80,75.50,12.20,35453,36873,49138,1413,17203,22,186,61523,10803
06,58072,0658072,Pomona city, California,1,2012,150817,47.90,72.10,8.30,73042,77775,98793,10248,14090,1399,363,44408,106409
06,59444,0659444,Rancho Cordova city, California,0,2012,66999,41.80,75.10,12.90,33333,33666,41720,5927,7441,362,1413,54986,12013
06,59451,0659451,Rancho Cucamonga city, California,1,2012,170740,42.80,76.10,9.40,83006,87734,109667,14011,24949,392,294,105812,64928
06,59920,0659920,Redding city, California,1,2012,90750,41.10,79.50,19.10,46047,44703,78898,1692,4421,2081,0,82988,7762
06,59962,0659962,Redlands city, California,1,2012,69908,37.80,75.90,15.60,33992,35916,53606,2456,5617,896,0,50560,19348
06,60018,0660018,Redondo Beach city, California,1,2012,67683,42.10,78.60,11.20,33720,33963,49057,1902,8031,237,0,56349,11334
06,60102,0660102,Redwood City city, California,1,2012,79005,43.50,76.90,10.80,40792,38213,57660,2219,8091,106,318,46184,32821
06,60466,0660466,Rialto city, California,1,2012,101747,46.60,65.80,6.20,51368,50379,64166,14140,2381,888,0,24775,76972
06,60620,0660620,Richmond city, California,1,2012,106526,43.90,75.60,9.80,51707,54819,49703,27395,13681,452,607,64186,42340
06,62000,0662000,Riverside city, California,1,2012,313700,46.50,73.80,9.70,155676,158024,201768,18038,20773,2976,648,150157,163543
06,62938,0662938,Roseville city, California,1,2012,124525,38.50,75.50,15.00,58081,66444,97596,1610,11086,192,199,105630,18895
06,64000,0664000,Sacramento city, California,1,2012,475524,44.70,76.20,11.30,227955,247569,232757,71297,87977,2665,6729,343427,132097
06,64224,0664224,Salinas city, California,1,2012,154463,47.60,68.60,7.70,78504,75959,105402,2761,11471,933,394,36057,118406
06,65000,0665000,San Bernardino city, California,1,2012,213298,46.50,69.70,8.30,107045,106253,112628,27947,10766,2689,779,83665,129633
06,65042,0665042,San Buenaventura (Ventura) city, California,1,2012,107755,38.90,78.80,14.90,51828,55927,89488,1935,4969,287,173,74690,33065
06,66000,0666000,San Diego city, California,1,2012,1338354,48.10,79.20,11.30,670519,667835,852307,87569,230434,11130,5814,929566,408788
06,67000,0667000,San Francisco city, California,1,2012,825863,48.80,86.60,14.00,419784,406079,409803,46406,274340,2640,3381,698987,126876
06,68000,0668000,San Jose city, California,1,2012,982783,43.70,75.70,10.90,494487,488296,453617,30619,325098,6287,5174,656955,325828
06,68084,0668084,San Leandro city, California,1,2012,86884,41.10,80.80,13.20,43240,43644,34179,10009,27678,1010,1508,63734,23150
06,68196,0668196,San Marcos city, California,1,2012,86756,44.00,74.90,11.40,40808,45948,66933,1886,6671,269,409,60348,26408
06,68252,0668252,San Mateo city, California,1,2012,99653,42.90,80.20,14.70,48469,51184,63584,1706,18918,486,1791,72165,27488
06,68378,0668378,San Ramon city, California,1,2012,73922,40.20,72.00,8.80,35814,38108,37980,1802,27583,251,232,68611,5311
06,69000,0669000,Santa Ana city, California,1,2012,330913,49.20,70.80,6.70,165599,165314,174088,3887,32089,1843,655,70179,260734
06,69070,0669070,Santa Barbara city, California,1,2012,89638,42.40,80.40,15.50,45666,43972,67966,2038,2919,407,74,53525,36113
06,69084,0669084,Santa Clara city, California,1,2012,119307,48.10,76.50,9.70,59759,59548,55488,6070,45662,719,270,96215,23092
06,69088,0669088,Santa Clarita city, California,1,2012,179005,39.60,74.70,11.10,88866,90139,131553,3282,17966,360,396,121063,57942
06,69196,0669196,Santa Maria city, California,1,2012,101469,45.60,70.60,10.10,53229,48240,67231,1696,5657,1177,576,30582,70887
06,70000,0670000,Santa Monica city, California,1,2012,91814,46.00,86.40,14.10,44445,47369,73780,3078,8579,235,330,74057,17757
06,70098,0670098,Santa Rosa city, California,1,2012,170684,39.20,76.80,14.00,83382,87302,129599,2834,7489,2633,1439,118813,51871
06,72016,0672016,Simi Valley city, California,1,2012,125794,38.90,73.60,11.10,62490,63304,96173,2229,11134,335,123,96731,29063
06,73080,0673080,South Gate city, California,1,2012,95297,49.00,71.50,8.70,47883,47414,47633,854,547,930,0,3263,92034
06,73262,0673262,South San Francisco city, California,0,2012,65565,41.00,74.90,11.80,32568,32997,26360,1626,23314,286,1838,42080,23485
06,75000,0675000,Stockton city, California,1,2012,297975,42.40,68.60,10.30,143947,154028,122464,32986,63383,3059,3364,177737,120238
06,77000,0677000,Sunnyvale city, California,1,2012,146199,46.40,76.70,10.80,75394,70805,71663,3951,58560,644,649,114898,31301
06,78120,0678120,Temecula city, California,1,2012,105213,43.50,68.20,7.20,51383,53830,80152,2337,12031,1452,36,80385,24828
06,78582,0678582,Thousand Oaks city, California,1,2012,128411,36.90,75.60,15.20,64030,64381,104423,1090,9844,106,81,103878,24533
06,80000,0680000,Torrance city, California,1,2012,147036,38.60,78.90,15.80,71747,75289,74888,4917,49749,122,655,118035,29001
06,80238,0680238,Tracy city, California,1,2012,84682,42.10,70.60,9.60,43195,41487,54145,5124,9700,158,124,48040,36642
06,80812,0680812,Turlock city, California,1,2012,69735,42.10,72.70,13.80,33597,36138,56806,1082,6019,123,198,45648,24087
06,80854,0680854,Tustin city, California,1,2012,78044,46.30,71.20,7.90,38252,39792,37723,2814,16918,84,128,46685,31359
06,81204,0681204,Union City city, California,1,2012,71749,40.80,74.90,12.50,35001,36748,18502,4702,34583,781,1156,55439,16310
06,81344,0681344,Upland city, California,1,2012,75208,41.00,75.20,14.00,35662,39546,46607,3963,5192,401,0,45279,29929
06,81554,0681554,Vacaville city, California,1,2012,93899,42.10,75.00,11.10,50278,43621,63287,6935,6861,196,543,74300,19599
06,81666,0681666,Vallejo city, California,1,2012,117814,40.80,78.20,13.10,56908,60906,52357,26370,26260,529,1125,87022,30792
06,82590,0682590,Victorville city, California,1,2012,120327,45.90,66.10,9.00,58379,61948,70094,32116,3164,1471,72,63821,56506
06,82954,0682954,Visalia city, California,1,2012,127072,44.50,70.10,11.10,61595,65477,97344,1985,8829,1549,87,68198,58874
06,82996,0682996,Vista city, California,1,2012,96046,45.30,77.20,11.50,48178,47868,80970,3346,3191,1102,99,48938,47108
06,83346,0683346,Walnut Creek city, California,0,2012,65696,31.00,83.60,27.80,30347,35349,54272,261,8469,657,0,61020,4676
06,84200,0684200,West Covina city, California,1,2012,107472,45.10,75.50,12.80,51914,55558,39311,4262,26944,1015,160,47189,60283
06,84550,0684550,Westminster city, California,1,2012,91355,39.90,77.70,16.70,45124,46231,32701,632,47561,89,327,73281,18074
06,85292,0685292,Whittier city, California,1,2012,86159,44.80,77.30,11.80,41956,44203,52973,914,3920,52,371,26087,60072
06,86832,0686832,Yorba Linda city, California,0,2012,66739,35.40,76.50,15.50,32185,34554,47445,67,13667,0,0,55670,11069
06,86972,0686972,Yuba City city, California,0,2012,65105,43.90,73.40,12.60,33191,31914,42388,1218,12119,726,0,47148,17957
08,03455,0803455,Arvada city, Colorado,1,2012,109315,34.90,77.90,15.90,53305,56010,98113,984,1907,1058,26,93596,15719
08,04000,0804000,Aurora city, Colorado,1,2012,338835,43.60,73.30,9.90,168352,170483,223122,56817,14916,3243,808,243919,94916
08,07850,0807850,Boulder city, Colorado,1,2012,101812,58.90,85.10,9.30,50702,51110,91562,1352,3726,93,19,92889,8923
08,12815,0812815,Centennial city, Colorado,1,2012,103735,34.80,74.60,13.90,50819,52916,88763,2561,4805,817,319,95842,7893
08,16000,0816000,Colorado Springs city, Colorado,1,2012,431846,43.10,76.00,11.60,214440,217406,348013,28963,13552,2172,636,357287,74559
08,20000,0820000,Denver city, Colorado,1,2012,634265,48.40,78.30,10.50,317233,317032,479745,64566,21689,5941,464,434399,199866
08,27425,0827425,Fort Collins city, Colorado,1,2012,148634,53.20,80.90,8.40,73287,75347,131686,2081,4415,751,373,131815,16819
08,32155,0832155,Greeley city, Colorado,1,2012,95365,46.70,75.30,12.00,47098,48267,69531,2114,1776,1532,35,62990,32375
08,36410,0836410,Highlands Ranch CDP, Colorado,0,2012,101898,39.30,71.10,7.90,51276,50622,90853,508,7763,207,0,94597,7301
08,43000,0843000,Lakewood city, Colorado,1,2012,145522,42.60,79.50,13.90,71927,73595,129486,2412,4654,2336,0,112972,32550
08,45970,0845970,Longmont city, Colorado,1,2012,88636,43.10,75.20,11.70,47119,41517,76416,1832,3624,464,0,64521,24115
08,46465,0846465,Loveland city, Colorado,1,2012,70214,36.10,76.30,15.10,34525,35689,61977,108,747,155,0,61351,8863
08,62000,0862000,Pueblo city, Colorado,1,2012,107775,39.10,76.30,16.20,51325,56450,79933,2736,430,2134,0,51247,56528
08,77290,0877290,Thornton city, Colorado,1,2012,124131,45.10,69.70,7.10,61642,62489,107507,1158,7043,632,78,86484,37647
08,83835,0883835,Westminster city, Colorado,1,2012,109181,41.50,77.70,10.00,54269,54912,91743,1367,6700,582,0,87429,21752
09,08000,0908000,Bridgeport city, Connecticut,1,2012,146434,47.20,75.00,9.80,71262,75172,61154,52636,4767,971,0,86177,60257
09,18430,0918430,Danbury city, Connecticut,1,2012,82783,46.50,82.60,12.70,41435,41348,52751,7517,5519,223,253,64434,18349
09,37000,0937000,Hartford city, Connecticut,1,2012,124887,48.30,74.80,8.60,61378,63509,54065,47485,3134,566,28,70630,54257
09,50370,0950370,New Britain city, Connecticut,1,2012,73148,43.80,75.20,11.00,34040,39108,49952,6600,1604,0,0,43716,29432
09,52000,0952000,New Haven city, Connecticut,1,2012,130749,51.60,77.30,10.40,62720,68029,55794,48665,5997,327,63,96932,33817
09,55990,0955990,Norwalk city, Connecticut,1,2012,87196,39.80,80.10,14.80,43724,43472,60975,14518,5287,238,0,68956,18240
09,73000,0973000,Stamford city, Connecticut,1,2012,125102,44.00,76.40,12.70,61575,63527,81386,16103,9846,143,62,92735,32367
09,80000,0980000,Waterbury city, Connecticut,1,2012,109915,41.70,74.70,12.40,53857,56058,73722,20998,1296,475,0,70985,38930
10,77580,1077580,Wilmington city, Delaware,1,2012,71289,43.10,76.20,12.80,32771,38518,26947,39561,806,102,0,60245,11044
11,50000,1150000,Washington city, District of Columbia,1,2012,632323,51.20,82.70,11.40,299036,333287,250657,313224,21858,2258,54,569597,62726
12,00410,1200410,Alafaya CDP, Florida,0,2012,85334,46.60,72.70,7.90,41455,43879,60789,8009,10499,310,0,52190,33144
12,07300,1207300,Boca Raton city, Florida,1,2012,87848,36.80,80.30,20.20,43048,44800,76469,5204,2511,0,0,77283,10565
12,07875,1207875,Boynton Beach city, Florida,1,2012,70120,39.00,80.20,22.30,32918,37202,41745,20697,3638,120,0,60314,9806
12,08150,1208150,Brandon CDP, Florida,0,2012,101167,44.20,76.10,11.10,48682,52485,72018,19139,2217,134,13,79827,21340
12,10275,1210275,Cape Coral city, Florida,1,2012,161237,33.10,77.40,17.60,78778,82459,144166,9008,3050,1010,0,129434,31803
12,12875,1212875,Clearwater city, Florida,1,2012,108732,34.70,80.70,21.00,51784,56948,88290,11724,3349,124,82,96150,12582
12,14400,1214400,Coral Springs city, Florida,1,2012,125275,42.00,73.70,8.60,59216,66059,87281,23628,6075,130,0,95841,29434
12,16475,1216475,Davie town, Florida,1,2012,95492,39.60,78.30,12.90,45511,49981,73837,10446,4316,0,0,64087,31405
12,16725,1216725,Deerfield Beach city, Florida,1,2012,77426,35.30,80.00,21.90,36624,40802,47608,26006,655,0,0,67789,9637
12,17200,1217200,Deltona city, Florida,1,2012,85436,40.00,78.30,14.80,41969,43467,70027,7440,1292,561,249,55827,29609
12,24000,1224000,Fort Lauderdale city, Florida,1,2012,170747,38.80,79.60,16.00,88017,82730,106854,51586,2824,157,320,141420,29327
12,24125,1224125,Fort Myers city, Florida,0,2012,65733,38.60,83.20,19.90,32714,33019,43526,19396,969,136,0,54826,10907
12,25175,1225175,Gainesville city, Florida,1,2012,126038,62.80,85.70,7.50,61036,65002,83661,25371,8866,450,196,112990,13048
12,30000,1230000,Hialeah city, Florida,1,2012,231953,40.40,81.30,18.70,111493,120460,218084,7367,1444,0,0,11980,219973
12,32000,1232000,Hollywood city, Florida,1,2012,145241,37.40,79.90,16.50,72482,72759,106545,22264,3569,288,0,96815,48426
12,35000,1235000,Jacksonville city, Florida,1,2012,836507,42.40,76.70,11.70,404710,431797,505082,250500,37272,2467,1058,767713,68794
12,36100,1236100,Kendall CDP, Florida,0,2012,75640,37.10,80.50,16.60,35507,40133,68198,3764,1872,186,0,29969,45671
12,38250,1238250,Lakeland city, Florida,1,2012,100009,38.50,76.20,19.10,47900,52109,75649,18634,773,214,118,84617,15392
12,39425,1239425,Largo city, Florida,1,2012,77871,34.00,84.30,25.10,36543,41328,67176,5135,1682,380,63,68860,9011
12,39550,1239550,Lauderhill city, Florida,1,2012,69083,39.10,75.80,13.30,32001,37082,13764,52055,1237,370,0,64647,4436
12,39925,1239925,Lehigh Acres CDP, Florida,0,2012,104011,42.90,70.90,12.20,53952,50059,70670,17610,500,554,0,64214,39797
12,43975,1243975,Melbourne city, Florida,1,2012,77047,34.50,82.60,21.20,37009,40038,64240,7400,2751,0,0,70309,6738
12,45000,1245000,Miami city, Florida,1,2012,413864,42.80,81.20,15.60,209756,204108,313496,82688,4652,557,0,130757,283107
12,45025,1245025,Miami Beach city, Florida,1,2012,90579,45.30,84.40,15.50,46532,44047,67190,4518,2376,152,112,44244,46335
12,45060,1245060,Miami Gardens city, Florida,1,2012,110739,44.00,76.00,11.80,51250,59489,23560,82454,679,0,0,83811,26928
12,45975,1245975,Miramar city, Florida,1,2012,128737,46.60,74.80,7.50,60274,68463,57927,57404,3526,48,0,78301,50436
12,53000,1253000,Orlando city, Florida,1,2012,249525,50.60,77.00,9.20,116126,133399,142314,77311,7653,394,36,180652,68873
12,54000,1254000,Palm Bay city, Florida,1,2012,104136,34.10,76.90,18.30,47435,56701,82113,16082,1571,0,0,87633,16503
12,54200,1254200,Palm Coast city, Florida,1,2012,79980,31.20,79.10,24.20,36924,43056,61002,10990,1825,0,64,71846,8134
12,55775,1255775,Pembroke Pines city, Florida,1,2012,160292,39.30,78.40,15.30,76521,83771,106064,32182,7898,458,93,89722,70570
12,56825,1256825,Pine Hills CDP, Florida,0,2012,69219,44.30,70.30,10.20,34822,34397,10413,50698,1233,180,0,61470,7749
12,57425,1257425,Plantation city, Florida,1,2012,88019,39.50,79.40,15.80,42696,45323,61106,16910,3884,0,0,68769,19250
12,58050,1258050,Pompano Beach city, Florida,1,2012,102968,39.00,82.00,17.40,54494,48474,63110,32270,1245,146,243,86247,16721
12,58715,1258715,Port St. Lucie city, Florida,1,2012,168718,36.70,75.00,17.20,81988,86730,126452,27863,2924,401,228,135788,32930
12,60950,1260950,Riverview CDP, Florida,0,2012,79420,41.30,73.60,8.70,40470,38950,58280,14864,1246,32,0,64962,14458
12,63000,1263000,St. Petersburg city, Florida,1,2012,246533,39.30,81.80,17.10,120515,126018,169944,60839,7368,832,121,225799,20734
12,68350,1268350,Spring Hill CDP, Florida,0,2012,101269,33.60,79.10,23.30,47902,53367,89295,4839,1828,77,0,86226,15043
12,69700,1269700,Sunrise city, Florida,1,2012,88859,41.60,78.00,14.20,38985,49874,52031,25941,4840,51,0,62200,26659
12,70600,1270600,Tallahassee city, Florida,1,2012,186977,60.50,83.10,8.30,89040,97937,107303,64337,7351,355,0,173911,13066
12,71000,1271000,Tampa city, Florida,1,2012,347650,45.40,77.70,10.90,169497,178153,225771,86746,13124,624,126,265595,82055
12,72145,1272145,Town 'n' Country CDP, Florida,0,2012,81597,44.70,78.60,12.50,42213,39384,65745,5893,3140,282,0,47198,34399
12,76582,1276582,Weston city, Florida,0,2012,67645,40.00,69.50,7.70,32200,35445,54911,3248,4921,84,0,36642,31003
12,76600,1276600,West Palm Beach city, Florida,1,2012,101910,41.40,82.10,17.10,49206,52704,66073,29545,1720,73,0,79900,22010
13,01052,1301052,Albany city, Georgia,1,2012,79150,43.40,73.90,12.10,37199,41951,20993,55507,904,22,0,77137,2013
13,03440,1303440,Athens-Clarke County unified government (balance), Georgia,1,2012,118866,59.40,82.30,9.00,55528,63338,78220,32149,5031,366,0,106048,12818
13,04000,1304000,Atlanta city, Georgia,1,2012,443768,52.90,81.60,9.60,223655,220113,173766,237154,17449,1351,308,420446,23322
13,04204,1304204,Augusta-Richmond County consolidated government (balance), Georgia,1,2012,197696,43.00,75.70,12.10,96043,101653,76825,109162,3419,932,0,188717,8979
13,19000,1319000,Columbus city, Georgia,1,2012,198413,43.70,74.60,11.40,97554,100859,92326,89055,4368,564,178,184151,14262
13,42425,1342425,Johns Creek city, Georgia,1,2012,82325,38.00,70.00,5.40,39801,42524,53847,10427,14726,90,0,77534,4791
13,49000,1349000,Macon city, Georgia,1,2012,91271,40.70,72.70,13.00,41158,50113,26416,61846,628,26,0,88387,2884
13,67284,1367284,Roswell city, Georgia,1,2012,93683,37.40,75.70,13.50,47866,45817,75684,11282,4353,563,0,81548,12135
13,68516,1368516,Sandy Springs city, Georgia,1,2012,99423,48.10,77.70,11.20,47083,52340,69092,17427,6629,108,0,84281,15142
13,69000,1369000,Savannah city, Georgia,1,2012,142010,46.90,77.40,12.20,68149,73861,54817,79663,2874,567,144,134070,7940
13,80508,1380508,Warner Robins city, Georgia,1,2012,70970,45.00,73.20,9.60,33507,37463,35223,27358,987,84,238,64904,6066
15,71550,1571550,Urban Honolulu CDP, Hawaii,0,2012,345604,40.90,82.70,17.70,172670,172934,58816,5885,190481,370,29365,321952,23652
16,08830,1608830,Boise City city, Idaho,1,2012,212299,42.80,78.10,11.90,106562,105737,191564,2530,7369,2056,179,196866,15433
16,52120,1652120,Meridian city, Idaho,1,2012,80391,41.00,66.10,10.90,38881,41510,-998,-998,-998,-998,-998,73672,6719
16,56260,1656260,Nampa city, Idaho,1,2012,83932,43.90,67.40,10.60,40145,43787,-998,-998,-998,-998,-998,66053,17879
17,02154,1702154,Arlington Heights village, Illinois,1,2012,74976,33.40,77.70,21.50,36299,38677,67806,1132,4452,79,0,70571,4405
17,03012,1703012,Aurora city, Illinois,1,2012,203318,44.80,69.10,7.50,102797,100521,116142,18137,14501,1168,0,113218,90100
17,06613,1706613,Bloomington city, Illinois,1,2012,77733,43.10,75.80,11.30,36722,41011,60932,9008,4950,40,0,74650,3083
17,07133,1707133,Bolingbrook village, Illinois,1,2012,77155,44.80,70.00,7.40,39347,37808,39818,17660,8276,599,0,61722,15433
17,12385,1712385,Champaign city, Illinois,1,2012,82509,58.10,84.20,8.60,42726,39783,55545,11310,12277,99,0,78373,4136
17,14000,1714000,Chicago city, Illinois,1,2012,2714844,47.60,77.40,10.90,1315782,1399062,1311393,866026,160568,8066,979,1926336,788508
17,14351,1714351,Cicero town, Illinois,1,2012,84129,50.60,65.00,4.90,44091,40038,41733,2905,468,314,0,8711,75418
17,18823,1718823,Decatur city, Illinois,1,2012,76346,37.40,77.70,17.10,36547,39799,54797,16585,1012,0,0,74404,1942
17,23074,1723074,Elgin city, Illinois,1,2012,109290,44.20,70.10,9.20,54154,55136,69812,9327,4641,750,0,60282,49008
17,24582,1724582,Evanston city, Illinois,1,2012,75420,47.70,78.50,11.30,35181,40239,49363,14265,8034,0,0,68140,7280
17,38570,1738570,Joliet city, Illinois,1,2012,146781,44.90,71.50,8.80,72672,74109,100674,19687,2837,905,37,107183,39598
17,51622,1751622,Naperville city, Illinois,1,2012,145137,37.20,72.30,10.70,71443,73694,104750,8414,25973,162,0,135318,9819
17,57225,1757225,Palatine village, Illinois,1,2012,69254,40.20,76.00,12.40,33644,35610,51338,2543,9319,0,740,59091,10163
17,59000,1759000,Peoria city, Illinois,1,2012,116845,43.30,75.30,13.00,56540,60305,73170,31270,6040,682,0,109958,6887
17,65000,1765000,Rockford city, Illinois,1,2012,151019,39.10,74.70,14.90,73312,77707,99044,30526,4287,139,0,125016,26003
17,68003,1768003,Schaumburg village, Illinois,1,2012,74228,40.60,78.00,14.00,35473,38755,50729,3079,14488,0,0,64791,9437
17,70122,1770122,Skokie village, Illinois,0,2012,65076,34.80,77.40,15.70,30636,34440,41226,3891,17293,66,0,57971,7105
17,72000,1772000,Springfield city, Illinois,1,2012,117019,39.50,76.70,14.20,56657,60362,88162,22167,2610,314,0,113619,3400
17,79293,1779293,Waukegan city, Illinois,1,2012,86273,43.60,70.70,8.60,43687,42586,59180,15817,3415,217,0,38196,48077
18,05860,1805860,Bloomington city, Indiana,1,2012,78592,69.30,88.90,8.60,40247,38345,64325,3214,7552,639,67,75556,3036
18,10342,1810342,Carmel city, Indiana,1,2012,84515,37.20,73.10,11.10,40773,43742,69952,3390,7223,107,0,81770,2745
18,22000,1822000,Evansville city, Indiana,1,2012,120059,41.00,78.60,15.10,56031,64028,99683,13287,837,646,26,115957,4102
18,23278,1823278,Fishers town, Indiana,1,2012,82087,39.90,69.70,5.70,39462,42625,71985,3070,3407,294,0,78729,3358
18,25000,1825000,Fort Wayne city, Indiana,1,2012,252427,40.70,74.30,13.30,122279,130148,184069,41147,9720,913,936,230686,21741
18,27000,1827000,Gary city, Indiana,1,2012,75611,35.10,72.80,16.40,34389,41222,9031,64453,116,104,0,72518,3093
18,31000,1831000,Hammond city, Indiana,1,2012,79686,41.70,72.30,9.90,38964,40722,37448,18775,971,449,85,52364,27322
18,36003,1836003,Indianapolis city (balance), Indiana,1,2012,835806,43.50,75.00,10.80,402471,433335,511806,229068,18298,2949,0,752188,83618
18,40788,1840788,Lafayette city, Indiana,1,2012,66820,45.60,76.60,12.70,32308,34512,58704,5436,769,91,0,57630,9190
18,51876,1851876,Muncie city, Indiana,1,2012,69841,52.10,83.70,13.10,32457,37384,58776,3631,837,219,0,68027,1814
18,71000,1871000,South Bend city, Indiana,1,2012,100003,41.30,72.20,12.20,49285,50718,61156,26958,1414,470,53,85518,14485
19,12000,1912000,Cedar Rapids city, Iowa,1,2012,128124,42.40,76.60,12.90,62798,65326,111093,8550,2988,202,86,122868,5256
19,19000,1919000,Davenport city, Iowa,1,2012,101354,40.50,77.30,13.00,50082,51272,83578,10206,1475,407,0,93412,7942
19,21000,1921000,Des Moines city, Iowa,1,2012,206568,42.90,74.80,11.20,100899,105669,159799,21311,10833,923,139,179977,26591
19,38595,1938595,Iowa City city, Iowa,1,2012,70131,59.90,84.60,8.50,35649,34482,55490,4100,6316,0,0,65732,4399
19,73335,1973335,Sioux City city, Iowa,1,2012,84297,40.20,74.60,12.90,42170,42127,70239,2706,2379,1518,0,69979,14318
19,82425,1982425,Waterloo city, Iowa,1,2012,68294,39.70,76.70,14.60,33701,34593,54401,10381,823,0,0,63617,4677
20,36000,2036000,Kansas City city, Kansas,1,2012,145410,40.70,71.80,11.10,71406,74004,87070,38888,4146,1378,828,104224,41186
20,38900,2038900,Lawrence city, Kansas,1,2012,88634,59.20,82.80,8.30,43369,45265,74778,3726,4396,1808,81,82727,5907
20,52575,2052575,Olathe city, Kansas,1,2012,130031,43.60,70.60,7.40,63343,66688,112816,6485,4912,363,107,114662,15369
20,53775,2053775,Overland Park city, Kansas,1,2012,178941,39.40,77.00,14.10,88836,90105,150739,7656,14129,256,36,166809,12132
20,71000,2071000,Topeka city, Kansas,1,2012,127942,39.30,75.20,15.20,61052,66890,99200,13004,1921,1371,0,109815,18127
20,79000,2079000,Wichita city, Kansas,1,2012,385586,40.50,74.30,12.30,190196,195390,297088,43503,18928,4272,24,326343,59243
21,46027,2146027,Lexington-Fayette urban county, Kentucky,1,2012,305489,47.20,78.90,11.00,150269,155220,235352,42816,10493,511,45,284170,21319
21,48006,2148006,Louisville/Jefferson County metro government (balance), Kentucky,1,2012,605108,40.50,76.80,13.00,294111,310997,430659,138894,13352,543,208,575717,29391
22,05000,2205000,Baton Rouge city, Louisiana,1,2012,230040,48.20,80.10,11.60,111949,118091,88624,127558,7794,624,0,224255,5785
22,39475,2239475,Kenner city, Louisiana,1,2012,66813,38.80,81.50,15.50,32331,34482,42257,16679,2894,122,0,55200,11613
22,40735,2240735,Lafayette city, Louisiana,1,2012,122749,46.60,76.90,11.40,59772,62977,78367,36838,2820,215,13,117065,5684
22,41155,2241155,Lake Charles city, Louisiana,1,2012,73481,41.10,77.20,13.10,34655,38826,34153,34609,1870,105,0,70458,3023
22,50115,2250115,Metairie CDP, Louisiana,0,2012,137210,40.90,80.30,17.10,65985,71225,110059,15212,5418,657,0,118419,18791
22,55000,2255000,New Orleans city, Louisiana,1,2012,369250,44.30,78.60,11.40,177208,192042,125220,220735,10775,1235,0,349593,19657
22,70000,2270000,Shreveport city, Louisiana,1,2012,201878,40.50,75.40,13.30,95818,106060,84900,109836,3229,402,55,195739,6139
23,60545,2360545,Portland city, Maine,1,2012,66211,48.90,83.00,11.90,32476,33735,54690,4693,4198,76,0,64247,1964
24,04000,2404000,Baltimore city, Maryland,1,2012,621342,44.60,78.50,11.90,292599,328743,187742,394998,15757,1862,46,593771,27571
24,19125,2419125,Columbia CDP, Maryland,0,2012,104129,42.00,75.10,10.60,51358,52771,58455,24761,12427,249,516,96048,8081
24,26000,2426000,Ellicott City CDP, Maryland,0,2012,71933,34.70,73.00,13.90,34902,37031,46367,7948,14608,0,0,68962,2971
24,30325,2430325,Frederick city, Maryland,0,2012,66390,44.40,78.50,12.50,31083,35307,44246,11815,2802,601,229,55894,10496
24,32025,2432025,Germantown CDP, Maryland,0,2012,91541,43.50,73.50,6.80,43822,47719,45408,17747,19917,232,0,71503,20038
24,32650,2432650,Glen Burnie CDP, Maryland,0,2012,70285,41.70,80.40,12.70,32689,37596,46515,15235,4227,49,148,66249,4036
24,72450,2472450,Silver Spring CDP, Maryland,0,2012,73958,51.50,81.70,7.90,34917,39041,31325,20286,8020,93,0,57200,16758
24,81175,2481175,Waldorf CDP, Maryland,0,2012,72890,45.30,72.80,6.60,34753,38137,26082,39777,2787,1099,0,67592,5298
25,07000,2507000,Boston city, Massachusetts,1,2012,637516,54.50,82.70,10.50,306561,330955,340877,166148,58186,2300,0,518942,118574
25,09000,2509000,Brockton city, Massachusetts,1,2012,94092,38.90,73.60,14.20,45778,48314,45298,37817,1947,278,0,86737,7355
25,11000,2511000,Cambridge city, Massachusetts,1,2012,106456,61.60,89.80,11.90,52607,53849,75710,12152,12243,243,46,98995,7461
25,23000,2523000,Fall River city, Massachusetts,1,2012,88943,38.00,79.70,15.50,42070,46873,76759,3320,1544,244,0,81402,7541
25,24960,2524960,Framingham CDP, Massachusetts,0,2012,70076,44.20,81.60,14.20,33599,36477,52737,5319,5587,5,0,60230,9846
25,34550,2534550,Lawrence city, Massachusetts,1,2012,77321,45.40,70.60,8.80,36316,41005,28797,10446,1988,203,0,18204,59117
25,37000,2537000,Lowell city, Massachusetts,1,2012,108528,46.40,78.00,9.90,53078,55450,60370,7814,22954,611,0,89502,19026
25,37490,2537490,Lynn city, Massachusetts,1,2012,91247,43.50,73.00,10.90,45273,45974,46406,10831,6741,60,53,58992,32255
25,45000,2545000,New Bedford city, Massachusetts,1,2012,94929,41.00,78.40,17.10,45835,49094,73724,7022,1031,777,0,78888,16041
25,45560,2545560,Newton city, Massachusetts,1,2012,86304,37.80,76.60,16.90,39893,46411,68295,3188,12403,8,0,82355,3949
25,55745,2555745,Quincy city, Massachusetts,1,2012,93031,45.60,84.40,13.70,45940,47091,61727,4568,23021,169,0,89746,3285
25,62535,2562535,Somerville city, Massachusetts,1,2012,77112,62.70,85.20,8.60,36317,40795,57074,6453,9268,36,0,70644,6468
25,67000,2567000,Springfield city, Massachusetts,1,2012,153557,43.00,73.30,11.40,73411,80146,84052,31844,2593,1087,0,88061,65496
25,82000,2582000,Worcester city, Massachusetts,1,2012,182680,45.00,76.10,11.20,87696,94984,131261,23637,11225,520,0,145153,37527
26,03000,2603000,Ann Arbor city, Michigan,1,2012,116128,59.10,86.20,10.40,57942,58186,84544,8154,19000,168,0,111977,4151
26,21000,2621000,Dearborn city, Michigan,1,2012,96470,38.40,70.00,12.60,46011,50459,86508,3882,1621,182,0,93142,3328
26,22000,2622000,Detroit city, Michigan,1,2012,701524,41.60,74.60,12.20,331941,369583,87281,572298,7569,2580,42,649103,52421
26,27440,2627440,Farmington Hills city, Michigan,1,2012,80752,36.60,79.70,15.80,38285,42467,54497,13915,9106,490,0,78546,2206
26,29000,2629000,Flint city, Michigan,1,2012,100515,39.90,75.50,12.80,48809,51706,39531,56638,202,483,0,96489,4026
26,34000,2634000,Grand Rapids city, Michigan,1,2012,190426,47.60,75.10,10.90,92359,98067,132308,37894,4529,1008,0,159904,30522
26,42160,2642160,Kalamazoo city, Michigan,1,2012,75092,54.70,80.10,10.20,36645,38447,51555,17175,2049,315,0,70889,4203
26,46000,2646000,Lansing city, Michigan,1,2012,113488,48.10,76.90,9.60,52941,60547,71038,26068,4308,749,140,101046,12442
26,49000,2649000,Livonia city, Michigan,1,2012,95576,35.60,78.40,16.50,47448,48128,88700,2268,2427,152,0,93198,2378
26,69035,2669035,Rochester Hills city, Michigan,1,2012,72288,34.60,78.40,16.90,35365,36923,58795,6471,5483,103,9,71213,1075
26,74900,2674900,Southfield city, Michigan,1,2012,72502,35.10,80.00,20.10,32561,39941,20512,47513,1259,126,0,70574,1928
26,76460,2676460,Sterling Heights city, Michigan,1,2012,130414,40.20,78.60,14.20,63970,66444,111601,6821,9161,36,0,127937,2477
26,80700,2680700,Troy city, Michigan,1,2012,82211,38.40,79.00,14.80,39744,42467,62481,2516,15015,72,0,80510,1701
26,84000,2684000,Warren city, Michigan,1,2012,134155,38.40,77.60,16.60,64559,69596,101118,21321,6267,201,0,131286,2869
26,86000,2686000,Westland city, Michigan,1,2012,82868,41.20,77.80,13.10,40951,41917,61477,14851,3198,245,0,79267,3601
26,88940,2688940,Wyoming city, Michigan,1,2012,73374,43.30,76.00,8.50,38798,34576,63033,3088,1552,1070,0,59468,13906
27,06616,2706616,Bloomington city, Minnesota,1,2012,86031,36.30,81.40,19.10,40764,45267,67130,6710,5195,175,264,78604,7427
27,07966,2707966,Brooklyn Park city, Minnesota,1,2012,77762,41.20,71.70,9.90,39527,38235,43869,19749,11061,319,0,74112,3650
27,17000,2717000,Duluth city, Minnesota,1,2012,86197,47.40,81.70,13.70,43086,43111,77941,2080,1123,1583,68,85476,721
27,43000,2743000,Minneapolis city, Minnesota,1,2012,392871,51.60,79.30,8.10,197360,195511,262253,70474,22628,4780,108,351687,41184
27,51730,2751730,Plymouth city, Minnesota,1,2012,72928,40.80,77.60,12.20,35815,37113,60716,3037,6579,352,0,69495,3433
27,54880,2754880,Rochester city, Minnesota,1,2012,108994,41.30,76.10,13.30,52687,56307,89784,6996,8456,125,0,103352,5642
27,56896,2756896,St. Cloud city, Minnesota,0,2012,64949,49.40,80.40,10.70,35487,29462,52803,6027,1535,546,0,63546,1403
27,58000,2758000,St. Paul city, Minnesota,1,2012,290776,46.90,74.20,9.00,142871,147905,177504,45731,45634,1235,52,264461,26315
28,29700,2829700,Gulfport city, Mississippi,1,2012,70101,40.00,77.00,13.50,35308,34793,42098,25476,581,238,0,64704,5397
28,36000,2836000,Jackson city, Mississippi,1,2012,175376,44.40,73.50,10.30,80687,94689,31889,139207,749,129,0,172359,3017
29,15670,2915670,Columbia city, Missouri,1,2012,113230,57.00,81.20,8.50,54366,58864,91039,7928,6068,532,0,108607,4623
29,35000,2935000,Independence city, Missouri,1,2012,117264,36.60,77.90,17.30,56924,60340,101471,6230,547,901,76,107072,10192
29,38000,2938000,Kansas City city, Missouri,1,2012,464346,42.40,75.60,11.60,222506,241840,272691,139934,10825,2698,118,417852,46494
29,41348,2941348,Lee's Summit city, Missouri,1,2012,92770,39.90,73.80,12.10,43766,49004,78893,7824,2453,63,576,87173,5597
29,54074,2954074,O'Fallon city, Missouri,1,2012,81983,41.50,71.50,9.80,39986,41997,-998,-998,-998,-998,-998,80085,1898
29,64082,2964082,St. Charles city, Missouri,0,2012,66454,44.90,78.80,14.20,32986,33468,57247,5238,1722,622,0,64336,2118
29,64550,2964550,St. Joseph city, Missouri,1,2012,76523,42.30,77.80,14.30,38509,38014,67344,3274,1082,151,299,71787,4736
29,65000,2965000,St. Louis city, Missouri,1,2012,318172,45.80,78.70,11.20,153196,164976,143417,152068,9220,900,0,306574,11598
29,70000,2970000,Springfield city, Missouri,1,2012,162193,49.40,81.60,14.20,77130,85063,143851,6710,4368,1320,1098,156244,5949
30,06550,3006550,Billings city, Montana,1,2012,106964,39.00,78.00,14.90,51607,55357,95649,517,1210,5038,0,101867,5097
30,50200,3050200,Missoula city, Montana,1,2012,68386,51.40,81.40,11.50,33894,34492,62390,40,1131,720,214,65517,2869
31,28000,3128000,Lincoln city, Nebraska,1,2012,265389,46.60,77.70,11.20,132472,132917,231664,10319,10239,2481,201,248311,17078
31,37000,3137000,Omaha city, Nebraska,1,2012,421564,42.60,74.60,11.60,205466,216098,314990,57054,11594,2856,25,363702,57862
32,23770,3223770,Enterprise CDP, Nevada,0,2012,123493,49.60,75.20,6.90,62847,60646,71568,12413,24061,546,2526,99911,23582
32,31900,3231900,Henderson city, Nevada,1,2012,265688,38.10,79.00,16.70,129401,136287,212809,14575,19577,1057,301,226655,39033
32,40000,3240000,Las Vegas city, Nevada,1,2012,596440,41.40,76.20,13.60,298671,297769,400931,61749,36402,3346,2099,400647,195793
32,51800,3251800,North Las Vegas city, Nevada,1,2012,223489,45.50,66.40,7.10,110870,112619,106952,45868,13477,1494,3619,138743,84746
32,54600,3254600,Paradise CDP, Nevada,0,2012,230184,44.60,76.70,11.30,119102,111082,145791,21328,21162,1081,1489,153799,76385
32,60600,3260600,Reno city, Nevada,1,2012,231004,43.90,77.30,13.10,115821,115183,182512,6180,15340,2827,1768,171495,59509
32,68400,3268400,Sparks city, Nevada,1,2012,92177,40.00,76.70,12.90,44232,47945,74569,2030,5247,1378,311,67506,24671
32,68585,3268585,Spring Valley CDP, Nevada,0,2012,177162,44.30,79.90,12.30,88787,88375,101025,19259,34126,1200,1585,137721,39441
32,71400,3271400,Sunrise Manor CDP, Nevada,0,2012,190583,42.70,72.00,9.60,95304,95279,117206,23740,12285,2241,1453,101436,89147
33,45140,3345140,Manchester city, New Hampshire,1,2012,110197,43.60,78.90,13.80,53275,56922,95680,5275,4039,80,0,102212,7985
33,50260,3350260,Nashua city, New Hampshire,1,2012,86932,42.40,79.20,13.20,43823,43109,74678,2241,7118,0,0,78317,8615
34,10000,3410000,Camden city, New Jersey,1,2012,77235,46.80,67.00,7.00,37594,39641,8972,39662,1284,675,0,39151,38084
34,13690,3413690,Clifton city, New Jersey,1,2012,84722,42.10,77.30,11.80,41650,43072,65136,3976,7019,484,0,56206,28516
34,19390,3419390,East Orange city, New Jersey,0,2012,64275,39.70,76.60,15.20,29933,34342,2017,57184,433,102,0,58537,5738
34,21000,3421000,Elizabeth city, New Jersey,1,2012,126459,43.80,71.80,9.60,60572,65887,67565,28860,2019,451,0,47013,79446
34,36000,3436000,Jersey City city, New Jersey,1,2012,254444,49.40,79.20,9.80,124851,129593,88488,67085,61965,1459,25,185209,69235
34,51000,3451000,Newark city, New Jersey,1,2012,277718,47.20,73.70,8.50,135983,141735,63733,137461,5954,1055,432,180026,97692
34,56550,3456550,Passaic city, New Jersey,1,2012,70215,47.90,66.10,6.60,35529,34686,37638,12150,1382,154,0,22392,47823
34,57000,3457000,Paterson city, New Jersey,1,2012,145236,43.70,73.40,10.40,68700,76536,65402,46986,5468,329,0,57838,87398
34,73110,3473110,Toms River CDP, New Jersey,0,2012,88984,36.10,77.50,17.20,43912,45072,82400,2176,3294,0,0,81984,7000
34,74000,3474000,Trenton city, New Jersey,1,2012,84492,47.20,74.00,8.00,41508,42984,31829,44606,828,99,0,57562,26930
34,74630,3474630,Union City city, New Jersey,1,2012,67751,48.80,77.70,9.60,34260,33491,40427,4417,1853,0,0,9636,58115
35,02000,3502000,Albuquerque city, New Mexico,1,2012,555419,42.40,76.30,12.80,269330,286089,384566,18373,14026,23905,665,296235,259184
35,39380,3539380,Las Cruces city, New Mexico,1,2012,101053,44.00,74.10,13.40,51347,49706,87275,1767,2201,1982,0,42478,58575
35,63460,3563460,Rio Rancho city, New Mexico,1,2012,90805,39.80,71.70,11.20,44234,46571,76364,3040,891,1987,45,53689,37116
35,70500,3570500,Santa Fe city, New Mexico,1,2012,69211,34.00,80.30,19.50,31524,37687,59339,829,1019,1120,0,34610,34601
36,01000,3601000,Albany city, New York,1,2012,97905,48.80,83.90,12.20,46725,51180,56811,30691,4536,453,0,88374,9531
36,11000,3611000,Buffalo city, New York,1,2012,259386,44.90,76.90,11.30,123034,136352,128663,95223,11733,1140,173,232234,27152
51,03000,5103000,Arlington CDP, Virginia,0,2012,221045,55.30,83.80,8.90,110100,110945,160578,19583,22006,450,293,187035,34010
51,14440,5114440,Centreville CDP, Virginia,0,2012,67202,45.40,76.50,6.50,34107,33095,36438,5001,19065,96,0,60497,6705
51,16000,5116000,Chesapeake city, Virginia,1,2012,228417,40.50,75.20,11.10,111029,117388,143877,67827,7209,681,103,217420,10997
51,21088,5121088,Dale City CDP, Virginia,0,2012,73534,41.10,70.00,7.50,36612,36922,37376,21581,5833,271,0,52921,20613
51,35000,5135000,Hampton city, Virginia,1,2012,136836,42.30,77.80,13.00,64924,71912,58445,69705,3862,652,0,129992,6844
51,47672,5147672,Lynchburg city, Virginia,1,2012,77113,48.70,80.80,13.80,36615,40498,49237,21565,1732,246,0,74643,2470
51,56000,5156000,Newport News city, Virginia,1,2012,180726,45.00,76.30,11.00,87544,93182,91747,71199,5015,775,209,166493,14233
51,57000,5157000,Norfolk city, Virginia,1,2012,245782,51.20,79.30,9.60,127912,117870,117707,104236,6662,995,492,228159,17623
51,64000,5164000,Portsmouth city, Virginia,1,2012,96470,41.20,76.30,13.60,46024,50446,39785,51722,946,176,93,93242,3228
51,67000,5167000,Richmond city, Virginia,1,2012,210309,48.10,80.60,11.30,99218,111091,91110,103831,3887,1123,72,196899,13410
51,68000,5168000,Roanoke city, Virginia,1,2012,97469,40.40,78.10,14.30,46510,50959,62594,26434,2104,792,68,91870,5599
51,76432,5176432,Suffolk city, Virginia,1,2012,85181,38.90,74.70,12.30,40650,44531,44969,35709,1414,105,0,82420,2761
51,82000,5182000,Virginia Beach city, Virginia,1,2012,447021,44.00,76.80,11.30,219367,227654,303805,86078,28845,976,347,414862,32159
53,03180,5303180,Auburn city, Washington,1,2012,73165,44.20,73.40,9.20,35828,37337,50474,3450,5269,1536,415,59437,13728
53,05210,5305210,Bellevue city, Washington,1,2012,126447,44.90,80.60,13.90,64846,61601,75486,3282,39275,460,148,119584,6863
53,05280,5305280,Bellingham city, Washington,1,2012,82234,48.00,84.60,15.80,39836,42398,71526,669,3422,1879,109,76280,5954
53,22640,5322640,Everett city, Washington,1,2012,104643,45.20,76.90,10.30,54136,50507,76196,5651,9136,864,1175,84264,20379
53,23515,5323515,Federal Way city, Washington,1,2012,91933,42.50,75.10,9.20,45102,46831,53376,9248,10933,1563,1959,74885,17048
53,35275,5335275,Kennewick city, Washington,1,2012,75984,44.70,74.20,11.90,37982,38002,61224,1396,2148,279,0,58099,17885
53,35415,5335415,Kent city, Washington,1,2012,123005,45.50,71.60,9.00,61903,61102,68198,14218,18220,764,5008,101192,21813
53,53545,5353545,Pasco city, Washington,0,2012,64029,44.70,64.40,5.00,31222,32807,37511,958,1702,0,75,29542,34487
53,57745,5357745,Renton city, Washington,1,2012,95422,44.20,78.90,11.70,46117,49305,53714,12261,22190,294,1105,85994,9428
53,63000,5363000,Seattle city, Washington,1,2012,634541,50.70,84.70,11.40,313386,321155,441308,45715,92535,5103,1327,588128,46413
53,67000,5367000,Spokane city, Washington,1,2012,209504,41.50,77.80,14.50,102984,106520,183521,4098,6649,3997,470,199083,10421
53,67167,5367167,Spokane Valley city, Washington,1,2012,90638,39.60,76.30,14.40,45011,45627,80154,2607,3340,1062,51,86156,4482
53,70000,5370000,Tacoma city, Washington,1,2012,201999,43.30,76.00,11.30,99392,102607,127766,21381,16263,3565,2634,178833,23166
53,74060,5374060,Vancouver city, Washington,1,2012,165502,42.50,76.50,13.80,83286,82216,126688,5302,12286,1361,3115,145848,19654
53,80010,5380010,Yakima city, Washington,1,2012,93123,40.50,72.90,13.90,45739,47384,70038,1124,2001,768,220,53024,40099
55,02375,5502375,Appleton city, Wisconsin,1,2012,71898,42.00,77.00,11.90,34991,36907,63041,1402,3546,639,86,68862,3036
55,22300,5522300,Eau Claire city, Wisconsin,0,2012,67186,52.40,81.30,12.10,33474,33712,62117,790,2628,194,0,65906,1280
55,31000,5531000,Green Bay city, Wisconsin,1,2012,104869,41.40,76.00,14.10,52370,52499,89415,3390,5122,2820,0,90181,14688
55,39225,5539225,Kenosha city, Wisconsin,1,2012,100139,43.20,73.20,10.90,49274,50865,83955,11220,2005,201,37,83550,16589
55,48000,5548000,Madison city, Wisconsin,1,2012,240315,54.10,81.50,9.80,120240,120075,189831,19523,19814,1004,0,225067,15248
55,53000,5553000,Milwaukee city, Wisconsin,1,2012,598920,46.60,72.80,8.90,287906,311014,274226,238310,21198,3903,88,490129,108791
55,60500,5560500,Oshkosh city, Wisconsin,0,2012,66647,47.30,80.90,12.90,34203,32444,61005,2654,1226,323,0,63649,2998
55,66000,5566000,Racine city, Wisconsin,1,2012,78293,40.60,72.60,11.60,38238,40055,52309,16584,133,946,0,61220,17073
55,84250,5584250,Waukesha city, Wisconsin,1,2012,70914,43.30,78.20,12.40,35171,35743,60732,3107,2815,216,0,63282,7632
72,10334,7210334,Caguas zona urbana, Puerto Rico,0,2012,80119,38.30,77.20,19.30,36797,43322,66163,7597,401,37,0,590,79529
72,14290,7214290,Carolina zona urbana, Puerto Rico,0,2012,155111,39.90,78.30,17.80,70458,84653,93197,36189,549,3623,0,2211,152900
72,32522,7232522,Guaynabo zona urbana, Puerto Rico,0,2012,74216,40.50,79.30,18.00,34930,39286,58743,3615,431,469,0,1049,73167
72,63820,7263820,Ponce zona urbana, Puerto Rico,0,2012,130627,38.80,75.40,16.50,61022,69605,95921,8655,37,44,0,867,129760
72,76770,7276770,San Juan zona urbana, Puerto Rico,0,2012,367412,39.10,79.30,18.30,168085,199327,239357,61586,3773,1903,0,6470,360942
36,15000,3615000,Cheektowaga CDP, New York,0,2012,75599,35.90,82.50,19.80,34807,40792,61740,10265,1190,131,0,73312,2287
36,49121,3649121,Mount Vernon city, New York,1,2012,67902,41.10,77.40,15.10,30605,37297,17721,41590,2200,91,74,56935,10967
36,50617,3650617,New Rochelle city, New York,1,2012,78390,39.00,78.20,16.40,38808,39582,54525,13985,3048,109,0,56064,22326
36,51000,3651000,New York city, New York,1,2012,8336697,45.00,78.60,12.50,3971426,4365271,3647131,2058522,1091449,30230,3548,5929807,2406890
36,63000,3663000,Rochester city, New York,1,2012,210521,45.90,77.50,10.70,102531,107990,94990,86386,8569,1151,0,175877,34644
36,65508,3665508,Schenectady city, New York,1,2012,66072,44.00,75.80,11.90,31528,34544,40055,12881,2898,236,0,59008,7064
36,73000,3673000,Syracuse city, New York,1,2012,144161,47.40,76.90,12.00,68739,75422,80011,42015,8167,1962,50,132582,11579
36,84000,3684000,Yonkers city, New York,1,2012,198457,39.50,77.50,14.80,92620,105837,111061,34889,11791,1248,54,127260,71197
37,02140,3702140,Asheville city, North Carolina,1,2012,85721,43.10,81.10,16.70,40142,45579,70482,10697,2084,0,0,81287,4434
37,10740,3710740,Cary town, North Carolina,1,2012,145830,40.60,72.10,8.70,71152,74678,108123,11968,18050,1199,162,131743,14087
37,12000,3712000,Charlotte city, North Carolina,1,2012,775208,46.60,75.10,8.80,372991,402217,407772,271441,42313,3597,980,670295,104913
37,14100,3714100,Concord city, North Carolina,1,2012,81976,41.30,72.10,11.00,40692,41284,62565,15175,2084,87,0,71143,10833
37,19000,3719000,Durham city, North Carolina,1,2012,239320,48.60,77.50,9.70,112315,127005,117578,95537,11417,1470,388,208164,31156
37,22920,3722920,Fayetteville city, North Carolina,1,2012,202105,46.80,75.20,10.90,97667,104438,93781,82881,5265,2558,297,179126,22979
37,25580,3725580,Gastonia city, North Carolina,1,2012,72735,37.50,72.00,12.70,35552,37183,46509,19916,1011,140,0,67476,5259
37,28000,3728000,Greensboro city, North Carolina,1,2012,277095,45.60,77.30,12.00,132167,144928,131026,118409,12671,1161,65,255468,21627
37,28080,3728080,Greenville city, North Carolina,1,2012,87248,59.50,80.60,7.50,40196,47052,48339,34030,2461,334,0,83265,3983
37,31400,3731400,High Point city, North Carolina,1,2012,108443,42.70,77.30,13.60,50079,58364,61174,34312,8158,974,0,100377,8066
37,34200,3734200,Jacksonville city, North Carolina,1,2012,69221,59.80,75.70,7.40,39414,29807,43894,16610,1760,252,65,58239,10982
37,55000,3755000,Raleigh city, North Carolina,1,2012,423743,50.00,77.80,8.80,202748,220995,255854,126167,20142,883,79,379660,44083
37,74440,3774440,Wilmington city, North Carolina,1,2012,109927,45.80,81.20,14.00,51603,58324,84603,18980,2359,63,0,104117,5810
37,75000,3775000,Winston-Salem city, North Carolina,1,2012,234354,42.70,75.90,12.90,110099,124255,136932,83870,5192,122,0,199601,34753
38,25700,3825700,Fargo city, North Dakota,1,2012,109467,51.30,80.50,10.00,54723,54744,97759,3137,2473,1562,19,106100,3367
39,01000,3901000,Akron city, Ohio,1,2012,198551,42.00,76.80,12.40,95383,103168,124941,59211,4847,381,47,194533,4018
39,12000,3912000,Canton city, Ohio,1,2012,72684,39.90,77.20,14.20,32767,39917,50878,14764,659,617,0,71740,944
39,15000,3915000,Cincinnati city, Ohio,1,2012,296552,46.20,77.60,11.00,140789,155763,150005,130712,5194,1116,0,289480,7072
39,16000,3916000,Cleveland city, Ohio,1,2012,390923,41.30,76.50,12.20,186203,204720,150263,210520,7403,1180,95,349282,41641
39,18000,3918000,Columbus city, Ohio,1,2012,809890,49.60,77.10,9.00,395576,414314,500239,225908,35453,2138,270,765512,44378
39,21000,3921000,Dayton city, Ohio,1,2012,141354,43.50,77.20,11.80,68474,72880,77228,56668,1351,146,0,135522,5832
39,44856,3944856,Lorain city, Ohio,0,2012,63710,38.10,76.10,14.80,28408,35302,46849,11158,318,147,0,46403,17307
39,61000,3961000,Parma city, Ohio,1,2012,80596,37.60,80.10,18.20,38072,42524,73921,2506,2166,28,0,76549,4047
39,77000,3977000,Toledo city, Ohio,1,2012,284022,41.90,77.10,12.80,138808,145214,183094,77134,3038,1130,0,260694,23328
39,88000,3988000,Youngstown city, Ohio,1,2012,65387,36.90,75.70,15.50,32739,32648,30515,29274,885,623,0,58054,7333
40,09050,4009050,Broken Arrow city, Oklahoma,1,2012,103534,40.40,73.50,12.50,50332,53202,79706,4579,4379,4325,26,96061,7473
40,23200,4023200,Edmond city, Oklahoma,1,2012,84871,40.30,72.20,10.50,40963,43908,70407,4609,3450,2245,122,80341,4530
40,41850,4041850,Lawton city, Oklahoma,1,2012,98373,47.20,77.00,9.60,50990,47383,59450,19772,2486,5698,650,84749,13624
40,52500,4052500,Norman city, Oklahoma,1,2012,115563,51.40,79.90,10.70,57910,57653,94558,4007,4487,4037,71,108327,7236
40,55000,4055000,Oklahoma City city, Oklahoma,1,2012,599309,42.50,74.40,11.20,294837,304472,404951,84566,24898,17577,0,494497,104812
40,75000,4075000,Tulsa city, Oklahoma,1,2012,394098,41.30,75.60,12.40,192172,201926,262157,58472,9987,16341,596,335960,58138
41,05350,4105350,Beaverton city, Oregon,1,2012,92677,45.10,76.60,10.40,43935,48742,65392,1992,11823,1306,618,77389,15288
41,05800,4105800,Bend city, Oregon,1,2012,79118,38.00,75.40,14.60,38830,40288,74503,0,1316,68,35,72432,6686
41,23850,4123850,Eugene city, Oregon,1,2012,157984,50.20,84.40,13.30,77005,80979,135505,2519,6713,968,492,146150,11834
41,31250,4131250,Gresham city, Oregon,1,2012,108958,42.60,75.70,12.60,54656,54302,85066,4795,5999,1128,400,86228,22730
41,34100,4134100,Hillsboro city, Oregon,1,2012,95340,47.80,72.80,8.40,45167,50173,68861,1349,9646,759,484,73420,21920
41,47000,4147000,Medford city, Oregon,1,2012,76459,37.40,75.10,16.20,37643,38816,67613,1062,1237,750,322,65501,10958
41,59000,4159000,Portland city, Oregon,1,2012,603650,47.50,80.80,10.80,297942,305708,475727,36746,42465,3581,4730,546601,57049
41,64900,4164900,Salem city, Oregon,1,2012,157425,41.30,74.50,12.20,78074,79351,128450,1885,5154,1381,2028,123816,33609
42,02000,4202000,Allentown city, Pennsylvania,1,2012,118974,43.40,74.40,11.20,57207,61767,73358,16365,1271,390,0,63817,55157
42,06088,4206088,Bethlehem city, Pennsylvania,1,2012,75729,45.70,78.50,15.60,37191,38538,60437,5698,1999,63,0,56255,19474
42,24000,4224000,Erie city, Pennsylvania,1,2012,101040,43.50,77.20,13.80,49392,51648,73987,16970,2421,730,19,94640,6400
42,60000,4260000,Philadelphia city, Pennsylvania,1,2012,1547607,45.40,77.50,12.20,731316,816291,637549,667585,99319,5680,5151,1346606,201001
42,61000,4261000,Pittsburgh city, Pennsylvania,1,2012,306212,50.00,83.90,13.40,148331,157881,204589,75220,15299,689,197,297832,8380
42,63624,4263624,Reading city, Pennsylvania,1,2012,88096,44.60,68.10,8.80,43441,44655,53193,12157,1706,1314,206,35313,52783
42,69000,4269000,Scranton city, Pennsylvania,1,2012,75813,41.60,81.90,16.00,36835,38978,65040,4856,3394,61,30,67337,8476
44,19180,4419180,Cranston city, Rhode Island,1,2012,80539,39.10,79.90,14.40,39422,41117,65547,4369,4929,305,64,72156,8383
44,54640,4454640,Pawtucket city, Rhode Island,1,2012,71174,42.10,78.50,12.30,35146,36028,48298,10283,1246,209,57,56233,14941
44,59000,4459000,Providence city, Rhode Island,1,2012,178438,53.30,78.00,8.40,87262,91176,91665,30625,11969,2164,25,107542,70896
44,74300,4474300,Warwick city, Rhode Island,1,2012,81873,36.60,81.00,16.60,38948,42925,73239,1628,3870,182,0,78141,3732
45,13330,4513330,Charleston city, South Carolina,1,2012,125941,49.30,82.90,12.10,60789,65152,91468,29947,1209,134,43,120711,5230
45,16000,4516000,Columbia city, South Carolina,1,2012,131303,54.60,80.80,9.40,69060,62243,65433,56840,2752,0,158,122613,8690
45,48535,4548535,Mount Pleasant town, South Carolina,1,2012,71883,37.60,73.30,12.30,32907,38976,-998,-998,-998,-998,-998,67238,4645
45,50875,4550875,North Charleston city, South Carolina,1,2012,102262,47.20,75.80,8.60,50730,51532,47649,46335,2359,289,0,93016,9246
45,61405,4561405,Rock Hill city, South Carolina,1,2012,68087,48.10,75.70,9.60,33123,34964,35432,27944,1117,124,0,64862,3225
46,52980,4652980,Rapid City city, South Dakota,1,2012,69849,39.50,74.70,14.30,35303,34546,55790,926,1010,6668,290,66272,3577
46,59020,4659020,Sioux Falls city, South Dakota,1,2012,159992,43.00,75.70,11.50,78714,81278,136845,7408,3741,5098,0,152089,7903
47,14000,4714000,Chattanooga city, Tennessee,1,2012,171282,42.00,79.50,15.00,83520,87762,103821,58559,4227,336,85,162600,8682
47,15160,4715160,Clarksville city, Tennessee,1,2012,142517,50.90,72.00,6.30,69128,73389,94761,32368,3166,985,507,127427,15090
47,27740,4727740,Franklin city, Tennessee,0,2012,66278,39.60,75.00,10.90,32271,34007,-998,-998,-998,-998,-998,62841,3437
47,37640,4737640,Jackson city, Tennessee,0,2012,67263,41.40,76.30,14.00,30579,36684,-998,-998,-998,-998,-998,64471,2792
47,40000,4740000,Knoxville city, Tennessee,1,2012,182196,47.00,82.70,15.80,86097,96099,139551,34605,2031,325,156,176927,5269
47,48000,4748000,Memphis city, Tennessee,1,2012,655141,43.60,75.00,10.60,314253,340888,202136,413365,9516,2069,406,612187,42954
47,51560,4751560,Murfreesboro city, Tennessee,1,2012,114044,50.10,75.60,8.60,56998,57046,87096,17598,4513,111,363,109491,4553
47,52006,4752006,Nashville-Davidson metropolitan government (balance), Tennessee,1,2012,623255,47.00,78.20,10.40,301627,321628,377215,178796,21226,1151,82,560113,63142
48,01000,4801000,Abilene city, Texas,1,2012,118881,44.80,77.40,13.70,60924,57957,94331,12087,2428,423,0,87653,31228
48,01924,4801924,Allen city, Texas,1,2012,89631,39.20,70.10,6.60,43365,46266,62460,11433,9372,1032,0,82866,6765
48,03000,4803000,Amarillo city, Texas,1,2012,195571,42.60,72.50,12.00,94805,100766,161335,12211,6303,1597,804,133748,61823
48,04000,4804000,Arlington city, Texas,1,2012,375598,46.50,73.60,8.10,184403,191195,258389,72464,23724,1207,85,270796,104802
48,04462,4804462,Atascocita CDP, Texas,0,2012,67714,42.20,66.10,7.00,33910,33804,44576,19075,1072,184,0,52716,14998
48,05000,4805000,Austin city, Texas,1,2012,842595,52.90,78.30,7.30,424725,417870,647851,65431,54084,5272,776,555745,286850
48,06128,4806128,Baytown city, Texas,1,2012,72044,39.60,70.80,11.30,35351,36693,52339,8492,616,1208,0,37931,34113
48,07000,4807000,Beaumont city, Texas,1,2012,118241,42.10,73.40,12.10,55667,62574,56595,55840,2140,307,94,99145,19096
48,10768,4810768,Brownsville city, Texas,1,2012,180077,43.00,67.20,10.40,85723,94354,164033,973,1970,139,29,12292,167785
48,10912,4810912,Bryan city, Texas,1,2012,78073,51.60,77.30,10.50,40920,37153,47932,13646,1860,502,0,48382,29691
48,13024,4813024,Carrollton city, Texas,1,2012,125395,41.60,73.60,9.30,61547,63848,88560,10607,15831,1182,100,86875,38520
48,15976,4815976,College Station city, Texas,1,2012,97794,68.40,83.30,5.10,49775,48019,78127,6357,9209,203,78,83267,14527
48,17000,4817000,Corpus Christi city, Texas,1,2012,312192,41.40,74.60,12.40,153740,158452,261050,14644,5753,1594,376,121988,190204
48,19000,4819000,Dallas city, Texas,1,2012,1241108,46.50,74.50,9.40,626205,614903,738525,309069,40222,2858,915,727082,514026
48,19972,4819972,Denton city, Texas,1,2012,121123,54.80,78.00,9.00,58491,62632,92845,15268,3985,496,59,95809,25314
48,22660,4822660,Edinburg city, Texas,1,2012,81033,46.80,71.20,6.90,39940,41093,74721,964,1378,680,0,8743,72290
48,24000,4824000,El Paso city, Texas,1,2012,672534,42.50,71.80,11.70,326575,345959,563281,25380,8582,3785,1066,140349,532185
48,26232,4826232,Flower Mound town, Texas,0,2012,67808,39.20,72.10,6.00,33512,34296,57021,3326,4540,469,0,60508,7300
48,27000,4827000,Fort Worth city, Texas,1,2012,782027,44.80,71.30,8.90,381663,400364,531430,148245,32330,3094,2004,518434,263593
48,27684,4827684,Frisco city, Texas,1,2012,128171,43.40,67.00,7.10,62972,65199,95240,7527,17400,616,0,114330,13841
48,29000,4829000,Garland city, Texas,1,2012,233623,42.20,71.60,10.20,116876,116747,101637,30920,26646,1234,320,133192,100431
48,30464,4830464,Grand Prairie city, Texas,1,2012,181791,43.90,70.00,6.00,90699,91092,120516,38462,9834,883,0,95497,86294
48,32372,4832372,Harlingen city, Texas,0,2012,65688,39.90,70.10,13.10,32617,33071,-998,-998,-998,-998,-998,13668,52020
48,35000,4835000,Houston city, Texas,1,2012,2161686,46.10,74.40,9.60,1085083,1076603,1247112,508366,141213,8144,1157,1222804,938882
48,37000,4837000,Irving city, Texas,1,2012,225427,48.80,73.90,7.30,106232,119195,104681,31458,35752,2057,0,140370,85057
48,39148,4839148,Killeen city, Texas,1,2012,134662,52.30,70.20,5.00,66606,68056,64861,49849,4216,573,1674,104261,30401
48,41464,4841464,Laredo city, Texas,1,2012,244143,44.00,65.60,8.30,119111,125032,229556,329,2120,570,94,11697,232446
48,41980,4841980,League City city, Texas,1,2012,88679,40.40,73.40,7.70,44338,44341,75053,5645,3974,460,0,70546,18133
48,42508,4842508,Lewisville city, Texas,1,2012,99763,49.40,74.90,8.00,48424,51339,68104,9754,11626,119,175,71299,28464
48,43888,4843888,Longview city, Texas,1,2012,80831,40.00,75.40,13.80,38842,41989,56507,17872,1529,320,751,63719,17112
48,45000,4845000,Lubbock city, Texas,1,2012,236060,48.00,77.10,11.60,115966,120094,183915,18399,5566,666,525,155251,80809
48,45384,4845384,McAllen city, Texas,1,2012,134729,43.00,71.60,11.20,66102,68627,114215,642,5317,818,0,17116,117613
48,45744,4845744,McKinney city, Texas,1,2012,143216,45.30,67.80,7.60,70862,72354,117866,13794,6328,713,71,116476,26740
48,47892,4847892,Mesquite city, Texas,1,2012,143484,43.10,68.20,7.70,68103,75381,102400,30464,3563,405,0,86907,56577
48,48072,4848072,Midland city, Texas,1,2012,119384,42.80,73.40,11.20,57626,61758,98725,9781,1927,224,0,70141,49243
48,48768,4848768,Mission city, Texas,1,2012,80449,40.20,65.30,11.40,38874,41575,-998,-998,-998,-998,-998,15502,64947
48,48804,4848804,Missouri City city, Texas,1,2012,67968,38.30,78.30,13.80,31973,35995,19848,27451,11082,176,0,56679,11289
48,52356,4852356,North Richland Hills city, Texas,0,2012,65289,40.00,77.00,14.10,32241,33048,53771,3766,1890,1130,0,53141,12148
48,53388,4853388,Odessa city, Texas,1,2012,106483,43.20,72.20,10.50,53132,53351,90732,6403,1521,543,0,49384,57099
48,56000,4856000,Pasadena city, Texas,1,2012,152257,44.60,70.20,8.40,77207,75050,123367,4891,3839,1602,0,55918,96339
48,56348,4856348,Pearland city, Texas,1,2012,96665,45.00,71.90,8.40,49328,47337,57581,17182,8987,380,0,72988,23677
48,57200,4857200,Pharr city, Texas,1,2012,73126,42.50,63.50,12.60,36244,36882,-998,-998,-998,-998,-998,6199,66927
48,58016,4858016,Plano city, Texas,1,2012,270816,40.10,74.30,9.70,134416,136400,193072,19979,45167,449,133,223522,47294
48,61796,4861796,Richardson city, Texas,1,2012,103268,41.70,78.00,14.50,53237,50031,69979,9710,13490,521,55,86242,17026
48,63500,4863500,Round Rock city, Texas,1,2012,105933,47.80,70.70,6.60,52402,53531,83094,11686,5811,446,0,74777,31156
48,64472,4864472,San Angelo city, Texas,1,2012,99085,42.80,76.90,14.50,48686,50399,86320,5456,1459,591,0,59923,39162
48,65000,4865000,San Antonio city, Texas,1,2012,1383194,43.50,73.90,11.20,674220,708974,1022508,96310,32699,12033,2582,503968,879226
48,70808,4870808,Sugar Land city, Texas,1,2012,82479,35.70,78.00,10.20,40781,41698,41680,4995,32567,140,126,75467,7012
48,72176,4872176,Temple city, Texas,0,2012,69147,36.90,76.80,16.60,33346,35801,52230,11837,1955,222,216,53469,15678
48,72656,4872656,The Woodlands CDP, Texas,0,2012,103533,36.40,71.10,11.00,49312,54221,92454,797,4699,233,0,89328,14205
48,74144,4874144,Tyler city, Texas,1,2012,99321,45.00,77.10,14.90,47764,51557,70267,21867,1874,396,51,73328,25993
48,76000,4876000,Waco city, Texas,1,2012,127003,47.40,76.20,11.10,61602,65401,86739,25935,2517,610,33,84272,42731
48,79000,4879000,Wichita Falls city, Texas,1,2012,104557,44.90,77.30,13.00,54706,49851,82369,12538,2278,873,48,82682,21875
49,43660,4943660,Layton city, Utah,1,2012,68684,44.00,70.30,8.80,35538,33146,59570,877,2713,559,651,60272,8412
49,50150,4950150,Millcreek CDP, Utah,0,2012,66939,43.00,75.80,13.40,32689,34250,59039,969,3395,418,1178,63530,3409
49,55980,4955980,Ogden city, Utah,1,2012,83799,46.20,73.00,10.80,43992,39807,64436,2452,1015,1112,256,56927,26872
49,57300,4957300,Orem city, Utah,1,2012,90754,48.50,69.60,8.40,45507,45247,81676,574,1675,517,1388,75972,14782
49,62470,4962470,Provo city, Utah,1,2012,115925,60.90,77.00,7.10,56717,59208,102933,325,3367,198,1614,94696,21229
49,65330,4965330,St. George city, Utah,1,2012,75560,38.20,74.30,19.60,35798,39762,69736,680,431,913,217,67012,8548
49,67000,4967000,Salt Lake City city, Utah,1,2012,189311,52.00,78.90,10.10,97343,91968,136245,6215,11696,1706,5131,149503,39808
49,67440,4967440,Sandy city, Utah,1,2012,89348,39.90,69.60,10.20,44559,44789,81947,416,2362,138,43,83321,6027
49,82950,4982950,West Jordan city, Utah,1,2012,108390,46.60,68.20,5.10,54685,53705,93761,2879,2101,1301,2708,88628,19762
49,83470,4983470,West Valley City city, Utah,1,2012,132431,43.90,66.90,7.30,65994,66437,96155,2422,5379,1561,3397,82608,49823
51,01000,5101000,Alexandria city, Virginia,1,2012,146294,51.50,82.30,10.00,70447,75847,94618,32065,9688,227,0,121763,24531
72,06593,7206593,Bayamón zona urbana, Puerto Rico,0,2012,181758,40.30,79.30,18.50,86152,95606,108141,15533,580,2075,22,1948,179810
72,52431,7252431,Mayagüez zona urbana, Puerto Rico,0,2012,67802,42.60,78.30,18.10,32085,35717,36659,2046,47,122,0,1001,66801
47,14000,4714000,Chattanooga city, Tennessee,1,2013,173375,41.40,77.50,14.50,82956,90419,103813,61264,3320,338,412,165825,7550
01,07000,0107000,Birmingham city, Alabama,1,2013,211933,44.20,80.30,13.00,102318,109615,50047,154377,1704,307,0,204561,7372
01,21184,0121184,Dothan city, Alabama,0,2013,67296,39.80,76.60,15.10,32208,35088,42739,21638,981,256,0,64717,2579
01,35896,0135896,Hoover city, Alabama,1,2013,84128,41.10,74.50,13.60,38013,46115,59310,16897,4211,590,0,80103,4025
01,37000,0137000,Huntsville city, Alabama,1,2013,186416,41.60,79.00,14.30,91771,94645,117148,58720,3813,804,156,177838,8578
01,50000,0150000,Mobile city, Alabama,1,2013,194879,40.50,77.00,15.20,93792,101087,88827,99171,2829,144,0,187922,6957
01,51000,0151000,Montgomery city, Alabama,1,2013,201335,41.90,75.10,12.70,95755,105580,72867,118085,3863,123,0,194215,7120
01,77256,0177256,Tuscaloosa city, Alabama,1,2013,95334,53.70,80.70,9.40,46928,48406,46629,43538,2680,130,0,93437,1897
02,03000,0203000,Anchorage municipality, Alaska,1,2013,300950,45.10,74.90,8.40,153776,147174,197183,17842,24675,22764,6800,274929,26021
04,04720,0404720,Avondale city, Arizona,1,2013,78817,46.60,71.40,7.70,38195,40622,57766,9396,2874,994,89,40660,38157
04,10670,0410670,Casas Adobes CDP, Arizona,0,2013,69653,36.10,74.50,17.20,34226,35427,60364,758,1885,373,0,54521,15132
04,12000,0412000,Chandler city, Arizona,1,2013,249139,44.20,72.90,9.00,120608,128531,190254,13132,23219,2571,778,193329,55810
04,23620,0423620,Flagstaff city, Arizona,0,2013,68661,61.00,83.10,8.40,34324,34337,49444,2273,1236,6560,277,54910,13751
04,27400,0427400,Gilbert town, Arizona,1,2013,229989,43.40,68.20,7.70,116912,113077,195583,5516,17852,883,180,198157,31832
04,27820,0427820,Glendale city, Arizona,1,2013,234618,41.80,73.00,10.80,118809,115809,188693,12116,7911,6230,300,145909,88709
04,28380,0428380,Goodyear city, Arizona,0,2013,72862,39.80,74.90,15.70,31726,41136,52065,7188,4692,1291,130,53797,19065
04,46000,0446000,Mesa city, Arizona,1,2013,457595,41.10,75.30,15.10,225463,232132,391780,15821,8813,10262,1827,333623,123972
04,54050,0454050,Peoria city, Arizona,1,2013,162617,36.10,74.10,16.10,76476,86141,143391,3241,5501,1132,413,131149,31468
04,55000,0455000,Phoenix city, Arizona,1,2013,1513350,44.50,73.30,9.10,756150,757200,1134127,104192,44936,31862,2643,888434,624916
04,64210,0464210,San Tan Valley CDP, Arizona,0,2013,93346,44.30,63.90,6.60,47157,46189,78427,5297,918,884,1360,70095,23251
04,65000,0465000,Scottsdale city, Arizona,1,2013,226909,35.80,81.90,21.10,112422,114487,200920,5017,9298,2008,44,201948,24961
04,71510,0471510,Surprise city, Arizona,1,2013,123569,32.50,75.00,25.30,57361,66208,105634,6797,2672,738,183,100363,23206
04,73000,0473000,Tempe city, Arizona,1,2013,168231,57.60,82.40,9.00,87787,80444,115657,9080,12949,4476,774,129511,38720
04,77000,0477000,Tucson city, Arizona,1,2013,526141,45.60,78.10,13.10,260131,266010,379631,27614,16250,15974,1296,303741,222400
04,85540,0485540,Yuma city, Arizona,1,2013,91915,42.50,73.30,14.50,49541,42374,63405,4019,1825,456,0,40126,51789
05,23290,0523290,Fayetteville city, Arkansas,1,2013,78967,59.70,81.00,6.40,39325,39642,61939,8570,2150,520,0,72079,6888
05,24550,0524550,Fort Smith city, Arkansas,1,2013,87654,40.20,75.40,11.90,42655,44999,68212,7669,5219,695,0,71757,15897
05,35710,0535710,Jonesboro city, Arkansas,1,2013,71547,45.10,75.00,12.30,35821,35726,54265,12844,1083,477,0,67347,4200
05,41000,0541000,Little Rock city, Arkansas,1,2013,197357,42.40,76.50,13.00,96468,100889,102255,81757,5656,641,182,186667,10690
05,50450,0550450,North Little Rock city, Arkansas,0,2013,66086,39.20,74.90,14.30,31629,34457,-998,-998,-998,-998,-998,61992,4094
05,66080,0566080,Springdale city, Arkansas,1,2013,73795,45.30,69.30,11.10,38288,35507,47016,2434,1669,1257,292,48613,25182
06,00562,0600562,Alameda city, California,1,2013,76413,37.20,79.10,15.90,37674,38739,35112,6541,23309,130,614,68199,8214
06,00884,0600884,Alhambra city, California,1,2013,84566,43.90,81.50,15.10,40301,44265,17806,1068,41535,316,64,51662,32904
06,02000,0602000,Anaheim city, California,1,2013,345015,44.60,74.80,11.20,171941,173074,246909,9707,54741,1114,1678,166223,178792
06,02252,0602252,Antioch city, California,1,2013,107098,41.50,73.30,11.10,50370,56728,52108,23652,10961,970,775,73124,33974
06,02364,0602364,Apple Valley town, California,1,2013,70923,34.30,76.40,18.00,35978,34945,56546,3822,3080,377,0,45262,25661
06,02553,0602553,Arden-Arcade CDP, California,0,2013,92438,41.30,78.50,16.70,44509,47929,61609,11019,5579,1484,243,76261,16177
06,03526,0603526,Bakersfield city, California,1,2013,363630,44.10,69.10,9.00,179150,184480,247768,29040,27287,3237,536,194047,169583
06,03666,0603666,Baldwin Park city, California,1,2013,76633,45.00,74.90,9.40,39069,37564,28450,723,10951,1561,0,15729,60904
06,04982,0604982,Bellflower city, California,1,2013,77594,45.40,75.10,9.70,37964,39630,29263,11308,8392,595,522,34933,42661
06,06000,0606000,Berkeley city, California,1,2013,116774,56.40,87.40,13.40,55703,61071,70246,10254,23997,499,487,105174,11600
06,08786,0608786,Buena Park city, California,1,2013,82885,45.20,75.80,10.20,40746,42139,50447,4244,22416,99,289,50564,32321
06,08954,0608954,Burbank city, California,1,2013,104717,41.00,80.10,15.70,49300,55417,76706,3018,10348,188,67,78198,26519
06,10046,0610046,Camarillo city, California,0,2013,66076,39.80,75.20,18.20,32525,33551,47988,464,9053,0,0,49724,16352
06,11194,0611194,Carlsbad city, California,1,2013,110977,34.60,76.60,14.60,56877,54100,94491,2363,7131,0,467,96591,14386
06,11390,0611390,Carmichael CDP, California,0,2013,66747,37.80,76.50,17.60,31065,35682,54596,3433,2151,291,315,58629,8118
06,11530,0611530,Carson city, California,1,2013,92597,40.70,78.30,14.60,44996,47601,27425,21781,25193,698,1112,57652,34945
06,13014,0613014,Chico city, California,1,2013,88075,52.00,81.30,11.50,41729,46346,73572,1837,3397,715,321,72973,15102
06,13210,0613210,Chino city, California,1,2013,81001,44.70,74.50,9.50,45007,35994,52386,3669,8353,177,56,38537,42464
06,13214,0613214,Chino Hills city, California,1,2013,76575,40.50,73.70,8.20,36801,39774,37444,1931,28881,56,423,58070,18505
06,13392,0613392,Chula Vista city, California,1,2013,256765,43.00,72.00,11.00,123706,133059,183472,10761,32162,1189,598,95964,160801
06,13588,0613588,Citrus Heights city, California,1,2013,85288,42.70,81.50,13.70,41999,43289,70432,2920,3595,2076,46,72839,12449
06,14218,0614218,Clovis city, California,1,2013,99758,41.70,73.30,12.60,47467,52291,70519,3185,11178,638,501,73958,25800
06,15044,0615044,Compton city, California,1,2013,97872,44.70,69.20,9.40,47835,50037,37036,30259,503,571,0,31367,66505
06,16000,0616000,Concord city, California,1,2013,125892,40.70,76.50,14.10,63078,62814,87069,4960,9969,842,0,82934,42958
06,16350,0616350,Corona city, California,1,2013,159507,44.00,74.20,9.30,80964,78543,113725,9006,19927,970,364,93558,65949
06,16532,0616532,Costa Mesa city, California,1,2013,112184,49.80,79.50,8.50,59396,52788,76144,1118,11754,376,1071,75895,36289
06,17918,0617918,Daly City city, California,1,2013,104747,46.50,81.90,15.10,53029,51718,25447,3714,55900,305,249,74316,30431
06,18100,0618100,Davis city, California,0,2013,66197,56.30,83.40,10.60,32704,33493,43798,1765,13955,38,127,57698,8499
06,19766,0619766,Downey city, California,1,2013,113240,48.30,77.00,12.00,55806,57434,83815,6280,5990,499,54,32344,80896
06,20802,0620802,East Los Angeles CDP, California,0,2013,137967,48.80,70.60,9.00,67176,70791,90389,221,1609,254,0,3424,134543
06,21712,0621712,El Cajon city, California,1,2013,102207,42.70,73.50,10.80,50753,51454,73696,5855,3061,202,717,72324,29883
06,22020,0622020,Elk Grove city, California,1,2013,161029,41.90,68.60,9.40,80252,80777,76985,18427,43231,392,2975,129951,31078
06,22230,0622230,El Monte city, California,1,2013,115685,43.70,75.60,14.00,58680,57005,66096,1028,35486,253,0,41354,74331
06,22804,0622804,Escondido city, California,1,2013,148728,46.20,74.90,10.10,71886,76842,119407,4063,8288,1199,310,75325,73403
06,23182,0623182,Fairfield city, California,1,2013,109302,44.50,75.00,10.60,54416,54886,47581,16492,16242,752,1789,74704,34598
06,24638,0624638,Folsom city, California,1,2013,73099,39.10,75.40,12.00,38633,34466,49922,4105,12403,108,204,66126,6973
06,24680,0624680,Fontana city, California,1,2013,203008,46.20,68.30,6.70,100416,102592,105540,22012,14667,1169,1157,69644,133364
06,26000,0626000,Fremont city, California,1,2013,224904,42.90,76.10,10.70,108836,116068,62417,7183,120731,1074,1311,193964,30940
06,27000,0627000,Fresno city, California,1,2013,509965,44.20,70.10,9.70,249538,260427,268855,42836,68125,6867,961,265804,244161
06,28000,0628000,Fullerton city, California,1,2013,138979,47.40,77.80,12.50,66085,72894,75660,4014,32258,305,492,85643,53336
06,29000,0629000,Garden Grove city, California,1,2013,175115,42.50,75.60,11.90,89197,85918,74672,1752,61583,767,1645,107153,67962
06,30000,0630000,Glendale city, California,1,2013,196000,42.10,81.60,16.20,93038,102962,141375,3339,31805,475,105,164009,31991
06,32548,0632548,Hawthorne city, California,1,2013,86204,49.50,74.20,7.70,43101,43103,36391,18796,5637,159,931,36236,49968
06,33000,0633000,Hayward city, California,1,2013,151582,45.10,78.30,11.70,73500,78082,55033,15394,37828,1379,4158,91764,59818
06,33182,0633182,Hemet city, California,1,2013,81734,36.50,75.30,21.50,39449,42285,58863,5150,1791,525,0,47148,34586
06,33434,0633434,Hesperia city, California,1,2013,92159,44.80,68.50,8.00,46928,45231,76847,4217,809,478,138,43823,48336
06,36000,0636000,Huntington Beach city, California,1,2013,197577,41.30,79.40,15.30,97676,99901,155576,1808,23476,224,1065,158258,39319
06,36448,0636448,Indio city, California,1,2013,83546,41.90,70.40,13.10,42526,41020,42321,1845,1635,899,777,23847,59699
06,36546,0636546,Inglewood city, California,1,2013,111544,43.70,74.00,10.50,52735,58809,31645,45315,762,123,0,51040,60504
06,36770,0636770,Irvine city, California,1,2013,236724,47.20,79.00,9.60,113416,123308,122292,3932,91945,523,15,208787,27937
06,37692,0637692,Jurupa Valley city, California,0,2013,98036,44.20,72.40,8.90,46915,51121,55919,3602,873,980,364,29092,68944
06,39496,0639496,Lake Forest city, California,1,2013,79300,39.60,76.30,12.60,39630,39670,51266,2155,10850,156,366,60976,18324
06,39892,0639892,Lakewood city, California,1,2013,81136,40.20,74.00,10.60,38356,42780,44482,5632,13746,620,2874,55739,25397
06,40130,0640130,Lancaster city, California,1,2013,159521,42.70,70.60,9.50,80263,79258,104446,31722,6161,898,284,95785,63736
06,41992,0641992,Livermore city, California,1,2013,85169,37.30,72.30,10.80,40627,44542,68295,153,9706,94,0,66700,18469
06,43000,0643000,Long Beach city, California,1,2013,469384,45.60,75.40,10.40,233932,235452,247260,64295,58532,9999,4057,271705,197679
06,44000,0644000,Los Angeles city, California,1,2013,3884340,47.00,78.00,11.00,1928557,1955783,1994140,346154,441638,25381,8217,1970839,1913501
06,44574,0644574,Lynwood city, California,1,2013,71387,49.50,65.00,5.30,34219,37168,46707,5444,1076,296,42,7869,63518
06,45484,0645484,Manteca city, California,1,2013,71949,42.20,71.60,9.70,35327,36622,50704,2489,6079,337,210,44308,27641
06,46842,0646842,Menifee city, California,1,2013,83459,38.50,76.90,21.40,39822,43637,59012,6051,4052,324,43,53633,29826
06,46898,0646898,Merced city, California,1,2013,81089,43.00,67.10,9.50,40601,40488,37125,2956,11151,526,0,37949,43140
06,47766,0647766,Milpitas city, California,1,2013,69796,45.00,79.70,11.40,33916,35880,13466,1762,46128,539,771,58561,11235
06,48256,0648256,Mission Viejo city, California,1,2013,96350,32.50,79.30,17.90,47257,49093,77505,2936,8646,177,75,79676,16674
06,48354,0648354,Modesto city, California,1,2013,204925,41.80,74.60,12.80,100772,104153,136008,8420,17706,1251,784,130492,74433
06,49270,0649270,Moreno Valley city, California,1,2013,201187,46.70,70.70,7.40,97059,104128,101184,33926,10379,1850,1097,84056,117131
06,49670,0649670,Mountain View city, California,1,2013,77839,47.50,78.60,10.10,39001,38838,47399,1369,23796,242,0,63643,14196
06,50076,0650076,Murrieta city, California,1,2013,107457,41.70,70.30,11.10,53391,54066,71238,7976,7308,279,298,78358,29099
06,50258,0650258,Napa city, California,1,2013,79059,41.30,75.70,13.10,39174,39885,59156,1133,1766,1065,54,48556,30503
06,51182,0651182,Newport Beach city, California,1,2013,87265,35.30,81.80,18.70,43287,43978,75633,696,6590,78,351,81318,5947
06,52526,0652526,Norwalk city, California,1,2013,106588,44.50,73.20,11.30,51357,55231,71659,4473,9819,1570,0,28031,78557
06,53000,0653000,Oakland city, California,1,2013,406228,46.00,79.50,11.70,202378,203850,159842,103294,65753,2923,2291,298147,108081
06,53322,0653322,Oceanside city, California,1,2013,172795,44.00,78.50,12.90,85047,87748,118738,10189,11022,1629,2504,110125,62670
06,53896,0653896,Ontario city, California,1,2013,167496,46.30,70.20,8.20,81781,85715,82603,10122,8837,746,1534,52087,115409
06,53980,0653980,Orange city, California,1,2013,139983,45.80,78.10,11.60,71017,68966,96897,1542,14537,809,77,78539,61444
06,54652,0654652,Oxnard city, California,1,2013,203014,46.70,72.30,9.00,102892,100122,155944,7686,13968,2119,196,50668,152346
06,55156,0655156,Palmdale city, California,1,2013,157146,39.90,69.10,8.50,79785,77361,68990,19876,8111,1653,0,71697,85449
06,55282,0655282,Palo Alto city, California,0,2013,66638,33.10,76.30,19.40,32683,33955,44516,372,16876,0,0,60772,5866
06,56000,0656000,Pasadena city, California,1,2013,139727,46.40,81.90,15.10,67371,72356,83946,17158,19061,424,67,91022,48705
06,56700,0656700,Perris city, California,1,2013,72334,45.40,68.50,7.30,34605,37729,27190,7992,1772,90,0,21526,50808
06,57456,0657456,Pittsburg city, California,0,2013,66703,43.90,76.10,12.50,31736,34967,23203,10321,11485,685,2051,38289,28414
06,57792,0657792,Pleasanton city, California,1,2013,74112,33.10,73.00,15.20,36963,37149,46761,1699,20642,94,237,68339,5773
06,58072,0658072,Pomona city, California,1,2013,151349,46.60,74.60,8.80,75369,75980,102192,9248,15971,1757,944,51325,100024
06,59444,0659444,Rancho Cordova city, California,0,2013,67919,40.60,76.20,13.10,31655,36264,43829,8171,6732,706,782,53351,14568
06,59451,0659451,Rancho Cucamonga city, California,1,2013,171359,45.70,75.50,10.30,87775,83584,116339,16354,20491,671,90,108155,63204
06,59920,0659920,Redding city, California,1,2013,91124,38.50,77.70,17.80,43919,47205,74879,1314,3793,2396,0,83713,7411
06,59962,0659962,Redlands city, California,1,2013,70000,39.90,72.50,13.20,33020,36980,50774,8116,5853,201,105,47031,22969
06,60018,0660018,Redondo Beach city, California,1,2013,67816,40.20,79.80,12.30,31836,35980,47468,2725,9784,292,97,55665,12151
06,60102,0660102,Redwood City city, California,1,2013,80875,43.40,77.20,11.30,40022,40853,54934,2709,11314,168,147,53919,26956
06,60466,0660466,Rialto city, California,1,2013,101889,44.40,67.70,6.80,51573,50316,64188,14498,1178,48,211,28559,73330
06,60620,0660620,Richmond city, California,1,2013,107580,45.30,76.90,12.10,51831,55749,44512,22538,15283,275,588,64353,43227
06,62000,0662000,Riverside city, California,1,2013,316613,46.80,73.70,9.30,156957,159656,217849,17135,23184,1879,816,147286,169327
06,62938,0662938,Roseville city, California,1,2013,127039,40.70,75.10,14.10,60972,66067,99852,1885,11708,601,214,108204,18835
06,64000,0664000,Sacramento city, California,1,2013,479671,44.20,75.80,11.40,232923,246748,243460,64174,88123,2116,7776,351199,128472
06,64224,0664224,Salinas city, California,1,2013,155649,46.80,68.80,6.70,79842,75807,121162,2820,11394,1169,109,42596,113053
06,65000,0665000,San Bernardino city, California,1,2013,213700,43.80,71.80,8.80,103840,109860,127260,30083,10264,1720,811,80454,133246
06,65042,0665042,San Buenaventura (Ventura) city, California,1,2013,108811,38.30,80.10,15.40,53262,55549,91582,766,4609,725,288,74697,34114
06,65084,0665084,San Clemente city, California,0,2013,65021,37.00,77.10,14.90,33335,31686,49978,1437,1790,11,0,49690,15331
06,66000,0666000,San Diego city, California,1,2013,1355885,47.10,78.10,11.60,689167,666718,870219,85305,233507,7268,6017,950096,405789
06,67000,0667000,San Francisco city, California,1,2013,837442,48.50,86.60,14.20,425845,411597,406041,47985,280667,4079,3481,709047,128395
06,68000,0668000,San Jose city, California,1,2013,998514,43.70,76.00,11.20,501691,496823,429466,32276,331114,5775,1476,663779,334735
06,68084,0668084,San Leandro city, California,1,2013,87967,37.90,79.80,13.50,45527,42440,38405,11957,28401,747,326,65039,22928
06,68196,0668196,San Marcos city, California,1,2013,89375,44.10,77.30,12.20,43627,45748,65721,1788,7347,327,137,53097,36278
06,68252,0668252,San Mateo city, California,1,2013,101132,41.20,81.20,16.60,49095,52037,59487,3452,22742,96,1726,75300,25832
06,68378,0668378,San Ramon city, California,1,2013,74514,37.30,71.10,9.00,37813,36701,35711,1973,31592,158,0,68488,6026
06,69000,0669000,Santa Ana city, California,1,2013,334241,48.20,71.60,7.70,169122,165119,147726,3592,34063,524,1207,75011,259230
06,69070,0669070,Santa Barbara city, California,1,2013,90431,47.70,82.50,15.50,44687,45744,66423,1292,3496,353,91,54339,36092
06,69084,0669084,Santa Clara city, California,1,2013,120250,49.80,79.30,9.60,61144,59106,49138,4929,53333,233,266,101502,18748
06,69088,0669088,Santa Clarita city, California,1,2013,179582,39.40,75.30,11.70,88283,91299,131491,6038,17454,888,112,125421,54161
06,69196,0669196,Santa Maria city, California,1,2013,102205,43.60,67.10,9.10,51214,50991,42614,818,4568,242,314,23272,78933
06,70000,0670000,Santa Monica city, California,1,2013,92484,45.00,84.80,17.80,45265,47219,74719,3672,8261,0,0,80110,12374
06,70098,0670098,Santa Rosa city, California,1,2013,171996,40.00,77.40,15.20,83556,88440,122706,5234,7252,4279,1151,120473,51523
06,72016,0672016,Simi Valley city, California,1,2013,126177,37.40,77.50,14.90,60478,65699,102196,1735,8700,360,144,93561,32616
06,73080,0673080,South Gate city, California,1,2013,95664,47.40,74.40,9.40,49046,46618,59138,1247,747,165,162,3710,91954
06,73262,0673262,South San Francisco city, California,0,2013,66174,38.60,77.20,13.90,33280,32894,19388,1149,27426,219,2000,43943,22231
06,73430,0673430,South Whittier CDP, California,0,2013,65365,44.30,73.90,9.40,31534,33831,49465,101,4174,180,0,14916,50449
06,75000,0675000,Stockton city, California,1,2013,298115,42.30,71.80,12.00,146145,151970,125699,32577,64079,1481,1633,168260,129855
06,77000,0677000,Sunnyvale city, California,1,2013,147559,44.80,79.50,14.10,76888,70671,68905,3853,62253,428,1236,127280,20279
06,78120,0678120,Temecula city, California,1,2013,106783,44.00,71.20,9.60,51092,55691,73019,5554,11978,1494,663,81512,25271
06,78582,0678582,Thousand Oaks city, California,1,2013,128739,34.90,78.30,15.90,63556,65183,98182,971,13379,432,0,104558,24181
06,80000,0680000,Torrance city, California,1,2013,147485,35.60,79.50,16.30,70830,76655,77587,3201,50149,625,72,125231,22254
06,80238,0680238,Tracy city, California,1,2013,84683,43.50,68.10,6.30,44424,40259,48804,5132,11146,55,1227,51438,33245
06,80812,0680812,Turlock city, California,1,2013,70358,44.70,73.20,12.40,33771,36587,59619,1734,3608,405,93,44660,25698
06,80854,0680854,Tustin city, California,1,2013,78326,43.60,74.90,9.60,37725,40601,31780,2069,19166,992,104,47350,30976
06,81204,0681204,Union City city, California,1,2013,72540,42.50,78.30,13.70,35897,36643,14454,3504,38905,807,1390,57792,14748
06,81344,0681344,Upland city, California,1,2013,75420,40.70,77.00,13.70,36275,39145,46002,3932,9430,215,93,48444,26976
06,81554,0681554,Vacaville city, California,1,2013,94272,40.60,76.80,13.20,50078,44194,62668,9301,6153,496,148,75951,18321
06,81666,0681666,Vallejo city, California,1,2013,118855,39.50,80.60,14.20,58073,60782,53917,24482,28420,601,712,88981,29874
06,82590,0682590,Victorville city, California,1,2013,121080,43.80,68.30,8.40,56286,64794,74986,23316,3859,1188,1151,56202,64878
06,82954,0682954,Visalia city, California,1,2013,127758,41.90,70.70,11.40,61123,66635,105139,4080,6857,1746,51,71219,56539
06,82996,0682996,Vista city, California,1,2013,96919,48.80,81.90,10.50,47915,49004,82048,3644,4196,344,460,53767,43152
06,83346,0683346,Walnut Creek city, California,0,2013,66890,33.60,83.50,26.60,30998,35892,53256,715,8944,33,466,62107,4783
06,84200,0684200,West Covina city, California,1,2013,107741,41.10,77.60,12.30,53072,54669,42095,5818,28993,423,125,50374,57367
06,84550,0684550,Westminster city, California,1,2013,91750,40.00,76.90,16.60,44156,47594,37247,370,46930,849,42,69380,22370
06,85292,0685292,Whittier city, California,1,2013,86618,41.90,74.80,13.00,40960,45658,51180,1484,4939,408,34,29763,56855
06,86832,0686832,Yorba Linda city, California,0,2013,67042,32.20,75.80,16.70,34123,32919,48931,358,13224,288,251,55580,11462
06,86972,0686972,Yuba City city, California,0,2013,65410,40.90,73.10,12.30,31590,33820,44500,2188,11995,460,124,47681,17729
08,03455,0803455,Arvada city, Colorado,1,2013,112028,39.80,76.40,13.30,54410,57618,103428,712,1652,1095,31,95633,16395
08,04000,0804000,Aurora city, Colorado,1,2013,345814,43.90,73.40,9.60,165357,180457,214760,55731,17868,1619,1197,245311,100503
08,07850,0807850,Boulder city, Colorado,1,2013,103163,59.00,85.80,10.00,53194,49969,92788,959,5003,406,42,96432,6731
08,12815,0812815,Centennial city, Colorado,1,2013,106101,38.60,75.90,13.70,54168,51933,92861,1489,5382,356,0,98991,7110
08,16000,0816000,Colorado Springs city, Colorado,1,2013,439858,42.80,75.60,11.60,216483,223375,346461,25014,13750,2786,756,364465,75393
08,20000,0820000,Denver city, Colorado,1,2013,649495,49.00,79.00,10.70,324648,324847,504146,64113,21095,5214,897,448690,200805
08,27425,0827425,Fort Collins city, Colorado,1,2013,152056,52.40,81.40,10.70,76812,75244,135911,1743,4202,927,183,136395,15661
08,32155,0832155,Greeley city, Colorado,1,2013,96549,46.90,74.80,11.00,48302,48247,66659,2822,1114,786,93,62731,33818
08,36410,0836410,Highlands Ranch CDP, Colorado,0,2013,106264,40.00,67.70,8.20,54098,52166,92910,954,8032,78,0,95332,10932
08,43000,0843000,Lakewood city, Colorado,1,2013,147220,40.70,81.00,15.90,74997,72223,130283,1790,3852,1487,234,114020,33200
08,45970,0845970,Longmont city, Colorado,1,2013,90075,39.20,74.50,11.20,44497,45578,70968,1215,3013,2148,437,64373,25702
08,46465,0846465,Loveland city, Colorado,1,2013,71331,39.60,76.50,14.90,33769,37562,66156,348,359,115,22,63029,8302
08,62000,0862000,Pueblo city, Colorado,1,2013,108247,40.10,76.70,15.60,53949,54298,73002,3994,763,4232,122,51520,56727
08,77290,0877290,Thornton city, Colorado,1,2013,127352,44.50,71.10,8.50,64567,62785,102986,2823,7794,1282,0,85076,42276
08,83835,0883835,Westminster city, Colorado,1,2013,110940,42.60,75.50,11.50,55602,55338,97182,1355,6181,1025,37,89895,21045
09,08000,0908000,Bridgeport city, Connecticut,1,2013,147216,45.60,74.60,9.90,72307,74909,56541,53488,4026,1153,236,89585,57631
09,18430,0918430,Danbury city, Connecticut,1,2013,83690,42.60,79.20,13.50,38152,45538,54693,4147,4714,110,0,56680,27010
09,37000,0937000,Hartford city, Connecticut,1,2013,125035,45.70,74.10,11.10,60732,64303,36583,52781,2751,71,0,70721,54314
09,50370,0950370,New Britain city, Connecticut,1,2013,72941,42.70,75.70,13.40,33930,39011,48401,8223,3014,100,0,41891,31050
09,52000,0952000,New Haven city, Connecticut,1,2013,130654,50.20,78.40,11.70,60296,70358,53286,44982,6347,438,0,95505,35149
09,55990,0955990,Norwalk city, Connecticut,1,2013,87775,42.40,78.30,11.90,42590,45185,64930,14124,3939,89,0,65101,22674
09,73000,0973000,Stamford city, Connecticut,1,2013,126455,43.70,81.20,14.00,62277,64178,77047,17831,9640,83,0,93885,32570
09,80000,0980000,Waterbury city, Connecticut,1,2013,109687,42.80,74.40,12.60,53731,55956,74229,22577,3021,18,101,68278,41409
10,77580,1077580,Wilmington city, Delaware,1,2013,71520,45.90,76.00,12.10,33349,38171,25492,39241,1501,133,0,61932,9588
11,50000,1150000,Washington city, District of Columbia,1,2013,646449,51.30,82.70,11.40,306147,340302,264080,315504,22963,1272,104,580889,65560
12,00410,1200410,Alafaya CDP, Florida,0,2013,76821,49.10,75.50,8.70,36673,40148,58481,6657,4930,0,0,54749,22072
12,07300,1207300,Boca Raton city, Florida,1,2013,89409,33.80,82.10,23.90,44966,44443,78705,3710,1218,145,0,79312,10097
12,07875,1207875,Boynton Beach city, Florida,1,2013,71103,36.80,84.40,20.50,33142,37961,-998,-998,-998,-998,-998,62596,8507
12,08150,1208150,Brandon CDP, Florida,0,2013,115318,43.70,74.40,9.30,54007,61311,84599,19321,3867,546,0,81643,33675
12,10275,1210275,Cape Coral city, Florida,1,2013,165849,32.60,78.00,20.60,78751,87098,151324,3677,2210,725,37,131896,33953
12,12875,1212875,Clearwater city, Florida,1,2013,109705,36.10,81.20,20.80,52267,57438,89479,11053,2873,864,246,95963,13742
12,14400,1214400,Coral Springs city, Florida,1,2013,126595,41.80,73.60,10.10,60631,65964,85499,28214,5114,528,120,94594,32001
12,16475,1216475,Davie town, Florida,1,2013,96818,43.10,80.10,14.10,48398,48420,73780,9329,4971,543,63,62078,34740
12,16725,1216725,Deerfield Beach city, Florida,1,2013,78045,35.20,81.00,23.80,39268,38777,51941,19949,2185,411,0,63175,14870
12,17200,1217200,Deltona city, Florida,1,2013,86300,35.40,75.30,15.90,40601,45699,67226,9773,471,561,0,57715,28585
12,24000,1224000,Fort Lauderdale city, Florida,1,2013,172374,39.10,83.70,16.40,91550,80824,112789,50947,2489,368,0,142707,29667
12,24125,1224125,Fort Myers city, Florida,0,2013,68184,41.20,79.20,16.40,36097,32087,40875,21812,1065,133,0,52984,15200
12,25175,1225175,Gainesville city, Florida,1,2013,127493,63.70,88.30,8.50,63026,64467,83163,30483,6892,222,1379,114253,13240
12,30000,1230000,Hialeah city, Florida,1,2013,233394,38.10,82.00,20.70,110935,122459,222377,4505,119,139,0,7554,225840
12,32000,1232000,Hollywood city, Florida,1,2013,146522,37.70,79.60,15.90,73161,73361,106834,24400,3077,32,179,101766,44756
12,35000,1235000,Jacksonville city, Florida,1,2013,842588,42.10,76.80,12.20,408223,434365,508387,258404,37511,2675,892,773861,68727
12,36100,1236100,Kendall CDP, Florida,0,2013,71373,37.20,78.50,17.00,33513,37860,60916,4090,3330,0,0,29263,42110
12,36950,1236950,Kissimmee city, Florida,0,2013,65186,42.50,75.90,13.00,32528,32658,52144,5459,1979,0,0,22981,42205
12,38250,1238250,Lakeland city, Florida,1,2013,100697,37.50,79.10,19.90,47549,53148,77699,18234,1417,0,0,87957,12740
12,39425,1239425,Largo city, Florida,1,2013,78415,33.60,85.10,24.30,39314,39101,66870,5674,1267,46,0,67612,10803
12,39550,1239550,Lauderhill city, Florida,1,2013,69793,41.90,71.30,12.40,30362,39431,-998,-998,-998,-998,-998,62966,6827
12,39925,1239925,Lehigh Acres CDP, Florida,0,2013,118806,43.00,70.60,10.20,58118,60688,72020,26787,1634,59,131,72665,46141
12,43975,1243975,Melbourne city, Florida,1,2013,77490,34.80,85.60,24.60,37685,39805,65193,6910,2444,330,0,71741,5749
12,45000,1245000,Miami city, Florida,1,2013,417670,42.80,81.20,15.70,212832,204838,315219,84724,3142,449,0,120744,296926
12,45025,1245025,Miami Beach city, Florida,1,2013,91019,44.40,85.00,16.40,49059,41960,76310,3063,1153,184,0,43971,47048
12,45060,1245060,Miami Gardens city, Florida,1,2013,111381,43.40,76.80,11.30,53806,57575,33034,75280,1340,43,0,74698,36683
12,45975,1245975,Miramar city, Florida,1,2013,130281,45.00,73.70,7.50,62242,68039,45373,69133,4545,138,46,81761,48520
12,53000,1253000,Orlando city, Florida,1,2013,255479,47.90,77.90,10.40,125911,129568,152592,68191,9644,1177,12,185774,69705
12,54000,1254000,Palm Bay city, Florida,1,2013,104894,34.70,77.80,15.00,48476,56418,74403,24405,919,723,0,91047,13847
12,54200,1254200,Palm Coast city, Florida,1,2013,79378,32.70,79.90,27.10,37148,42230,64275,8306,2671,179,0,70867,8511
12,55775,1255775,Pembroke Pines city, Florida,1,2013,162333,39.40,78.60,15.40,74735,87598,104082,30420,12419,540,0,97888,64445
12,56825,1256825,Pine Hills CDP, Florida,0,2013,67295,44.10,72.30,11.00,33335,33960,11875,47838,1365,0,0,56173,11122
12,57425,1257425,Plantation city, Florida,1,2013,90280,39.30,79.30,12.10,45470,44810,67866,15290,4128,0,58,67612,22668
12,58050,1258050,Pompano Beach city, Florida,1,2013,104406,39.80,82.20,20.40,54364,50042,72156,28843,1064,0,0,83968,20438
12,58715,1258715,Port St. Lucie city, Florida,1,2013,170999,37.00,75.00,16.50,83806,87193,126801,30176,4120,0,0,137082,33917
12,60950,1260950,Riverview CDP, Florida,0,2013,75934,43.60,71.70,8.60,37416,38518,49494,15468,3546,174,0,63488,12446
12,63000,1263000,St. Petersburg city, Florida,1,2013,249702,37.10,81.60,17.00,116653,133049,172547,58681,8151,514,201,231675,18027
12,68350,1268350,Spring Hill CDP, Florida,0,2013,101349,33.30,77.00,22.30,48197,53152,87704,7143,1640,321,0,86253,15096
12,69700,1269700,Sunrise city, Florida,1,2013,90133,38.50,78.70,15.90,39614,50519,49936,32071,2944,0,0,68035,22098
12,70600,1270600,Tallahassee city, Florida,1,2013,186408,58.00,82.60,9.40,88071,98337,104567,68652,7341,427,0,174304,12104
12,71000,1271000,Tampa city, Florida,1,2013,352981,44.40,78.90,12.10,170578,182403,229892,85472,14629,664,50,269304,83677
12,72145,1272145,Town 'n' Country CDP, Florida,0,2013,77829,42.90,80.70,14.10,35883,41946,66717,5187,2474,230,0,42015,35814
12,76582,1276582,Weston city, Florida,0,2013,68386,34.00,68.50,9.30,34533,33853,59099,3344,2913,106,0,37906,30480
12,76600,1276600,West Palm Beach city, Florida,1,2013,102433,39.80,81.20,17.50,49347,53086,61692,34976,1788,0,0,78098,24335
13,01052,1301052,Albany city, Georgia,1,2013,76151,43.30,73.00,11.90,34866,41285,19950,53445,662,68,39,74271,1880
13,03440,1303440,Athens-Clarke County unified government (balance), Georgia,1,2013,120212,58.70,82.60,8.80,57379,62833,78215,31906,5118,78,0,107257,12955
13,04000,1304000,Atlanta city, Georgia,1,2013,447848,51.50,81.00,10.70,224933,222915,181595,233662,18809,701,77,423844,24004
13,04204,1304204,Augusta-Richmond County consolidated government (balance), Georgia,1,2013,196711,42.50,76.00,11.90,94979,101732,75931,108310,3042,309,499,187733,8978
13,19000,1319000,Columbus city, Georgia,1,2013,202824,44.20,75.40,11.70,99399,103425,93310,92316,4360,398,0,187985,14839
13,42425,1342425,Johns Creek city, Georgia,1,2013,82761,37.80,71.20,8.30,39751,43010,50996,8228,19366,434,0,78799,3962
13,49000,1349000,Macon city, Georgia,1,2013,90107,41.30,74.50,11.20,41055,49052,23917,63595,490,31,0,87568,2539
13,67284,1367284,Roswell city, Georgia,1,2013,94029,43.60,75.80,11.40,43973,50056,69863,14938,4440,532,0,81612,12417
13,68516,1368516,Sandy Springs city, Georgia,1,2013,99769,43.50,78.00,11.90,46639,53130,65568,25282,3954,375,0,85484,14285
13,69000,1369000,Savannah city, Georgia,1,2013,142772,46.20,77.00,12.60,67518,75254,58739,78078,2026,394,48,134295,8477
13,80508,1380508,Warner Robins city, Georgia,1,2013,72321,46.30,70.30,9.10,35146,37175,37194,29358,3705,135,0,69483,2838
15,71550,1571550,Urban Honolulu CDP, Hawaii,0,2013,347907,40.70,82.30,18.60,171644,176263,65619,6846,186103,63,26625,323005,24902
16,08830,1608830,Boise City city, Idaho,1,2013,214235,44.10,77.10,11.40,106240,107995,189324,2922,8388,2554,775,197592,16643
16,52120,1652120,Meridian city, Idaho,1,2013,83594,35.70,70.20,10.80,40680,42914,-998,-998,-998,-998,-998,78262,5332
16,56260,1656260,Nampa city, Idaho,1,2013,86514,41.00,67.20,11.70,43738,42776,76180,1140,254,408,29,63696,22818
17,02154,1702154,Arlington Heights village, Illinois,1,2013,76069,38.10,80.10,16.60,36379,39690,61977,949,9801,0,0,71564,4505
17,03012,1703012,Aurora city, Illinois,1,2013,202665,44.90,69.50,7.70,97727,104938,114029,19537,17441,257,145,115544,87121
17,06613,1706613,Bloomington city, Illinois,1,2013,78911,44.90,77.50,11.30,37299,41612,60613,9625,5859,34,0,74866,4045
17,07133,1707133,Bolingbrook village, Illinois,1,2013,74969,45.40,70.80,8.50,36600,38369,36333,14141,8129,142,0,55016,19953
17,12385,1712385,Champaign city, Illinois,1,2013,83421,59.80,81.30,7.60,43807,39614,54129,15373,9551,14,0,77626,5795
17,14000,1714000,Chicago city, Illinois,1,2013,2718789,47.90,78.00,10.70,1325677,1393112,1326635,863542,163321,6205,1127,1936172,782617
17,14351,1714351,Cicero town, Illinois,1,2013,84107,45.30,66.50,5.80,41126,42981,49808,2560,439,1302,0,9273,74834
17,18823,1718823,Decatur city, Illinois,1,2013,72842,38.40,78.30,17.80,34003,38839,52248,13782,979,315,0,71357,1485
17,23074,1723074,Elgin city, Illinois,1,2013,108694,43.80,71.60,10.30,56687,52007,66628,7902,7154,144,0,64566,44128
17,24582,1724582,Evanston city, Illinois,1,2013,75579,45.10,78.90,14.50,35051,40528,49237,13549,8077,376,0,66938,8641
17,38570,1738570,Joliet city, Illinois,1,2013,148411,45.30,72.30,8.60,73688,74723,98775,25095,2644,191,0,103837,44574
17,51622,1751622,Naperville city, Illinois,1,2013,144736,38.10,73.40,11.10,70489,74247,112634,4601,22523,203,0,133654,11082
17,57225,1757225,Palatine village, Illinois,1,2013,69304,43.80,75.90,10.80,33805,35499,44623,2168,8639,87,0,53159,16145
17,59000,1759000,Peoria city, Illinois,1,2013,116575,42.70,74.80,12.80,55002,61573,72456,30348,6129,216,0,110009,6566
17,65000,1765000,Rockford city, Illinois,1,2013,152618,40.00,73.40,14.40,73981,78637,102919,31033,4080,297,0,126094,26524
17,68003,1768003,Schaumburg village, Illinois,1,2013,75850,42.70,81.50,14.10,36712,39138,49393,2028,19461,0,0,70106,5744
17,70122,1770122,Skokie village, Illinois,0,2013,65183,35.30,75.50,19.10,30744,34439,43064,2197,15565,412,0,56409,8774
17,72000,1772000,Springfield city, Illinois,1,2013,116858,39.30,76.90,14.50,56263,60595,87968,21375,3232,0,87,113553,3305
17,79293,1779293,Waukegan city, Illinois,1,2013,90252,46.20,71.20,6.50,45714,44538,57914,15091,4382,503,0,41522,48730
18,05860,1805860,Bloomington city, Indiana,1,2013,80693,68.10,89.50,9.30,38912,41781,66466,3408,7880,79,81,76950,3743
18,10342,1810342,Carmel city, Indiana,1,2013,84542,35.20,70.90,12.80,41570,42972,70514,3074,6845,188,0,82557,1985
18,22000,1822000,Evansville city, Indiana,1,2013,117439,39.10,78.70,16.40,56672,60767,96340,16163,639,660,183,114122,3317
18,23278,1823278,Fishers town, Indiana,1,2013,85588,42.60,65.90,5.60,41428,44160,71156,4991,7560,0,0,81437,4151
18,25000,1825000,Fort Wayne city, Indiana,1,2013,251340,40.90,74.40,12.80,120983,130357,183670,40317,7519,374,75,230276,21064
18,27000,1827000,Gary city, Indiana,1,2013,75375,35.00,73.20,17.00,33122,42253,11315,60039,318,209,821,70794,4581
18,31000,1831000,Hammond city, Indiana,1,2013,78958,43.00,73.20,10.00,38307,40651,37209,19772,1070,523,0,49640,29318
18,36003,1836003,Indianapolis city (balance), Indiana,1,2013,838425,43.40,75.30,10.70,407301,431124,509372,235416,20418,1741,0,754998,83427
18,40788,1840788,Lafayette city, Indiana,1,2013,69720,48.30,76.60,11.30,34036,35684,61946,4398,1505,149,0,62558,7162
18,51876,1851876,Muncie city, Indiana,1,2013,70107,51.40,85.20,15.00,32038,38069,58449,7541,987,33,0,68402,1705
18,71000,1871000,South Bend city, Indiana,1,2013,101975,42.00,73.80,12.40,49918,52057,65662,26755,1329,465,105,89133,12842
19,12000,1912000,Cedar Rapids city, Iowa,1,2013,128422,42.40,77.50,13.60,60570,67852,110589,9972,1932,41,0,122847,5575
19,19000,1919000,Davenport city, Iowa,1,2013,102165,39.70,76.40,13.60,51565,50600,82705,12715,2019,123,48,93485,8680
19,21000,1921000,Des Moines city, Iowa,1,2013,207293,44.50,75.00,10.80,104548,102745,161270,22822,9136,638,48,179746,27547
19,38595,1938595,Iowa City city, Iowa,1,2013,71598,63.40,85.60,8.70,35333,36265,58245,4368,6598,81,243,68345,3253
19,73335,1973335,Sioux City city, Iowa,1,2013,81325,43.00,74.20,13.10,39975,41350,68654,3091,2077,815,0,66483,14842
19,82425,1982425,Waterloo city, Iowa,1,2013,68366,41.10,77.80,16.00,33471,34895,54166,12001,576,121,0,65193,3173
20,36000,2036000,Kansas City city, Kansas,1,2013,148112,41.40,71.70,10.80,73434,74678,89101,38935,5152,915,65,105919,42193
20,38900,2038900,Lawrence city, Kansas,1,2013,92730,57.60,83.10,9.00,45201,47529,75666,4363,4606,2225,0,86853,5877
20,52575,2052575,Olathe city, Kansas,1,2013,131903,43.20,70.60,8.80,66138,65765,110985,6703,6474,205,46,116078,15825
20,53775,2053775,Overland Park city, Kansas,1,2013,181273,39.10,75.60,13.50,87412,93861,152985,10383,12011,757,108,170340,10933
20,71000,2071000,Topeka city, Kansas,1,2013,127702,38.70,77.50,16.10,60814,66888,102351,12417,1637,1034,47,110789,16913
20,79000,2079000,Wichita city, Kansas,1,2013,386558,40.40,73.50,12.60,192002,194556,298594,45158,19233,3347,0,322874,63684
21,46027,2146027,Lexington-Fayette urban county, Kentucky,1,2013,308428,46.40,78.90,11.40,150932,157496,232749,46201,11551,933,115,287226,21202
21,48006,2148006,Louisville/Jefferson County metro government (balance), Kentucky,1,2013,609908,40.20,77.10,13.50,294423,315485,435907,139241,13357,500,350,580168,29740
22,05000,2205000,Baton Rouge city, Louisiana,1,2013,229405,47.30,79.30,13.10,107862,121543,86004,127266,9512,502,0,223175,6230
22,08920,2208920,Bossier City city, Louisiana,0,2013,66334,47.00,73.70,11.10,31154,35180,42904,17507,1498,1055,0,59808,6526
22,39475,2239475,Kenner city, Louisiana,1,2013,66975,38.60,78.60,15.90,31528,35447,45890,14611,3102,131,0,55222,11753
22,40735,2240735,Lafayette city, Louisiana,1,2013,124282,44.80,78.70,11.20,60245,64037,76983,40629,2664,552,0,118646,5636
22,41155,2241155,Lake Charles city, Louisiana,1,2013,74032,42.60,76.00,12.70,37216,36816,31329,38587,1098,0,0,71938,2094
22,50115,2250115,Metairie CDP, Louisiana,0,2013,143630,39.40,79.60,17.20,72258,71372,121554,11729,4838,640,25,119928,23702
22,55000,2255000,New Orleans city, Louisiana,1,2013,378715,44.60,79.40,11.80,181823,196892,130880,224787,11508,681,69,357866,20849
22,70000,2270000,Shreveport city, Louisiana,1,2013,200191,41.00,74.80,13.50,94091,106100,79332,112011,2771,1122,235,194949,5242
23,60545,2360545,Portland city, Maine,1,2013,66316,46.30,82.00,12.40,33313,33003,55848,4885,2561,71,0,63711,2605
24,04000,2404000,Baltimore city, Maryland,1,2013,622104,44.30,78.90,12.00,292760,329344,187993,391451,14728,2668,356,593664,28440
24,07125,2407125,Bethesda CDP, Maryland,0,2013,66364,35.30,77.60,18.80,30405,35959,53016,1483,7575,109,0,61565,4799
24,19125,2419125,Columbia CDP, Maryland,0,2013,102907,39.20,77.70,12.10,51545,51362,55539,30745,11951,698,0,96033,6874
24,26000,2426000,Ellicott City CDP, Maryland,0,2013,69535,35.70,74.00,14.30,33794,35741,45385,4858,16160,0,0,65323,4212
24,30325,2430325,Frederick city, Maryland,0,2013,66910,42.60,77.10,14.50,31973,34937,47065,9265,5534,333,68,56912,9998
24,31175,2431175,Gaithersburg city, Maryland,0,2013,65689,41.40,73.20,12.40,31437,34252,32715,12158,9202,160,0,48601,17088
24,32025,2432025,Germantown CDP, Maryland,0,2013,94958,46.10,72.20,5.50,48170,46788,39336,21075,22032,0,0,72883,22075
24,32650,2432650,Glen Burnie CDP, Maryland,0,2013,66760,40.10,76.30,15.10,32270,34490,39317,19150,2877,67,390,62773,3987
24,72450,2472450,Silver Spring CDP, Maryland,0,2013,76563,46.00,76.70,8.20,37384,39179,32448,18298,5409,137,0,51767,24796
24,81175,2481175,Waldorf CDP, Maryland,0,2013,69685,45.20,72.80,7.70,32061,37624,23796,39863,2725,445,0,66307,3378
25,07000,2507000,Boston city, Massachusetts,1,2013,644710,54.50,83.40,10.60,308191,336519,341007,155619,57743,3161,0,523214,121496
25,09000,2509000,Brockton city, Massachusetts,1,2013,94101,41.70,74.20,12.50,44164,49937,45220,38046,1908,395,0,86759,7342
25,11000,2511000,Cambridge city, Massachusetts,1,2013,107276,62.60,88.00,10.00,51084,56192,71166,11936,16141,280,78,97412,9864
25,23000,2523000,Fall River city, Massachusetts,1,2013,88686,40.80,78.70,17.70,41161,47525,75638,3954,1770,0,221,81636,7050
25,24960,2524960,Framingham CDP, Massachusetts,0,2013,70448,43.30,78.40,13.00,31632,38816,52142,5823,4248,143,0,58411,12037
25,34550,2534550,Lawrence city, Massachusetts,1,2013,77665,46.60,74.20,9.90,36387,41278,36041,7887,2328,90,0,19738,57927
25,37000,2537000,Lowell city, Massachusetts,1,2013,108868,47.20,76.30,10.70,55965,52903,60912,7124,22296,175,0,86223,22645
25,37490,2537490,Lynn city, Massachusetts,1,2013,91595,39.10,73.50,11.90,44387,47208,46199,12519,6333,0,335,59378,32217
25,45000,2545000,New Bedford city, Massachusetts,1,2013,95079,42.00,78.00,15.90,45059,50020,68959,3364,1214,361,0,73966,21113
25,45560,2545560,Newton city, Massachusetts,1,2013,87977,38.70,78.20,15.20,42877,45100,68877,3048,11979,71,0,83273,4704
25,55745,2555745,Quincy city, Massachusetts,1,2013,93490,43.20,84.10,15.30,44615,48875,63629,4686,22330,0,0,90810,2680
25,62535,2562535,Somerville city, Massachusetts,1,2013,78814,58.40,88.10,12.50,39185,39629,64233,3853,5483,201,42,73356,5458
25,67000,2567000,Springfield city, Massachusetts,1,2013,153694,42.70,73.50,11.40,72298,81396,80788,36120,3518,1266,52,91489,62205
25,82000,2582000,Worcester city, Massachusetts,1,2013,182538,47.30,77.80,11.00,90259,92279,129201,25562,11456,501,213,142094,40444
26,03000,2603000,Ann Arbor city, Michigan,1,2013,117034,58.70,85.50,9.90,57828,59206,85137,11131,14840,231,0,111836,5198
26,21000,2621000,Dearborn city, Michigan,1,2013,95888,39.40,68.60,12.40,46014,49874,86788,3922,2154,0,0,93180,2708
26,22000,2622000,Detroit city, Michigan,1,2013,688740,41.40,75.10,12.60,326379,362361,88347,553258,9072,2436,116,635440,53300
26,27440,2627440,Farmington Hills city, Michigan,1,2013,81293,35.40,80.90,19.50,38753,42540,55308,16453,7272,62,0,78126,3167
26,29000,2629000,Flint city, Michigan,1,2013,99758,38.60,74.50,12.30,48371,51387,39170,54234,352,341,23,96530,3228
26,34000,2634000,Grand Rapids city, Michigan,1,2013,192285,46.20,75.80,10.90,92190,100095,134449,39821,2740,794,49,163688,28597
26,42160,2642160,Kalamazoo city, Michigan,1,2013,75542,56.50,79.60,9.70,38561,36981,48603,17435,2186,388,0,68146,7396
26,46000,2646000,Lansing city, Michigan,1,2013,114113,44.10,75.50,10.60,54675,59438,71643,22961,4503,516,70,99981,14132
26,49000,2649000,Livonia city, Michigan,1,2013,95212,33.50,78.90,17.70,46585,48627,86390,3489,3372,305,0,92216,2996
26,69035,2669035,Rochester Hills city, Michigan,1,2013,72957,35.10,78.20,15.50,35939,37018,61440,2302,7178,207,0,69039,3918
26,74900,2674900,Southfield city, Michigan,1,2013,73012,35.60,78.00,18.90,34625,38387,17783,52461,406,30,0,72517,495
26,76460,2676460,Sterling Heights city, Michigan,1,2013,131204,38.20,79.70,17.00,67987,63217,112832,5499,8300,0,301,128100,3104
26,80700,2680700,Troy city, Michigan,1,2013,82822,36.40,76.20,15.40,40763,42059,60413,2613,18030,27,0,80022,2800
26,84000,2684000,Warren city, Michigan,1,2013,134875,38.60,78.60,16.20,65085,69790,99806,20694,9960,657,0,132198,2677
26,86000,2686000,Westland city, Michigan,1,2013,82586,42.90,82.50,14.60,37772,44814,65526,12514,1989,188,0,80890,1696
26,88940,2688940,Wyoming city, Michigan,1,2013,74114,47.80,75.30,8.80,37512,36602,62486,2991,2103,230,0,57606,16508
27,06616,2706616,Bloomington city, Minnesota,1,2013,86321,36.90,79.70,19.40,42567,43754,68804,8739,3568,189,0,80318,6003
27,07966,2707966,Brooklyn Park city, Minnesota,1,2013,78373,42.90,72.90,8.70,39396,38977,40382,21184,12445,357,126,74281,4092
27,17000,2717000,Duluth city, Minnesota,1,2013,86125,46.10,82.00,14.10,41874,44251,77172,2855,1517,2017,16,84144,1981
27,17288,2717288,Eagan city, Minnesota,0,2013,65453,40.60,74.30,11.20,32042,33411,51203,6500,4524,613,0,62929,2524
27,40166,2740166,Maple Grove city, Minnesota,0,2013,65406,37.10,72.30,11.40,31054,34352,56878,1611,5390,0,0,63112,2294
27,43000,2743000,Minneapolis city, Minnesota,1,2013,400079,51.50,80.40,8.80,201059,199020,256874,72382,24860,4097,104,361455,38624
27,51730,2751730,Plymouth city, Minnesota,1,2013,73987,39.70,76.00,14.40,35613,38374,59808,5131,7128,95,0,71609,2378
27,54880,2754880,Rochester city, Minnesota,1,2013,110731,40.30,75.20,13.30,52083,58648,90673,7429,7508,129,0,104494,6237
27,56896,2756896,St. Cloud city, Minnesota,0,2013,67754,54.20,78.30,9.00,35234,32520,57224,5951,1982,759,128,65639,2115
27,58000,2758000,St. Paul city, Minnesota,1,2013,294873,46.70,74.30,8.70,145710,149163,173335,47597,49270,3727,58,266644,28229
27,71428,2771428,Woodbury city, Minnesota,0,2013,65659,39.30,72.70,8.80,32024,33635,53479,2863,5977,145,189,63266,2393
28,29700,2829700,Gulfport city, Mississippi,1,2013,71022,43.40,78.00,13.90,33692,37330,41865,25250,1225,288,0,66836,4186
28,36000,2836000,Jackson city, Mississippi,1,2013,172585,43.70,73.60,11.00,79641,92944,-998,-998,-998,-998,-998,170542,2043
29,15670,2915670,Columbia city, Missouri,1,2013,115287,55.80,83.10,9.60,55102,60185,93564,8062,7159,557,77,111399,3888
29,35000,2935000,Independence city, Missouri,1,2013,117246,36.90,77.40,16.90,54908,62338,96025,12532,1070,539,340,108269,8977
29,38000,2938000,Kansas City city, Missouri,1,2013,467082,42.70,77.00,12.00,231475,235607,278765,131562,12142,2137,1440,418520,48562
29,41348,2941348,Lee's Summit city, Missouri,1,2013,93669,38.00,71.20,13.20,44375,49294,81633,6959,2268,459,352,90629,3040
29,54074,2954074,O'Fallon city, Missouri,1,2013,82802,41.30,72.20,9.10,41728,41074,74227,2269,4081,103,0,81022,1780
29,64082,2964082,St. Charles city, Missouri,0,2013,67566,43.70,77.80,12.90,33256,34310,58581,5353,947,38,0,63444,4122
29,64550,2964550,St. Joseph city, Missouri,1,2013,77845,40.50,76.00,13.00,38893,38952,-998,-998,-998,-998,-998,73006,4839
29,65000,2965000,St. Louis city, Missouri,1,2013,318416,45.90,79.60,11.10,154551,163865,147036,152570,9272,830,90,306515,11901
29,70000,2970000,Springfield city, Missouri,1,2013,164133,48.90,81.60,14.60,78009,86124,143982,7227,3180,1092,177,156570,7563
30,06550,3006550,Billings city, Montana,1,2013,109062,40.40,77.50,16.00,52823,56239,96902,779,954,5940,88,102290,6772
30,50200,3050200,Missoula city, Montana,1,2013,69116,51.20,83.30,13.10,34035,35081,62876,75,1152,1823,0,66661,2455
31,28000,3128000,Lincoln city, Nebraska,1,2013,268743,45.90,77.20,12.00,134460,134283,228457,12271,11326,1930,63,250041,18702
31,37000,3137000,Omaha city, Nebraska,1,2013,434353,42.50,75.10,11.80,214685,219668,343081,54315,10674,1409,215,376188,58165
32,23770,3223770,Enterprise CDP, Nevada,0,2013,121164,44.20,76.80,10.50,63132,58032,66439,8923,31409,430,2408,101581,19583
32,31900,3231900,Henderson city, Nevada,1,2013,270798,37.00,78.40,17.40,130792,140006,212627,15885,23842,974,1369,238271,32527
32,40000,3240000,Las Vegas city, Nevada,1,2013,603525,41.70,75.40,13.20,303074,300451,376135,73355,41993,3003,3056,415470,188055
32,51800,3251800,North Las Vegas city, Nevada,1,2013,226872,46.90,69.10,7.90,114747,112125,107447,40916,12206,1749,3013,130685,96187
32,54600,3254600,Paradise CDP, Nevada,0,2013,225861,44.00,77.50,11.20,116658,109203,154353,21683,15933,871,1081,150304,75557
32,60600,3260600,Reno city, Nevada,1,2013,233306,43.40,76.70,12.00,118707,114599,188632,5792,15389,2199,1851,171053,62253
32,68400,3268400,Sparks city, Nevada,1,2013,93281,39.80,75.50,14.40,44169,49112,74331,3229,4821,1471,125,73471,19810
32,68585,3268585,Spring Valley CDP, Nevada,0,2013,188025,45.50,80.50,13.40,90194,97831,108212,21887,35258,1613,1895,146014,42011
32,71400,3271400,Sunrise Manor CDP, Nevada,0,2013,181454,41.20,74.50,11.10,90511,90943,102938,22208,9590,711,1257,87549,93905
33,45140,3345140,Manchester city, New Hampshire,1,2013,110369,45.50,80.00,13.50,55156,55213,94904,4420,5583,74,0,100814,9555
33,50260,3350260,Nashua city, New Hampshire,1,2013,87138,39.30,77.40,14.30,41141,45997,71471,2414,7277,85,0,76644,10494
34,03580,3403580,Bayonne city, New Jersey,0,2013,65024,44.30,79.70,13.90,32539,32485,45606,6327,6438,423,0,49831,15193
34,10000,3410000,Camden city, New Jersey,1,2013,76903,42.30,66.40,7.70,36756,40147,9927,42232,2875,0,0,41780,35123
34,13690,3413690,Clifton city, New Jersey,1,2013,85379,41.40,78.70,13.40,42474,42905,63554,3903,8540,192,0,54341,31038
34,19390,3419390,East Orange city, New Jersey,0,2013,64543,42.30,75.90,11.70,29026,35517,2127,59132,679,275,0,61739,2804
34,21000,3421000,Elizabeth city, New Jersey,1,2013,127552,44.40,73.00,10.00,60997,66555,63344,22864,1328,583,0,43996,83556
34,36000,3436000,Jersey City city, New Jersey,1,2013,257345,50.20,78.80,9.50,125879,131466,95797,64138,62433,349,0,183819,73526
34,51000,3451000,Newark city, New Jersey,1,2013,278436,46.20,74.90,8.60,140692,137744,62772,142789,2631,1688,43,175854,102582
34,56550,3456550,Passaic city, New Jersey,1,2013,70876,46.80,65.40,6.90,35231,35645,41508,9800,2201,1619,126,19231,51645
34,57000,3457000,Paterson city, New Jersey,1,2013,145952,43.40,75.00,10.60,69586,76366,47426,48455,7770,182,0,62859,83093
34,73110,3473110,Toms River CDP, New Jersey,0,2013,89957,33.60,79.10,17.90,43820,46137,80641,2654,4691,335,0,85304,4653
34,74000,3474000,Trenton city, New Jersey,1,2013,84344,48.70,76.20,7.20,43813,40531,19730,46257,1693,148,0,58370,25974
34,74630,3474630,Union City city, New Jersey,1,2013,68248,45.50,77.60,10.30,35816,32432,43541,4532,1558,984,0,7998,60250
35,02000,3502000,Albuquerque city, New Mexico,1,2013,556489,41.90,76.60,13.30,271156,285333,434500,19847,15513,21926,642,293293,263196
35,39380,3539380,Las Cruces city, New Mexico,1,2013,101317,44.60,75.30,14.10,49630,51687,87633,2195,961,1904,0,46000,55317
35,63460,3563460,Rio Rancho city, New Mexico,1,2013,91928,39.00,73.20,14.00,44400,47528,75931,2121,1698,1493,44,56090,35838
35,70500,3570500,Santa Fe city, New Mexico,1,2013,69969,35.10,81.50,20.90,32245,37724,57433,438,1112,1570,155,36202,33767
36,01000,3601000,Albany city, New York,1,2013,98441,52.60,83.30,13.20,47064,51377,57073,27932,7270,63,281,89358,9083
36,11000,3611000,Buffalo city, New York,1,2013,258945,44.80,77.10,12.00,126110,132835,123198,96248,10830,829,17,230086,28859
36,15000,3615000,Cheektowaga CDP, New York,0,2013,74338,38.50,81.80,19.20,34085,40253,62765,8312,1313,96,0,72724,1614
36,49121,3649121,Mount Vernon city, New York,1,2013,68218,40.80,76.70,12.20,32530,35688,16862,44129,1462,193,0,59845,8373
36,50617,3650617,New Rochelle city, New York,1,2013,79453,38.10,79.60,16.70,39521,39932,52248,14293,3755,0,0,55272,24181
36,51000,3651000,New York city, New York,1,2013,8405837,44.80,78.80,12.80,4010741,4395096,3659632,2070401,1133042,30380,5908,5977081,2428756
36,63000,3663000,Rochester city, New York,1,2013,210345,46.00,75.60,10.20,103067,107278,95512,86081,5119,1720,325,172398,37947
36,65508,3665508,Schenectady city, New York,1,2013,65915,44.30,78.00,12.50,31426,34489,40144,15653,3764,542,0,59624,6291
36,73000,3673000,Syracuse city, New York,1,2013,144675,47.20,78.60,12.00,67528,77147,79566,42312,9046,1861,30,132103,12572
36,84000,3684000,Yonkers city, New York,1,2013,199764,40.50,77.50,16.90,90485,109279,119741,32231,11286,28,0,129155,70609
37,02140,3702140,Asheville city, North Carolina,1,2013,87251,41.90,80.00,17.40,42147,45104,72333,11097,1136,134,0,81545,5706
37,10740,3710740,Cary town, North Carolina,1,2013,151560,41.60,73.90,9.10,74119,77441,110441,11618,21610,695,41,136974,14586
37,12000,3712000,Charlotte city, North Carolina,1,2013,792849,46.70,74.80,9.00,378742,414107,394713,284328,43223,3098,73,682798,110051
37,14100,3714100,Concord city, North Carolina,1,2013,83507,44.70,72.00,9.90,40269,43238,59023,15774,3033,204,44,73419,10088
37,19000,3719000,Durham city, North Carolina,1,2013,245466,48.50,77.40,9.30,114919,130547,118676,98160,11527,471,0,209953,35513
37,22920,3722920,Fayetteville city, North Carolina,1,2013,204401,47.40,75.40,10.40,101203,103198,96999,85379,5148,952,358,181663,22738
37,25580,3725580,Gastonia city, North Carolina,1,2013,73205,40.40,74.80,13.60,34544,38661,44100,19960,934,202,0,65907,7298
37,28000,3728000,Greensboro city, North Carolina,1,2013,279651,44.80,78.10,12.60,132489,147162,140880,114751,9431,910,410,259620,20031
37,28080,3728080,Greenville city, North Carolina,1,2013,89142,57.70,81.60,8.70,39892,49250,49884,33517,2809,78,53,85766,3376
37,31400,3731400,High Point city, North Carolina,1,2013,107229,43.70,76.90,12.60,51926,55303,53325,35504,10942,740,47,97444,9785
37,34200,3734200,Jacksonville city, North Carolina,1,2013,69075,53.20,74.10,7.80,38924,30151,45195,15402,2812,231,403,59319,9756
37,55000,3755000,Raleigh city, North Carolina,1,2013,431897,49.70,77.10,9.10,208659,223238,255147,126279,20173,1644,500,385510,46387
37,74440,3774440,Wilmington city, North Carolina,1,2013,112072,46.20,84.10,15.00,51720,60352,85947,20637,1922,563,0,105215,6857
37,75000,3775000,Winston-Salem city, North Carolina,1,2013,236457,42.20,75.80,13.20,110760,125697,134141,81199,2873,981,884,198133,38324
38,07200,3807200,Bismarck city, North Dakota,0,2013,66063,41.20,78.60,15.40,32603,33460,60831,565,637,2454,0,64791,1272
38,25700,3825700,Fargo city, North Dakota,1,2013,112510,51.30,81.40,11.20,57372,55138,100838,4457,3339,1287,28,109247,3263
39,01000,3901000,Akron city, Ohio,1,2013,198095,42.40,78.90,13.80,95758,102337,118338,63736,5252,952,146,192805,5290
39,12000,3912000,Canton city, Ohio,1,2013,72551,36.40,74.10,16.80,32986,39565,-998,-998,-998,-998,-998,69579,2972
39,15000,3915000,Cincinnati city, Ohio,1,2013,297498,45.90,78.40,11.30,145142,152356,155675,123578,5499,517,347,287574,9924
39,16000,3916000,Cleveland city, Ohio,1,2013,390106,41.50,76.70,12.40,187433,202673,156131,202393,5531,2080,0,348130,41976
39,18000,3918000,Columbus city, Ohio,1,2013,822762,48.40,76.90,9.20,401455,421307,508169,224394,37879,1585,349,772911,49851
39,21000,3921000,Dayton city, Ohio,1,2013,143355,45.30,79.60,13.40,70099,73256,78149,57086,2100,339,58,136929,6426
39,44856,3944856,Lorain city, Ohio,0,2013,63706,40.10,73.70,15.90,29599,34107,46427,9286,618,196,37,47287,16419
39,61000,3961000,Parma city, Ohio,1,2013,80427,36.80,80.10,18.20,38284,42143,75034,2833,808,44,0,76078,4349
39,77000,3977000,Toledo city, Ohio,1,2013,282313,41.10,77.60,13.70,138903,143410,181978,74982,3496,1000,33,260229,22084
39,88000,3988000,Youngstown city, Ohio,1,2013,65174,38.30,78.90,16.50,31052,34122,32036,27488,232,328,0,57958,7216
40,09050,4009050,Broken Arrow city, Oklahoma,1,2013,105013,39.60,73.40,11.40,51332,53681,82787,4484,2764,3130,68,96322,8691
40,23200,4023200,Edmond city, Oklahoma,1,2013,87002,40.40,75.20,13.40,43145,43857,73376,5486,2257,1727,412,83242,3760
40,41850,4041850,Lawton city, Oklahoma,1,2013,97142,47.20,75.40,9.50,51171,45971,58982,20510,2224,4031,607,82613,14529
40,52500,4052500,Norman city, Oklahoma,1,2013,118200,51.40,78.20,11.90,58788,59412,92309,5097,7239,5087,358,111306,6894
40,55000,4055000,Oklahoma City city, Oklahoma,1,2013,610617,42.80,75.10,11.70,300775,309842,419802,86352,25328,17516,0,494494,116123
40,75000,4075000,Tulsa city, Oklahoma,1,2013,398724,41.80,75.70,12.60,194834,203890,261172,60285,10598,15455,277,339531,59193
41,05350,4105350,Beaverton city, Oregon,1,2013,93525,45.00,79.80,11.60,47485,46040,69847,2014,11443,1439,712,77549,15976
41,05800,4105800,Bend city, Oregon,1,2013,81236,42.80,76.60,13.40,39248,41988,74156,456,1931,558,185,72877,8359
41,23850,4123850,Eugene city, Oregon,1,2013,159161,47.20,82.30,13.40,79449,79712,132965,2938,7242,1738,1067,145483,13678
41,31250,4131250,Gresham city, Oregon,1,2013,109410,41.00,73.60,12.10,55848,53562,85340,5075,3448,876,1800,90430,18980
41,34100,4134100,Hillsboro city, Oregon,1,2013,97371,44.90,74.10,10.50,46494,50877,79797,546,8607,96,547,74176,23195
41,47000,4147000,Medford city, Oregon,1,2013,77680,39.50,74.20,15.70,39535,38145,70335,859,1034,261,0,65651,12029
41,59000,4159000,Portland city, Oregon,1,2013,611134,48.10,81.60,11.30,302285,308849,474549,35745,45933,5639,2386,550160,60974
41,64900,4164900,Salem city, Oregon,1,2013,160618,43.20,75.60,12.00,78896,81722,132125,1833,5592,829,728,129452,31166
42,02000,4202000,Allentown city, Pennsylvania,1,2013,118577,45.00,73.80,12.00,56574,62003,68390,16274,2427,338,0,62415,56162
42,06088,4206088,Bethlehem city, Pennsylvania,1,2013,74241,43.70,83.30,16.30,37326,36915,56823,4314,2265,450,0,55049,19192
42,24000,4224000,Erie city, Pennsylvania,1,2013,100676,44.50,78.60,13.30,50022,50654,76294,15993,2407,208,40,93685,6991
42,60000,4260000,Philadelphia city, Pennsylvania,1,2013,1553165,45.20,77.80,12.40,734249,818916,646435,670482,106286,3322,375,1347132,206033
42,61000,4261000,Pittsburgh city, Pennsylvania,1,2013,305838,49.20,83.70,14.30,147786,158052,207899,72398,14628,560,0,297622,8216
42,63624,4263624,Reading city, Pennsylvania,1,2013,87894,43.10,68.90,8.80,44414,43480,46494,9617,301,2405,417,33593,54301
42,69000,4269000,Scranton city, Pennsylvania,1,2013,75814,41.80,77.90,16.30,36019,39795,65569,5135,2768,184,0,67054,8760
44,19180,4419180,Cranston city, Rhode Island,1,2013,80575,39.00,78.70,15.40,41509,39066,68746,2967,1734,65,0,70530,10045
44,54640,4454640,Pawtucket city, Rhode Island,1,2013,71178,42.10,76.40,11.20,35006,36172,42453,13769,286,273,264,54231,16947
44,59000,4459000,Providence city, Rhode Island,1,2013,177995,52.00,76.70,8.60,87505,90490,89225,28410,12653,1699,31,107119,70876
44,74300,4474300,Warwick city, Rhode Island,1,2013,81983,36.80,80.60,17.40,38656,43327,74942,619,2474,17,0,76908,5075
45,13330,4513330,Charleston city, South Carolina,1,2013,130428,45.90,81.20,14.40,60391,70037,96793,29593,1251,226,35,126841,3587
45,16000,4516000,Columbia city, South Carolina,1,2013,133377,57.50,82.50,9.50,69643,63734,67338,55072,3275,317,80,124373,9004
45,48535,4548535,Mount Pleasant town, South Carolina,1,2013,74876,41.60,75.20,12.10,36728,38148,-998,-998,-998,-998,-998,73535,1341
45,50875,4550875,North Charleston city, South Carolina,1,2013,101838,46.10,77.70,8.90,50649,51189,44550,49555,1479,140,94,91576,10262
45,61405,4561405,Rock Hill city, South Carolina,1,2013,69104,44.00,76.40,12.80,33541,35563,36980,27015,2566,64,0,66366,2738
46,52980,4652980,Rapid City city, South Dakota,1,2013,70810,39.30,76.90,15.70,35348,35462,55323,802,770,8446,0,66759,4051
46,59020,4659020,Sioux Falls city, South Dakota,1,2013,163629,43.00,76.30,11.70,82343,81286,141676,6710,2739,4261,267,155833,7796
47,15160,4715160,Clarksville city, Tennessee,1,2013,142355,50.40,72.20,6.80,71579,70776,95372,30729,2957,953,87,128122,14233
47,27740,4727740,Franklin city, Tennessee,0,2013,68872,39.00,74.50,11.50,33039,35833,58920,3730,3068,208,0,66645,2227
47,37640,4737640,Jackson city, Tennessee,0,2013,67685,40.30,76.90,15.40,31353,36332,-998,-998,-998,-998,-998,67311,374
47,38320,4738320,Johnson City city, Tennessee,0,2013,65796,43.80,82.90,17.30,32544,33252,57714,4502,1918,0,0,63614,2182
47,40000,4740000,Knoxville city, Tennessee,1,2013,183261,49.10,82.00,13.00,86650,96611,142222,29541,4401,514,247,173878,9383
47,48000,4748000,Memphis city, Tennessee,1,2013,653450,43.70,74.90,10.50,311131,342319,197962,411962,10959,1057,0,610077,43373
47,51560,4751560,Murfreesboro city, Tennessee,1,2013,117039,52.30,78.10,8.90,58963,58076,89151,19225,3906,484,0,110663,6376
47,52006,4752006,Nashville-Davidson metropolitan government (balance), Tennessee,1,2013,634465,46.80,78.40,10.60,307078,327387,391895,176670,21073,2279,350,569533,64932
48,01000,4801000,Abilene city, Texas,1,2013,119036,47.40,77.00,12.00,61966,57070,93231,11453,2248,493,123,86652,32384
48,01924,4801924,Allen city, Texas,1,2013,92025,42.70,70.10,7.40,43530,48495,70743,6221,10496,183,280,77529,14496
48,03000,4803000,Amarillo city, Texas,1,2013,196691,41.50,72.60,12.10,96308,100383,164749,12391,7385,1428,79,137159,59532
48,04000,4804000,Arlington city, Texas,1,2013,379565,43.60,72.50,9.30,185091,194474,258264,66741,27701,1815,0,267265,112300
48,04462,4804462,Atascocita CDP, Texas,0,2013,65166,41.60,70.00,8.40,33796,31370,43931,10928,3263,0,595,49365,15801
48,05000,4805000,Austin city, Texas,1,2013,885415,51.80,78.10,7.60,444955,440460,688286,65314,54535,2560,666,584066,301349
48,06128,4806128,Baytown city, Texas,1,2013,76327,38.80,71.80,11.70,38001,38326,52870,11440,431,505,142,44021,32306
48,07000,4807000,Beaumont city, Texas,1,2013,117808,41.30,77.00,14.50,56216,61592,53857,56669,4450,73,0,104708,13100
48,10768,4810768,Brownsville city, Texas,1,2013,181850,42.00,66.80,9.70,86287,95563,170101,361,2972,228,0,12967,168883
48,10912,4810912,Bryan city, Texas,1,2013,78718,49.90,74.20,9.60,41502,37216,47484,10675,3531,453,101,49015,29703
48,13024,4813024,Carrollton city, Texas,1,2013,126695,43.20,75.50,9.70,62326,64369,80188,10501,21624,397,0,86187,40508
48,15976,4815976,College Station city, Texas,1,2013,100036,69.70,84.80,5.10,49613,50423,79275,7605,7885,146,50,85642,14394
48,17000,4817000,Corpus Christi city, Texas,1,2013,316389,41.60,74.70,12.60,154688,161701,264567,13646,5923,1546,402,125544,190845
48,19000,4819000,Dallas city, Texas,1,2013,1257676,46.40,73.90,9.10,627752,629924,747660,305645,43327,2272,467,737940,519736
48,19972,4819972,Denton city, Texas,1,2013,123105,56.10,80.60,8.40,58775,64330,94701,15151,4903,495,135,96625,26480
48,22660,4822660,Edinburg city, Texas,1,2013,80830,49.60,70.00,7.40,39475,41355,67557,2006,3421,189,0,12309,68521
48,24000,4824000,El Paso city, Texas,1,2013,674438,42.70,71.80,11.70,327441,346997,570340,24351,7822,3202,1148,134987,539451
48,26232,4826232,Flower Mound town, Texas,0,2013,68397,35.40,71.20,7.00,33881,34516,57879,2404,5723,404,0,61602,6795
48,27000,4827000,Fort Worth city, Texas,1,2013,794189,44.90,71.20,8.60,389743,404446,492980,146387,26809,4767,1188,519244,274945
48,27684,4827684,Frisco city, Texas,1,2013,136783,42.40,67.20,7.40,68935,67848,103493,10160,16144,138,125,115999,20784
48,29000,4829000,Garland city, Texas,1,2013,234694,40.50,71.10,9.70,112430,122264,100582,31486,19632,1827,92,137358,97336
48,30464,4830464,Grand Prairie city, Texas,1,2013,183324,44.60,70.10,7.60,86486,96838,111205,47438,9179,262,0,106946,76378
48,32372,4832372,Harlingen city, Texas,0,2013,65677,39.00,71.00,14.20,33258,32419,-998,-998,-998,-998,-998,13688,51989
48,35000,4835000,Houston city, Texas,1,2013,2197374,46.00,74.90,9.50,1101445,1095929,1289328,508643,138809,8801,752,1236816,960558
48,37000,4837000,Irving city, Texas,1,2013,228652,49.10,73.10,7.50,115507,113145,133190,29180,38709,454,286,136376,92276
48,39148,4839148,Killeen city, Texas,1,2013,137160,49.30,69.80,6.20,68075,69085,63674,47082,5931,1782,1462,97679,39481
48,41464,4841464,Laredo city, Texas,1,2013,249085,43.60,65.70,8.50,121967,127118,237387,1317,1098,977,0,12067,237018
48,41980,4841980,League City city, Texas,1,2013,92163,41.00,73.60,9.10,45368,46795,73623,5908,7347,91,0,78865,13298
48,42508,4842508,Lewisville city, Texas,1,2013,101154,48.40,72.00,6.40,49511,51643,75244,10470,7720,71,0,69701,31453
48,43888,4843888,Longview city, Texas,1,2013,81683,41.90,73.40,13.90,40804,40879,58218,19020,899,280,0,64778,16905
48,45000,4845000,Lubbock city, Texas,1,2013,239544,48.50,76.00,11.00,116543,123001,183737,20194,5647,1770,16,157123,82421
48,45384,4845384,McAllen city, Texas,1,2013,136631,44.20,70.10,10.80,68527,68104,120782,802,3464,536,0,18916,117715
48,45744,4845744,McKinney city, Texas,1,2013,148544,43.30,67.70,9.00,76625,71919,120430,17442,5768,378,51,118941,29603
48,47892,4847892,Mesquite city, Texas,1,2013,143341,44.70,71.50,8.00,69340,74001,92594,37272,4032,924,0,94124,49217
48,48072,4848072,Midland city, Texas,1,2013,123935,42.00,73.10,10.40,61099,62836,89865,8031,1616,487,864,75571,48364
48,48768,4848768,Mission city, Texas,1,2013,81047,41.30,64.20,11.60,38529,42518,-998,-998,-998,-998,-998,11560,69487
48,48804,4848804,Missouri City city, Texas,1,2013,69521,40.70,77.70,11.50,34658,34863,23107,32563,10377,0,0,59578,9943
48,52356,4852356,North Richland Hills city, Texas,0,2013,67319,40.00,76.40,13.20,32257,35062,55999,2152,4035,491,388,55885,11434
48,53388,4853388,Odessa city, Texas,1,2013,110406,44.30,70.50,9.00,55743,54663,90079,6142,1399,881,0,51412,58994
48,56000,4856000,Pasadena city, Texas,1,2013,152734,43.50,68.70,8.30,75949,76785,126078,3361,3052,2338,0,51687,101047
48,56348,4856348,Pearland city, Texas,1,2013,102491,39.60,71.70,10.40,50328,52163,60242,21561,15633,219,0,82124,20367
48,57200,4857200,Pharr city, Texas,1,2013,73785,43.10,64.80,8.60,34264,39521,-998,-998,-998,-998,-998,3453,70332
48,58016,4858016,Plano city, Texas,1,2013,273519,41.20,74.90,10.30,132139,141380,188898,21946,50081,1822,24,237142,36377
48,61796,4861796,Richardson city, Texas,1,2013,104477,41.00,77.80,14.60,51360,53117,68811,10089,17651,65,0,86505,17972
48,63500,4863500,Round Rock city, Texas,1,2013,109835,45.20,68.80,6.50,54683,55152,82855,11064,6235,198,0,79583,30252
48,64472,4864472,San Angelo city, Texas,1,2013,100111,44.40,76.60,14.70,49094,51017,81385,5256,1308,272,0,60126,39985
48,65000,4865000,San Antonio city, Texas,1,2013,1409000,44.40,74.40,11.30,692077,716923,1115376,100363,37803,7593,1137,520958,888042
48,70808,4870808,Sugar Land city, Texas,1,2013,83851,32.80,77.20,12.90,41965,41886,40489,7844,30890,0,0,75328,8523
48,72176,4872176,Temple city, Texas,0,2013,70182,39.90,73.60,13.10,35049,35133,50209,13850,2001,136,266,54525,15657
48,72656,4872656,The Woodlands CDP, Texas,0,2013,100843,35.40,71.40,11.00,50126,50717,88379,2482,7153,0,60,85788,15055
48,74144,4874144,Tyler city, Texas,1,2013,100217,41.50,77.00,16.00,44948,55269,71637,23255,1673,103,0,74835,25382
48,75428,4875428,Victoria city, Texas,0,2013,65097,38.10,73.90,14.30,31867,33230,55568,5095,819,94,0,31896,33201
48,76000,4876000,Waco city, Texas,1,2013,129031,48.60,75.60,11.50,61893,67138,83488,25576,3321,442,34,87702,41329
48,79000,4879000,Wichita Falls city, Texas,1,2013,104900,45.80,77.50,12.20,55746,49154,81388,13437,2701,749,0,84572,20328
49,43660,4943660,Layton city, Utah,1,2013,70798,44.80,68.50,6.30,35122,35676,62459,654,1534,312,482,62777,8021
49,55980,4955980,Ogden city, Utah,1,2013,84239,45.80,73.50,9.70,43021,41218,74874,1694,939,1421,233,59749,24490
49,57300,4957300,Orem city, Utah,1,2013,91650,49.10,71.10,8.90,44296,47354,79586,497,2866,794,1661,77289,14361
49,62470,4962470,Provo city, Utah,1,2013,116289,64.00,75.80,5.90,57127,59162,100000,1293,2874,1020,1554,95984,20305
49,65330,4965330,St. George city, Utah,1,2013,76824,35.00,71.10,21.10,37282,39542,69773,476,151,239,868,66261,10563
49,67000,4967000,Salt Lake City city, Utah,1,2013,191160,49.30,77.80,11.00,98142,93018,139809,5637,9855,2093,5388,151750,39410
49,67440,4967440,Sandy city, Utah,1,2013,90215,40.80,72.40,12.80,45622,44593,78346,946,3539,161,558,81208,9007
49,82950,4982950,West Jordan city, Utah,1,2013,110064,47.50,67.00,6.50,55835,54229,93782,773,3472,2024,1829,90384,19680
49,83470,4983470,West Valley City city, Utah,1,2013,133597,46.00,68.50,7.40,65050,68547,77798,4143,4450,1596,8286,86085,47512
51,01000,5101000,Alexandria city, Virginia,1,2013,148892,50.00,82.30,9.50,71874,77018,96307,33626,9913,237,0,123680,25212
51,03000,5103000,Arlington CDP, Virginia,0,2013,224906,54.40,83.40,9.40,111593,113313,160325,19607,21316,1858,146,189856,35050
51,14440,5114440,Centreville CDP, Virginia,0,2013,72622,44.80,73.50,5.70,34042,38580,42228,5449,18039,299,43,63622,9000
51,16000,5116000,Chesapeake city, Virginia,1,2013,230571,40.90,75.40,11.60,113137,117434,144713,68899,7393,375,163,218951,11620
51,21088,5121088,Dale City CDP, Virginia,0,2013,66259,44.80,72.00,8.10,33391,32868,37647,18483,5841,356,65,49759,16500
51,35000,5135000,Hampton city, Virginia,1,2013,136699,42.70,78.20,12.90,66193,70506,58817,69903,2494,39,24,129667,7032
51,47672,5147672,Lynchburg city, Virginia,1,2013,78014,49.40,79.70,13.90,36475,41539,50278,21916,2166,0,60,75405,2609
51,56000,5156000,Newport News city, Virginia,1,2013,182020,45.50,76.30,11.50,88530,93490,93041,73712,6320,465,362,167005,15015
51,57000,5157000,Norfolk city, Virginia,1,2013,246139,51.30,79.60,9.70,129237,116902,119451,102683,8565,1322,36,228225,17914
51,64000,5164000,Portsmouth city, Virginia,1,2013,96205,41.10,76.50,13.60,47371,48834,39532,50229,1312,282,0,92732,3473
51,67000,5167000,Richmond city, Virginia,1,2013,214114,48.40,81.50,11.20,102030,112084,94420,102491,4329,905,64,200516,13598
51,68000,5168000,Roanoke city, Virginia,1,2013,98465,40.60,77.90,14.40,47211,51254,64840,26127,2042,378,511,92745,5720
51,76432,5176432,Suffolk city, Virginia,1,2013,85728,39.30,74.80,12.40,41098,44630,44893,35914,612,58,102,82697,3031
51,82000,5182000,Virginia Beach city, Virginia,1,2013,448479,43.70,76.90,11.80,220447,228032,306569,84836,29786,1415,747,415021,33458
53,03180,5303180,Auburn city, Washington,1,2013,73882,40.80,75.30,11.90,35342,38540,51513,3421,7990,1846,2120,69762,4120
53,05210,5305210,Bellevue city, Washington,1,2013,133990,41.40,78.40,14.50,68617,65373,78855,3949,41754,344,75,124632,9358
53,05280,5305280,Bellingham city, Washington,1,2013,82635,52.80,83.60,13.10,40445,42190,69177,988,4947,1446,86,77040,5595
53,22640,5322640,Everett city, Washington,1,2013,105355,44.80,77.50,10.90,54768,50587,83349,3876,8716,552,2041,91696,13659
53,23515,5323515,Federal Way city, Washington,1,2013,92717,40.70,74.80,13.50,45170,47547,58043,8618,15545,981,929,75723,16994
53,35275,5335275,Kennewick city, Washington,1,2013,76760,41.60,71.60,11.50,36570,40190,54186,1814,1619,582,21,57339,19421
53,35415,5335415,Kent city, Washington,1,2013,124410,44.30,76.30,9.70,62995,61415,74881,12418,23208,951,5129,107063,17347
53,35940,5335940,Kirkland city, Washington,0,2013,84434,41.10,76.30,10.80,40898,43536,65812,439,11213,524,0,78534,5900
53,53545,5353545,Pasco city, Washington,0,2013,70345,43.10,64.90,8.40,36473,33872,53100,1417,1852,371,0,31573,38772
53,57745,5357745,Renton city, Washington,1,2013,96987,47.40,76.70,9.50,48234,48753,57196,8403,19475,1256,227,83408,13579
53,63000,5363000,Seattle city, Washington,1,2013,652429,51.50,84.60,11.40,325929,326500,459360,46431,87331,3177,2904,610439,41990
53,67000,5367000,Spokane city, Washington,1,2013,210722,42.00,78.60,14.30,104398,106324,183945,6141,6433,2398,963,198934,11788
53,67167,5367167,Spokane Valley city, Washington,1,2013,91111,39.20,78.00,15.50,47103,44008,82801,1184,1901,889,544,86341,4770
53,70000,5370000,Tacoma city, Washington,1,2013,203451,43.70,78.90,13.10,99297,104154,139048,16976,18767,1680,4038,180467,22984
53,74060,5374060,Vancouver city, Washington,1,2013,167410,42.30,75.70,13.40,80972,86438,133065,5745,7969,1124,1548,147364,20046
53,80010,5380010,Yakima city, Washington,1,2013,93260,42.10,72.10,13.00,45253,48007,62853,1361,731,1612,130,50741,42519
55,02375,5502375,Appleton city, Wisconsin,1,2013,74124,42.60,75.10,12.70,36227,37897,62205,1017,6390,697,0,69473,4651
55,22300,5522300,Eau Claire city, Wisconsin,0,2013,67155,49.70,79.40,12.80,32001,35154,61802,466,2830,254,0,65208,1947
55,31000,5531000,Green Bay city, Wisconsin,1,2013,104773,42.00,76.80,11.70,52817,51956,82682,4288,4354,3498,61,91657,13116
55,39225,5539225,Kenosha city, Wisconsin,1,2013,99887,41.90,74.90,11.80,49013,50874,82478,10295,1199,554,52,82508,17379
55,48000,5548000,Madison city, Wisconsin,1,2013,243337,54.00,83.20,10.30,120435,122902,194764,17257,19169,782,0,226108,17229
55,53000,5553000,Milwaukee city, Wisconsin,1,2013,599168,46.10,73.60,9.60,288604,310564,287529,233739,21205,3325,58,494541,104627
55,60500,5560500,Oshkosh city, Wisconsin,0,2013,66771,47.30,81.50,12.80,34431,32340,61457,2015,1845,111,0,64957,1814
55,66000,5566000,Racine city, Wisconsin,1,2013,78204,42.60,73.40,12.40,37044,41160,49253,17475,1062,717,0,60748,17456
55,84250,5584250,Waukesha city, Wisconsin,1,2013,71026,46.40,76.50,10.20,35956,35070,62030,1896,2420,40,0,60563,10463
72,10334,7210334,Caguas zona urbana, Puerto Rico,0,2013,82680,39.90,76.50,16.10,38322,44358,64021,6858,183,432,0,1304,81376
72,14290,7214290,Carolina zona urbana, Puerto Rico,0,2013,153245,40.50,78.20,17.80,70280,82965,89092,37859,1490,6168,0,1828,151417
72,32522,7232522,Guaynabo zona urbana, Puerto Rico,0,2013,72715,39.00,79.80,18.60,33181,39534,57975,3732,0,421,0,1751,70964
72,63820,7263820,Ponce zona urbana, Puerto Rico,0,2013,124904,38.20,76.80,17.90,58619,66285,109201,5303,307,449,0,1135,123769
72,76770,7276770,San Juan zona urbana, Puerto Rico,0,2013,363000,39.20,79.30,18.60,166032,196968,252956,46502,1624,2341,0,5671,357329
72,06593,7206593,Bayamón zona urbana, Puerto Rico,0,2013,178894,40.20,79.30,18.10,84498,94396,112087,13096,408,2402,0,1599,177295
72,52431,7252431,Mayagüez zona urbana, Puerto Rico,0,2013,69454,42.40,80.40,20.40,32954,36500,41889,3848,0,199,0,418,69036
01,07000,0107000,Birmingham city, Alabama,1,2014,212653,43.70,79.30,12.60,98257,114396,51751,154281,1617,413,23,205710,6943
01,21184,0121184,Dothan city, Alabama,0,2014,69400,38.70,75.30,15.90,32542,36858,42496,24772,538,104,0,67315,2085
01,35896,0135896,Hoover city, Alabama,1,2014,84352,38.60,78.50,17.90,40334,44018,64794,11914,3433,0,0,78577,5775
01,37000,0137000,Huntsville city, Alabama,1,2014,187592,40.50,78.90,15.70,90041,97551,117137,58918,4196,461,170,177235,10357
01,50000,0150000,Mobile city, Alabama,1,2014,194670,40.70,76.70,14.60,92585,102085,85101,101500,2823,458,0,188903,5767
01,51000,0151000,Montgomery city, Alabama,1,2014,200486,42.60,75.60,13.20,94746,105740,69942,120378,5732,359,58,193790,6696
01,77256,0177256,Tuscaloosa city, Alabama,1,2014,96116,51.10,80.50,12.10,44911,51205,49611,42277,2368,122,0,93773,2343
02,03000,0203000,Anchorage municipality, Alaska,1,2014,301010,45.50,75.10,8.90,153176,147834,194958,17041,27805,21093,6629,274197,26813
04,04720,0404720,Avondale city, Arizona,1,2014,79621,47.50,71.50,7.50,40906,38715,58729,8253,3691,758,0,42566,37055
04,10670,0410670,Casas Adobes CDP, Arizona,0,2014,72867,39.10,76.70,17.80,34663,38204,58435,1328,992,724,41,49231,23636
04,12000,0412000,Chandler city, Arizona,1,2014,254275,43.10,73.30,9.80,126999,127276,196801,12129,20254,5102,294,191054,63221
04,23620,0423620,Flagstaff city, Arizona,0,2014,68786,55.60,81.80,9.70,33678,35108,52626,2053,2721,6566,0,55552,13234
04,27400,0427400,Gilbert town, Arizona,1,2014,239282,42.10,66.60,7.10,118543,120739,194359,7108,17164,3730,356,200636,38646
04,27820,0427820,Glendale city, Arizona,1,2014,237529,41.30,72.70,10.60,112405,125124,182397,13931,13440,2839,367,149417,88112
04,28380,0428380,Goodyear city, Arizona,0,2014,75676,38.20,74.90,13.50,37150,38526,60436,7876,2609,952,174,55957,19719
04,46000,0446000,Mesa city, Arizona,1,2014,464682,40.10,75.00,15.80,230440,234242,406265,15288,8467,7689,1569,326567,138115
04,54050,0454050,Peoria city, Arizona,1,2014,166955,36.70,76.40,16.70,81937,85018,141299,6488,7416,583,57,135694,31261
04,55000,0455000,Phoenix city, Arizona,1,2014,1537045,44.20,73.10,9.80,763915,773130,1122320,102038,57181,32233,4750,903946,633099
04,64210,0464210,San Tan Valley CDP, Arizona,0,2014,94390,45.30,65.60,11.30,45883,48507,80498,3747,2009,3448,527,77753,16637
04,65000,0465000,Scottsdale city, Arizona,1,2014,230502,35.50,84.20,22.10,110117,120385,203489,2873,9719,2946,0,207683,22819
04,71510,0471510,Surprise city, Arizona,1,2014,126278,37.30,76.00,20.10,58527,67751,105253,7346,2278,1185,124,101375,24903
04,73000,0473000,Tempe city, Arizona,1,2014,172836,59.70,86.00,10.70,94028,78808,122827,10474,12215,5447,824,137707,35129
04,77000,0477000,Tucson city, Arizona,1,2014,527948,45.90,78.60,13.30,263671,264277,390699,24531,16829,14654,1608,305719,222229
04,85540,0485540,Yuma city, Arizona,1,2014,93399,45.20,74.20,14.30,47677,45722,67779,2925,1480,416,0,40119,53280
05,23290,0523290,Fayetteville city, Arkansas,1,2014,80614,58.80,81.80,8.40,39133,41481,66892,5151,1562,510,12,75008,5606
05,24550,0524550,Fort Smith city, Arkansas,1,2014,87362,42.50,74.70,12.70,43069,44293,66198,9023,4808,702,0,71814,15548
05,35710,0535710,Jonesboro city, Arkansas,1,2014,72214,44.80,76.90,13.50,34707,37507,53915,13322,1081,453,668,67740,4474
05,41000,0541000,Little Rock city, Arkansas,1,2014,197701,42.10,76.70,13.20,90249,107452,104537,81462,4521,272,57,185476,12225
05,50450,0550450,North Little Rock city, Arkansas,0,2014,66813,37.80,72.40,13.10,33195,33618,33691,29729,847,355,0,63804,3009
05,66080,0566080,Springdale city, Arkansas,1,2014,78122,43.90,68.30,9.50,40599,37523,54629,541,2398,239,4424,49386,28736
06,00562,0600562,Alameda city, California,1,2014,77661,41.10,79.50,12.40,37527,40134,39547,4175,23967,90,719,68790,8871
06,00884,0600884,Alhambra city, California,1,2014,85585,40.60,82.00,14.30,41586,43999,18449,1587,43917,374,262,55577,30008
06,02000,0602000,Anaheim city, California,1,2014,346961,44.90,75.00,10.00,171140,175821,240418,6943,62641,549,794,166309,180652
06,02252,0602252,Antioch city, California,1,2014,108953,41.70,74.80,11.00,54821,54132,51135,23209,11208,747,1437,74608,34345
06,02364,0602364,Apple Valley town, California,1,2014,71586,38.20,74.90,16.80,34208,37378,60526,3545,3148,310,41,49330,22256
06,02553,0602553,Arden-Arcade CDP, California,0,2014,99903,37.90,76.40,14.40,47170,52733,66654,7812,7467,275,90,77948,21955
06,03526,0603526,Bakersfield city, California,1,2014,368748,44.00,69.30,9.20,180907,187841,259615,26666,22915,6158,596,187850,180898
06,03666,0603666,Baldwin Park city, California,1,2014,77134,44.40,75.00,10.50,38062,39072,20465,2462,16304,212,327,22162,54972
06,04982,0604982,Bellflower city, California,1,2014,78246,41.40,74.10,10.80,38296,39950,26514,9640,11311,251,159,36564,41682
06,06000,0606000,Berkeley city, California,1,2014,118851,58.30,87.20,12.60,57321,61530,72378,10058,21796,536,82,105704,13147
06,08786,0608786,Buena Park city, California,1,2014,83114,43.60,76.30,10.90,41571,41543,49863,2280,24612,726,0,50159,32955
06,08954,0608954,Burbank city, California,1,2014,105366,43.50,80.40,14.50,51046,54320,74271,1149,10489,776,0,76994,28372
06,10046,0610046,Camarillo city, California,0,2014,66932,35.10,75.10,18.60,32824,34108,53249,1408,6484,164,0,50595,16337
06,11194,0611194,Carlsbad city, California,1,2014,112310,33.90,76.80,15.00,55806,56504,96417,343,8469,131,0,94132,18178
06,11390,0611390,Carmichael CDP, California,0,2014,66493,34.90,80.00,20.80,30625,35868,54942,3418,2820,449,258,56693,9800
06,11530,0611530,Carson city, California,1,2014,93272,42.70,76.80,13.50,47027,46245,27836,20520,23732,99,2274,55317,37955
06,13014,0613014,Chico city, California,1,2014,89187,52.30,81.50,11.70,45207,43980,74917,1711,2709,482,187,74079,15108
06,13210,0613210,Chino city, California,1,2014,84743,46.30,79.00,8.20,51588,33155,37633,6203,7497,651,385,35951,48792
06,13214,0613214,Chino Hills city, California,1,2014,77005,41.80,75.70,7.90,38447,38558,32640,4225,25789,164,0,54849,22156
06,13392,0613392,Chula Vista city, California,1,2014,260977,43.10,73.80,12.90,129689,131288,176481,10652,39570,199,1242,111360,149617
06,13588,0613588,Citrus Heights city, California,1,2014,86147,39.70,79.00,16.30,40533,45614,73036,3097,2500,160,97,71107,15040
06,14218,0614218,Clovis city, California,1,2014,102190,41.00,69.90,10.40,51226,50964,68887,4462,12094,1748,532,72124,30066
06,15044,0615044,Compton city, California,1,2014,98596,48.90,71.30,6.60,47144,51452,43354,31877,804,254,460,33922,64674
06,16000,0616000,Concord city, California,1,2014,127511,41.50,79.00,13.20,63749,63762,93582,4491,12592,758,106,88755,38756
06,16350,0616350,Corona city, California,1,2014,161498,42.80,74.30,9.70,78773,82725,108631,10263,21221,227,820,94299,67199
06,16532,0616532,Costa Mesa city, California,1,2014,112793,48.30,78.40,9.30,56625,56168,67025,2462,10330,123,664,68516,44277
06,17918,0617918,Daly City city, California,1,2014,106099,44.30,81.00,16.90,51276,54823,21455,3113,60677,0,722,78154,27945
06,18100,0618100,Davis city, California,0,2014,66733,59.90,85.20,9.60,32242,34491,38895,2249,17268,0,117,57992,8741
06,19766,0619766,Downey city, California,1,2014,114168,42.80,77.50,11.10,55667,58501,59116,3687,10765,263,1133,32898,81270
06,20802,0620802,East Los Angeles CDP, California,0,2014,117267,45.60,75.20,11.50,55598,61669,55657,761,1711,734,39,4891,112376
06,21712,0621712,El Cajon city, California,1,2014,103075,44.30,74.10,12.10,54094,48981,73709,7354,4523,355,1638,70566,32509
06,22020,0622020,Elk Grove city, California,1,2014,163560,41.70,72.20,10.80,78798,84762,79022,17451,45696,3345,625,137057,26503
06,22230,0622230,El Monte city, California,1,2014,116617,43.10,75.30,12.30,58628,57989,66916,785,34597,692,387,42316,74301
06,22804,0622804,Escondido city, California,1,2014,150252,45.40,73.40,11.40,74189,76063,119782,4380,10064,913,152,71793,78459
06,23182,0623182,Fairfield city, California,1,2014,111139,40.40,74.50,11.90,54342,56797,53687,14203,19094,651,1374,77296,33843
06,24638,0624638,Folsom city, California,1,2014,75366,36.80,77.90,14.10,40367,34999,50413,4966,12453,164,695,65841,9525
06,24680,0624680,Fontana city, California,1,2014,204953,46.70,71.70,8.00,101464,103489,81353,15249,15230,1805,1216,72006,132947
06,26000,0626000,Fremont city, California,1,2014,228760,42.20,75.80,11.00,114098,114662,58799,7888,126464,1354,2172,195628,33132
06,27000,0627000,Fresno city, California,1,2014,515985,43.80,71.20,10.80,254170,261815,267332,40245,67486,4356,385,265996,249989
06,28000,0628000,Fullerton city, California,1,2014,139663,45.10,75.00,11.50,69620,70043,75857,3469,33352,551,768,85747,53916
06,29000,0629000,Garden Grove city, California,1,2014,175085,41.10,77.20,12.80,87177,87908,73705,1160,69512,926,95,108900,66185
06,30000,0630000,Glendale city, California,1,2014,200161,40.60,83.20,16.50,92906,107255,139421,2101,32543,875,0,162116,38045
06,32548,0632548,Hawthorne city, California,1,2014,87591,46.30,74.20,9.60,42673,44918,29553,19618,5238,475,0,40278,47313
06,33000,0633000,Hayward city, California,1,2014,154633,45.70,78.90,11.20,77664,76969,70988,19394,39747,787,2255,92829,61804
06,33182,0633182,Hemet city, California,1,2014,83040,36.00,75.80,23.60,37486,45554,60734,10817,3102,1046,0,52056,30984
06,33434,0633434,Hesperia city, California,1,2014,92744,40.50,68.60,9.10,43377,49367,76059,7796,2035,1116,0,40220,52524
06,36000,0636000,Huntington Beach city, California,1,2014,200814,42.50,81.10,15.60,100899,99915,151238,2261,23707,1563,366,162884,37930
06,36448,0636448,Indio city, California,1,2014,85639,40.80,70.80,14.10,41734,43905,39606,1200,2489,810,33,24571,61068
06,36546,0636546,Inglewood city, California,1,2014,111901,43.60,74.60,10.30,51171,60730,29382,48988,1496,964,379,57178,54723
06,36770,0636770,Irvine city, California,1,2014,248521,48.00,76.00,10.20,121361,127160,120744,6816,94616,420,89,223556,24965
06,37692,0637692,Jurupa Valley city, California,0,2014,98843,43.20,68.90,8.70,51346,47497,52346,2865,3029,1803,165,31174,67669
06,39248,0639248,Laguna Niguel city, California,0,2014,65435,31.20,80.60,15.50,32673,32762,50110,1684,6978,446,154,56374,9061
06,39496,0639496,Lake Forest city, California,1,2014,80125,41.80,76.70,10.70,39142,40983,56964,1450,9860,1015,117,58990,21135
06,39892,0639892,Lakewood city, California,1,2014,81641,42.60,79.20,12.70,39582,42059,38864,5522,12818,600,958,48829,32812
06,40130,0640130,Lancaster city, California,1,2014,161036,42.90,70.40,10.40,78543,82493,96978,38908,6809,1068,748,107774,53262
06,41992,0641992,Livermore city, California,1,2014,86856,38.30,77.00,12.80,42458,44398,69338,1504,8448,171,193,67253,19603
06,43000,0643000,Long Beach city, California,1,2014,473605,45.60,75.60,10.00,234805,238800,257998,59993,68620,2428,4891,273427,200178
06,44000,0644000,Los Angeles city, California,1,2014,3928827,46.40,78.20,11.60,1952196,1976631,2101883,350773,456847,32059,8781,2017837,1910990
06,44574,0644574,Lynwood city, California,1,2014,71846,46.60,72.20,7.30,35037,36809,36863,7440,177,374,34,8661,63185
06,45484,0645484,Manteca city, California,1,2014,73477,41.20,73.90,12.60,35453,38024,47219,1519,8488,854,28,46526,26951
06,46842,0646842,Menifee city, California,1,2014,85201,38.50,76.40,19.20,38317,46884,57741,5329,4991,759,442,55708,29493
06,46898,0646898,Merced city, California,1,2014,81739,45.10,70.80,11.30,40614,41125,39143,5510,11036,248,91,44017,37722
06,47766,0647766,Milpitas city, California,1,2014,73679,43.60,77.40,10.20,35215,38464,14487,1570,45908,242,399,59343,14336
06,48256,0648256,Mission Viejo city, California,1,2014,97231,36.60,79.90,16.30,48567,48664,75620,666,8490,274,0,76836,20395
06,48354,0648354,Modesto city, California,1,2014,209308,40.30,75.80,13.70,101265,108043,157995,7099,15262,1813,1666,133980,75328
06,49270,0649270,Moreno Valley city, California,1,2014,202978,46.20,70.50,8.60,98854,104124,81239,34318,16389,1441,1113,87834,115144
06,49670,0649670,Mountain View city, California,1,2014,79374,45.70,79.30,10.50,42578,36796,46016,2314,24891,44,61,65475,13899
06,50076,0650076,Murrieta city, California,1,2014,108371,43.00,70.50,9.80,54572,53799,74588,10562,4706,916,485,79215,29156
06,50258,0650258,Napa city, California,1,2014,80009,40.00,77.30,13.90,40222,39787,60725,984,2337,462,0,47513,32496
06,51182,0651182,Newport Beach city, California,1,2014,87242,31.70,81.50,21.20,43085,44157,72550,105,8108,454,124,80042,7200
06,52526,0652526,Norwalk city, California,1,2014,107111,45.00,79.60,10.80,54627,52484,61646,3933,17246,597,298,32442,74669
06,53000,0653000,Oakland city, California,1,2014,413782,45.30,78.90,11.90,198623,215159,155910,100601,63484,5166,3456,300568,113214
06,53322,0653322,Oceanside city, California,1,2014,174552,42.10,78.20,15.90,85340,89212,136101,8423,10364,921,1619,122320,52232
06,53896,0653896,Ontario city, California,1,2014,169085,47.40,72.80,7.90,83145,85940,78675,9450,8449,1819,1368,48320,120765
06,53980,0653980,Orange city, California,1,2014,139826,46.60,75.90,10.50,70646,69180,96705,1983,17408,626,0,85125,54701
06,54652,0654652,Oxnard city, California,1,2014,205434,45.20,72.10,9.30,105699,99735,157195,3661,16563,3933,273,50618,154816
06,55156,0655156,Palmdale city, California,1,2014,158274,42.70,70.10,7.90,79488,78786,62018,19408,7596,635,176,64650,93624
06,55282,0655282,Palo Alto city, California,0,2014,66968,37.50,77.70,17.80,34371,32597,39273,860,23519,9,303,63438,3530
06,56000,0656000,Pasadena city, California,1,2014,140860,45.90,80.60,13.60,70848,70012,72395,13692,24929,237,168,93928,46932
06,56700,0656700,Perris city, California,1,2014,73751,48.30,69.80,6.20,37530,36221,19993,5743,2679,331,0,14824,58927
06,57456,0657456,Pittsburg city, California,0,2014,68122,43.30,75.30,11.00,31773,36349,23628,11429,10204,300,1136,42184,25938
06,57792,0657792,Pleasanton city, California,1,2014,77676,35.20,73.30,13.30,38910,38766,47454,1353,24241,98,432,72160,5516
06,58072,0658072,Pomona city, California,1,2014,153381,45.60,72.00,9.20,75322,78059,96332,9334,13332,838,128,44677,108704
06,59444,0659444,Rancho Cordova city, California,0,2014,69727,44.00,76.10,11.90,32737,36990,44655,5425,8088,204,482,54904,14823
06,59451,0659451,Rancho Cucamonga city, California,1,2014,174302,43.30,76.80,10.00,85895,88407,108124,14551,22543,2909,0,113264,61038
06,59920,0659920,Redding city, California,1,2014,91588,39.20,77.20,18.30,43789,47799,78324,1434,3178,783,0,83015,8573
06,59962,0659962,Redlands city, California,1,2014,70618,45.00,74.00,12.60,34051,36567,51452,5057,6106,551,1352,51197,19421
06,60018,0660018,Redondo Beach city, California,1,2014,68146,44.90,78.80,10.80,35112,33034,51220,1167,7840,0,56,52161,15985
06,60102,0660102,Redwood City city, California,1,2014,82868,42.40,76.60,12.60,41346,41522,48245,1729,9756,753,426,50381,32487
06,60466,0660466,Rialto city, California,1,2014,102740,47.60,70.60,8.40,51107,51633,60732,12805,1913,980,324,27177,75563
06,60620,0660620,Richmond city, California,1,2014,108562,41.90,76.80,11.40,52501,56061,32448,23452,17022,727,1427,65678,42884
06,62000,0662000,Riverside city, California,1,2014,319519,46.60,74.70,9.50,157133,162386,215584,17937,25919,3660,1327,155214,164305
06,62938,0662938,Roseville city, California,1,2014,128593,37.20,75.20,16.90,61615,66978,101770,1810,13808,211,443,110907,17686
06,64000,0664000,Sacramento city, California,1,2014,485193,44.90,75.60,11.60,238864,246329,234625,69249,90255,3151,8600,341692,143501
06,64224,0664224,Salinas city, California,1,2014,156678,45.40,69.90,8.00,77450,79228,123642,1854,11261,1061,0,40708,115970
06,65000,0665000,San Bernardino city, California,1,2014,215227,45.20,67.90,8.40,105530,109697,125109,30580,10270,1701,369,76788,138439
06,65042,0665042,San Buenaventura (Ventura) city, California,1,2014,109478,37.60,79.60,15.90,52067,57411,93981,1845,3117,1047,166,72677,36801
06,65084,0665084,San Clemente city, California,0,2014,65342,36.30,78.70,18.60,32055,33287,51265,341,3074,127,1967,55161,10181
06,66000,0666000,San Diego city, California,1,2014,1381083,47.30,79.60,11.40,690091,690992,889280,89431,228372,5347,4525,962648,418435
06,67000,0667000,San Francisco city, California,1,2014,852469,48.30,86.60,14.40,433882,418587,403610,45986,289650,2382,3665,722194,130275
06,68000,0668000,San Jose city, California,1,2014,1015796,43.30,76.90,11.70,507542,508254,438911,29970,349632,4929,4493,682845,332951
06,68084,0668084,San Leandro city, California,1,2014,89347,41.80,80.40,14.30,44035,45312,38286,12174,24185,1411,1477,63066,26281
06,68196,0668196,San Marcos city, California,1,2014,92910,43.90,74.50,12.00,47687,45223,56080,2425,9899,281,1257,59414,33496
06,68252,0668252,San Mateo city, California,1,2014,102885,39.50,79.40,15.90,50821,52064,67681,1731,21896,241,679,77674,25211
06,68378,0668378,San Ramon city, California,1,2014,75319,39.60,69.00,10.40,37609,37710,31885,2145,34938,39,798,70033,5286
06,69000,0669000,Santa Ana city, California,1,2014,334924,46.60,72.10,8.30,170381,164543,167781,2555,35172,2487,1394,71185,263739
06,69070,0669070,Santa Barbara city, California,1,2014,91208,43.00,81.20,17.00,46890,44318,71822,338,3085,776,278,56770,34438
06,69084,0669084,Santa Clara city, California,1,2014,122198,49.10,81.00,12.20,64128,58070,58345,3314,47647,415,922,102708,19490
06,69088,0669088,Santa Clarita city, California,1,2014,181559,39.10,72.10,11.40,87585,93974,129839,7063,19273,915,170,123934,57625
06,69196,0669196,Santa Maria city, California,1,2014,103414,45.90,67.80,9.00,52031,51383,82363,3022,3791,659,205,26405,77009
06,70000,0670000,Santa Monica city, California,1,2014,92989,44.40,86.80,17.40,44044,48945,75667,2882,7017,1068,0,76899,16090
06,70098,0670098,Santa Rosa city, California,1,2014,174166,40.30,76.40,14.50,83824,90342,123008,1797,10570,3621,904,119479,54687
06,72016,0672016,Simi Valley city, California,1,2014,126873,40.00,77.90,13.80,61967,64906,102150,1351,13572,911,170,93381,33492
06,73080,0673080,South Gate city, California,1,2014,96299,45.80,73.00,8.70,45042,51257,55677,1065,591,183,98,5567,90732
06,73262,0673262,South San Francisco city, California,0,2014,67011,44.40,85.70,14.40,32460,34551,26050,2171,27320,190,1482,44990,22021
06,75000,0675000,Stockton city, California,1,2014,302405,41.90,72.10,11.30,149291,153114,138630,41846,61559,1927,3571,179071,123334
06,77000,0677000,Sunnyvale city, California,1,2014,149984,46.60,74.20,11.10,73339,76645,75207,2448,62966,348,311,122504,27480
06,78120,0678120,Temecula city, California,1,2014,109446,40.90,73.00,11.40,53871,55575,84170,3451,12960,317,376,82404,27042
06,78582,0678582,Thousand Oaks city, California,1,2014,129344,36.00,77.80,17.10,62715,66629,106424,1873,10462,312,191,111398,17946
06,80000,0680000,Torrance city, California,1,2014,148483,36.50,78.30,16.90,74595,73888,79909,3283,48414,1295,589,124632,23851
06,80238,0680238,Tracy city, California,1,2014,85835,45.20,68.10,6.80,43847,41988,52258,3059,13582,229,167,50971,34864
06,80812,0680812,Turlock city, California,1,2014,71246,43.60,74.00,13.10,35136,36110,56043,1497,4363,63,583,45049,26197
06,80854,0680854,Tustin city, California,1,2014,80617,47.80,77.70,9.50,39303,41314,35234,2256,15809,737,606,43264,37353
06,81204,0681204,Union City city, California,1,2014,73608,41.40,79.80,16.10,36832,36776,13375,4218,40474,68,666,57658,15950
06,81344,0681344,Upland city, California,1,2014,76039,40.40,76.70,15.00,36703,39336,45968,5446,5438,313,0,45803,30236
06,81554,0681554,Vacaville city, California,1,2014,95863,41.10,76.80,11.20,50438,45425,62369,8782,8329,708,45,70716,25147
06,81666,0681666,Vallejo city, California,1,2014,120210,40.50,78.40,14.10,57333,62877,50444,26352,31015,627,244,91991,28219
06,82590,0682590,Victorville city, California,1,2014,121911,45.00,65.70,8.30,61941,59970,74162,21298,5250,1408,519,52403,69508
06,82954,0682954,Visalia city, California,1,2014,129280,40.50,68.90,12.60,65719,63561,103599,3777,5317,1075,0,65236,64044
06,82996,0682996,Vista city, California,1,2014,98086,49.30,75.20,8.10,48632,49454,72080,1643,4738,423,162,51387,46699
06,83346,0683346,Walnut Creek city, California,0,2014,67664,31.10,84.00,29.20,31240,36424,52265,1114,9875,135,64,60249,7415
06,84200,0684200,West Covina city, California,1,2014,108445,40.30,76.80,14.20,52771,55674,36506,5140,32130,730,0,50667,57778
06,84550,0684550,Westminster city, California,1,2014,92062,39.40,82.90,17.80,46867,45195,39397,226,44784,710,168,73627,18435
06,85292,0685292,Whittier city, California,1,2014,87348,44.40,75.30,12.60,42023,45325,50894,943,3572,157,186,27733,59615
06,86832,0686832,Yorba Linda city, California,0,2014,67824,34.90,74.70,15.00,34267,33557,50544,1181,9650,141,0,54278,13546
06,86972,0686972,Yuba City city, California,0,2014,65775,44.60,74.90,13.10,32501,33274,44523,2236,11367,759,624,47738,18037
08,03455,0803455,Arvada city, Colorado,1,2014,113775,38.20,78.60,14.20,55421,58354,105457,788,2668,994,0,95646,18129
08,04000,0804000,Aurora city, Colorado,1,2014,353381,43.70,73.80,10.40,172051,181330,222225,50629,18068,4671,693,249175,104206
08,07850,0807850,Boulder city, Colorado,1,2014,105101,59.10,86.70,10.20,56566,48535,93080,1099,4550,351,89,94782,10319
08,12815,0812815,Centennial city, Colorado,1,2014,107193,35.70,77.00,15.00,53106,54087,93347,2381,5839,262,400,98729,8464
08,16000,0816000,Colorado Springs city, Colorado,1,2014,445820,44.10,76.80,12.50,223286,222534,350458,20843,15377,1820,705,365374,80446
08,20000,0820000,Denver city, Colorado,1,2014,663862,48.80,79.10,10.90,332182,331680,520398,62757,24784,7326,174,459487,204375
08,27425,0827425,Fort Collins city, Colorado,1,2014,156473,55.70,80.80,9.20,79016,77457,139809,2721,4549,1085,451,136391,20082
08,32155,0832155,Greeley city, Colorado,1,2014,98593,45.40,73.50,12.80,47171,51422,85289,2287,509,855,48,59083,39510
08,36410,0836410,Highlands Ranch CDP, Colorado,0,2014,100192,37.80,70.90,9.80,49363,50829,89874,643,5807,185,30,92298,7894
08,43000,0843000,Lakewood city, Colorado,1,2014,149650,40.40,79.60,15.50,74749,74901,135026,2634,2544,1875,107,117939,31711
08,45970,0845970,Longmont city, Colorado,1,2014,90189,40.30,74.30,13.10,43188,47001,75498,1551,3841,1661,0,67533,22656
08,46465,0846465,Loveland city, Colorado,1,2014,72647,34.90,79.20,19.90,34270,38377,67489,166,787,756,967,67869,4778
08,62000,0862000,Pueblo city, Colorado,1,2014,108439,39.70,76.00,16.70,52417,56022,78493,3138,955,2077,0,51809,56630
08,77290,0877290,Thornton city, Colorado,1,2014,130309,44.50,69.80,8.50,65151,65158,114844,2723,5100,1085,136,87077,43232
08,83835,0883835,Westminster city, Colorado,1,2014,112099,42.60,78.80,13.00,56161,55938,94151,2886,7522,2202,45,86766,25333
09,08000,0908000,Bridgeport city, Connecticut,1,2014,147608,46.10,75.10,9.90,72305,75303,55760,52367,4045,774,0,88008,59600
09,18430,0918430,Danbury city, Connecticut,1,2014,83795,42.80,77.70,12.70,41499,42296,54030,6312,3955,210,0,60086,23709
09,37000,0937000,Hartford city, Connecticut,1,2014,124721,47.40,74.70,8.90,60232,64489,45701,46063,4392,518,16,71325,53396
09,50370,0950370,New Britain city, Connecticut,1,2014,72889,47.30,76.10,10.80,35545,37344,52870,6789,2415,166,281,39940,32949
09,52000,0952000,New Haven city, Connecticut,1,2014,130285,51.20,77.30,10.20,60372,69913,55948,45210,6409,418,76,94936,35349
09,55990,0955990,Norwalk city, Connecticut,1,2014,88144,43.50,79.90,14.70,42841,45303,61782,15160,5466,526,100,67093,21051
09,73000,0973000,Stamford city, Connecticut,1,2014,128283,43.10,79.60,12.90,64716,63567,75547,17081,12426,175,103,95389,32894
09,80000,0980000,Waterbury city, Connecticut,1,2014,109311,42.20,74.90,11.90,56617,52694,63630,21262,2306,15,0,69115,40196
10,77580,1077580,Wilmington city, Delaware,1,2014,71808,42.60,77.40,12.80,33064,38744,25207,38949,1203,54,142,63577,8231
11,50000,1150000,Washington city, District of Columbia,1,2014,658893,51.50,82.50,11.30,312633,346260,265077,321346,24910,1859,172,590537,68356
12,00410,1200410,Alafaya CDP, Florida,0,2014,84594,51.80,73.50,5.30,41289,43305,59191,8539,6993,0,0,57019,27575
12,07300,1207300,Boca Raton city, Florida,1,2014,91321,37.80,85.10,19.50,43639,47682,76186,4575,4151,100,0,80523,10798
12,07875,1207875,Boynton Beach city, Florida,1,2014,73121,38.40,81.80,20.40,35541,37580,46096,23558,1412,62,310,62170,10951
12,08150,1208150,Brandon CDP, Florida,0,2014,105125,41.20,79.70,13.40,50231,54894,74502,15262,5530,99,254,82360,22765
12,10275,1210275,Cape Coral city, Florida,1,2014,169855,31.10,79.90,22.50,82335,87520,151511,12082,2248,193,0,139817,30038
12,12875,1212875,Clearwater city, Florida,1,2014,110709,36.50,82.10,21.00,53840,56869,89704,13512,2984,238,0,95103,15606
12,14400,1214400,Coral Springs city, Florida,1,2014,127963,42.60,78.30,10.50,64355,63608,83957,24524,8207,1095,0,97605,30358
12,16475,1216475,Davie town, Florida,1,2014,98905,44.10,77.60,11.10,46461,52444,78648,8025,5261,499,416,62295,36610
12,16725,1216725,Deerfield Beach city, Florida,1,2014,78898,38.20,79.50,20.10,40224,38674,53889,18785,1495,566,0,63587,15311
12,17100,1217100,Delray Beach city, Florida,0,2014,65054,38.60,83.10,24.80,33880,31174,37237,22824,1552,67,0,58859,6195
12,17200,1217200,Deltona city, Florida,1,2014,86907,38.00,75.80,13.90,40913,45994,71540,10851,1478,1031,0,64486,22421
12,24000,1224000,Fort Lauderdale city, Florida,1,2014,176018,35.70,81.60,18.00,91239,84779,115219,52714,2524,151,228,148937,27081
12,24125,1224125,Fort Myers city, Florida,0,2014,70916,39.30,79.40,16.70,34397,36519,46198,19087,1337,59,72,56203,14713
12,25175,1225175,Gainesville city, Florida,1,2014,128474,63.00,87.70,10.20,61234,67240,84169,27889,8928,316,206,117424,11050
12,30000,1230000,Hialeah city, Florida,1,2014,235566,38.20,83.10,18.20,113813,121753,222473,7059,189,114,0,7566,228000
12,32000,1232000,Hollywood city, Florida,1,2014,148040,40.40,81.30,16.20,72357,75683,106466,25510,4450,93,0,98245,49795
12,32275,1232275,Homestead city, Florida,0,2014,65514,46.30,69.20,8.50,33544,31970,48289,12621,1390,0,0,25273,40241
12,35000,1235000,Jacksonville city, Florida,1,2014,853376,42.10,76.80,12.60,411582,441794,508647,267080,39525,2047,288,777590,75786
12,36100,1236100,Kendall CDP, Florida,0,2014,79143,36.40,81.00,20.20,39092,40051,69430,3044,4315,0,0,29603,49540
12,36950,1236950,Kissimmee city, Florida,0,2014,66729,47.50,75.40,10.00,34860,31869,44302,8607,1775,0,0,22159,44570
12,38250,1238250,Lakeland city, Florida,1,2014,102335,37.30,78.30,20.50,48884,53451,73705,22623,1482,481,0,85764,16571
12,39425,1239425,Largo city, Florida,1,2014,79028,32.30,84.70,26.00,36638,42390,68353,5141,1538,179,64,67665,11363
12,39550,1239550,Lauderhill city, Florida,1,2014,70636,41.00,79.30,16.70,31006,39630,16063,49551,1810,224,0,60892,9744
12,39925,1239925,Lehigh Acres CDP, Florida,0,2014,111416,43.00,70.20,11.50,56578,54838,77443,24924,2034,170,660,70947,40469
12,43975,1243975,Melbourne city, Florida,1,2014,78486,37.40,82.80,22.30,37604,40882,63745,9822,1327,635,0,68023,10463
12,45000,1245000,Miami city, Florida,1,2014,430341,43.20,82.30,15.90,209516,220825,315691,87384,3829,419,38,126522,303819
12,45025,1245025,Miami Beach city, Florida,1,2014,91721,40.20,83.10,16.60,47749,43972,73268,2839,1075,288,185,42554,49167
12,45060,1245060,Miami Gardens city, Florida,1,2014,112270,43.80,77.50,13.00,52212,60058,23368,83203,1289,602,366,82069,30201
12,45975,1245975,Miramar city, Florida,1,2014,134991,42.60,74.20,10.20,63236,71755,58241,59679,9912,0,0,83319,51672
12,53000,1253000,Orlando city, Florida,1,2014,262396,50.70,78.70,10.00,128229,134167,162828,72050,10579,566,186,192561,69835
12,54000,1254000,Palm Bay city, Florida,1,2014,105845,37.50,78.80,16.70,51135,54710,76043,22675,2287,303,0,89190,16655
12,54200,1254200,Palm Coast city, Florida,1,2014,82388,30.70,81.10,28.40,38697,43691,67091,10320,2499,77,65,72573,9815
12,55775,1255775,Pembroke Pines city, Florida,1,2014,164625,37.30,77.10,16.20,74253,90372,105626,41538,7620,240,0,91516,73109
12,56825,1256825,Pine Hills CDP, Florida,0,2014,76021,41.80,72.40,8.60,35610,40411,8939,58325,1861,37,0,66228,9793
12,57425,1257425,Plantation city, Florida,1,2014,91454,40.50,80.00,13.40,44484,46970,65570,17348,4375,3,392,68725,22729
12,58050,1258050,Pompano Beach city, Florida,1,2014,106115,37.50,81.90,21.00,55934,50181,66950,32714,1685,213,0,88244,17871
12,58715,1258715,Port St. Lucie city, Florida,1,2014,174093,34.80,78.80,20.50,87806,86287,129836,30765,3679,293,0,140595,33498
12,60950,1260950,Riverview CDP, Florida,0,2014,81226,42.60,72.10,8.80,39355,41871,51260,13295,3215,345,491,55680,25546
12,63000,1263000,St. Petersburg city, Florida,1,2014,253682,38.30,81.00,17.00,123768,129914,172432,58321,10078,753,345,237517,16165
12,68350,1268350,Spring Hill CDP, Florida,0,2014,98950,31.60,81.20,24.30,47439,51511,87883,5187,1860,143,0,84158,14792
12,69700,1269700,Sunrise city, Florida,1,2014,91256,41.00,78.60,14.60,42104,49152,50278,33701,2651,89,0,67154,24102
12,70600,1270600,Tallahassee city, Florida,1,2014,188106,59.10,82.80,9.00,90019,98087,108478,68156,7398,277,211,175260,12846
12,71000,1271000,Tampa city, Florida,1,2014,358684,44.60,78.00,12.30,174566,184118,231131,88164,14094,1168,340,273321,85363
12,71625,1271625,The Villages CDP, Florida,0,2014,-998,-999999999.00,-999999999.00,-999999999.00,-998,-998,-998,-998,-998,-998,-998,66122,2752
12,72145,1272145,Town 'n' Country CDP, Florida,0,2014,87874,44.70,79.40,12.70,43025,44849,72504,6299,4421,133,0,48856,39018
12,76582,1276582,Weston city, Florida,0,2014,69091,35.90,70.40,10.20,35600,33491,57471,5089,2574,969,0,35214,33877
12,76600,1276600,West Palm Beach city, Florida,1,2014,104017,41.70,80.20,17.20,49350,54667,58348,34889,4533,0,198,80375,23642
13,01052,1301052,Albany city, Georgia,1,2014,73016,43.30,74.90,13.00,32389,40627,-998,-998,-998,-998,-998,71532,1484
13,03440,1303440,Athens-Clarke County unified government (balance), Georgia,1,2014,119841,59.60,82.40,9.80,57618,62223,75599,33041,5565,52,0,106887,12954
13,04000,1304000,Atlanta city, Georgia,1,2014,456012,50.20,81.30,11.40,220350,235662,188315,234394,17133,638,81,434627,21385
13,04204,1304204,Augusta-Richmond County consolidated government (balance), Georgia,1,2014,197465,43.30,76.20,12.50,94648,102817,76062,111432,3681,405,0,188441,9024
13,19000,1319000,Columbus city, Georgia,1,2014,200887,44.30,75.80,11.90,98634,102253,91379,89440,4689,843,322,185869,15018
13,42425,1342425,Johns Creek city, Georgia,1,2014,83108,38.30,71.70,7.30,40602,42506,50622,8616,21177,81,0,77471,5637
13,49008,1349008,Macon-Bibb County, Georgia,0,2014,153633,40.00,74.80,14.00,72268,81365,66160,81483,3060,0,37,148752,4881
13,67284,1367284,Roswell city, Georgia,1,2014,94073,41.20,74.50,11.40,47572,46501,72875,12074,6322,356,132,80618,13455
13,68516,1368516,Sandy Springs city, Georgia,1,2014,101914,44.40,78.80,13.50,48621,53293,67771,22990,7409,208,112,91410,10504
13,69000,1369000,Savannah city, Georgia,1,2014,144355,46.80,79.60,13.40,66576,77779,56434,79829,2915,184,299,140181,4174
13,80508,1380508,Warner Robins city, Georgia,1,2014,73060,46.00,74.60,9.90,33578,39482,37604,27923,2303,1033,0,67943,5117
15,71550,1571550,Urban Honolulu CDP, Hawaii,0,2014,350403,41.00,82.90,18.80,175998,174405,59358,6229,188187,504,34203,330743,19660
16,08830,1608830,Boise City city, Idaho,1,2014,216280,43.10,76.50,12.50,109906,106374,189444,5660,8529,2096,0,195976,20304
16,52120,1652120,Meridian city, Idaho,1,2014,87739,40.50,72.20,11.50,42290,45449,-998,-998,-998,-998,-998,80450,7289
16,56260,1656260,Nampa city, Idaho,1,2014,88208,42.10,69.20,11.40,42289,45919,77022,502,1421,1441,223,68589,19619
17,02154,1702154,Arlington Heights village, Illinois,1,2014,74445,35.40,78.10,18.60,35308,39137,63594,1591,5684,215,0,70133,4312
17,03012,1703012,Aurora city, Illinois,1,2014,200708,45.90,70.50,7.70,99376,101332,108563,24226,13694,1114,0,116014,84694
17,06613,1706613,Bloomington city, Illinois,1,2014,78743,45.60,77.30,11.50,39132,39611,62291,7196,5734,31,0,72876,5867
17,07133,1707133,Bolingbrook village, Illinois,1,2014,73414,43.40,70.70,7.70,36036,37378,31390,17310,6442,0,0,52336,21078
17,12385,1712385,Champaign city, Illinois,1,2014,84520,56.80,82.10,9.10,42590,41930,58095,14631,9262,96,0,80263,4257
17,14000,1714000,Chicago city, Illinois,1,2014,2722407,47.20,78.00,11.40,1314074,1408333,1317969,852756,164633,7567,1012,1920162,802245
17,14351,1714351,Cicero town, Illinois,1,2014,84359,45.80,68.70,6.30,43220,41139,38660,4333,392,302,38,9722,74637
17,18823,1718823,Decatur city, Illinois,1,2014,73081,39.20,77.80,16.90,34329,38752,52791,14645,1012,360,0,70984,2097
17,23074,1723074,Elgin city, Illinois,1,2014,116548,43.30,75.20,12.20,59007,57541,77318,7982,7382,1315,0,67497,49051
17,24582,1724582,Evanston city, Illinois,1,2014,75657,46.10,79.90,13.30,35339,40318,53053,13875,4641,97,36,68144,7513
17,38570,1738570,Joliet city, Illinois,1,2014,146578,43.60,71.50,8.80,71078,75500,91846,27243,4390,848,0,108383,38195
17,51622,1751622,Naperville city, Illinois,1,2014,145396,38.60,74.50,10.00,71550,73846,105858,6869,26893,271,0,137500,7896
17,57225,1757225,Palatine village, Illinois,1,2014,69357,39.20,74.80,12.90,33434,35923,49525,1850,9186,0,0,56636,12721
17,59000,1759000,Peoria city, Illinois,1,2014,117288,42.20,75.40,13.50,56813,60475,72749,29175,6125,505,36,110560,6728
17,65000,1765000,Rockford city, Illinois,1,2014,148996,38.20,75.30,15.00,72805,76191,100083,31647,4837,752,0,124965,24031
17,68003,1768003,Schaumburg village, Illinois,1,2014,75287,43.40,79.30,14.60,35679,39608,51747,3063,14270,85,50,67915,7372
17,70122,1770122,Skokie village, Illinois,0,2014,65128,38.80,78.10,15.90,30154,34974,38619,5624,17626,0,0,59696,5432
17,72000,1772000,Springfield city, Illinois,1,2014,116649,38.80,77.20,16.20,54351,62298,84056,24449,2655,285,93,113031,3618
17,79293,1779293,Waukegan city, Illinois,1,2014,88998,45.80,72.50,9.50,43420,45578,61329,14983,6141,242,196,42694,46304
18,05860,1805860,Bloomington city, Indiana,1,2014,83423,68.40,87.00,7.00,40627,42796,67845,4127,7956,465,0,79857,3566
18,10342,1810342,Carmel city, Indiana,1,2014,87015,32.70,72.90,15.40,41250,45765,75200,892,9233,0,0,82943,4072
18,22000,1822000,Evansville city, Indiana,1,2014,121299,41.00,78.40,15.50,57080,64219,98832,15483,1063,125,193,117054,4245
18,23278,1823278,Fishers town, Indiana,1,2014,84967,44.50,68.10,6.50,40947,44020,71598,5601,4820,0,0,84099,868
18,25000,1825000,Fort Wayne city, Indiana,1,2014,256023,42.00,74.50,12.50,124040,131983,188136,37046,11591,374,23,234791,21232
18,27000,1827000,Gary city, Indiana,1,2014,71180,32.70,72.50,16.70,32072,39108,9198,58451,70,35,0,66748,4432
18,31000,1831000,Hammond city, Indiana,1,2014,78383,42.40,73.90,10.40,39572,38811,39842,15713,357,254,0,48615,29768
18,36003,1836003,Indianapolis city (balance), Indiana,1,2014,851353,43.20,75.20,11.10,412711,438642,538499,234712,22865,1642,1197,764742,86611
18,40788,1840788,Lafayette city, Indiana,1,2014,67012,46.70,76.10,13.40,30165,36847,55778,6416,1801,0,0,59388,7624
18,51876,1851876,Muncie city, Indiana,1,2014,70580,50.30,83.90,15.30,34314,36266,58502,8491,1521,0,16,68331,2249
18,71000,1871000,South Bend city, Indiana,1,2014,103019,40.20,72.10,12.60,48792,54227,66836,26037,1879,402,61,90824,12195
19,12000,1912000,Cedar Rapids city, Iowa,1,2014,129183,42.20,76.80,13.30,63155,66028,113288,7185,4856,180,0,125625,3558
19,19000,1919000,Davenport city, Iowa,1,2014,102431,43.10,76.20,12.40,49422,53009,82549,12011,2901,559,0,94057,8374
19,21000,1921000,Des Moines city, Iowa,1,2014,209064,43.10,73.60,11.30,100715,108349,162648,24954,12270,651,381,182479,26585
19,38595,1938595,Iowa City city, Iowa,1,2014,73424,61.30,84.60,8.40,37328,36096,61104,3657,5244,376,0,69446,3978
19,73335,1973335,Sioux City city, Iowa,1,2014,81392,41.20,74.60,13.80,39366,42026,68647,2873,2845,2288,0,66832,14560
19,82425,1982425,Waterloo city, Iowa,1,2014,68365,40.40,76.30,14.40,32821,35544,51181,10865,1802,168,0,64086,4279
20,36000,2036000,Kansas City city, Kansas,1,2014,148323,40.80,72.10,11.30,73034,75289,89758,36749,5739,1133,1048,105274,43049
20,38900,2038900,Lawrence city, Kansas,1,2014,91282,57.70,83.50,9.40,44817,46465,74304,4048,5467,2630,0,85422,5860
20,52575,2052575,Olathe city, Kansas,1,2014,133059,43.20,70.70,9.00,65913,67146,115210,5316,6467,240,0,119958,13101
20,53775,2053775,Overland Park city, Kansas,1,2014,184524,40.30,77.20,14.60,91117,93407,158289,8210,11133,290,205,172476,12048
20,71000,2071000,Topeka city, Kansas,1,2014,127223,40.80,75.30,14.60,61402,65821,101516,13814,1091,1156,0,110450,16773
20,79000,2079000,Wichita city, Kansas,1,2014,388413,41.10,73.50,12.80,192770,195643,291746,45961,18450,4132,0,326216,62197
21,46027,2146027,Lexington-Fayette urban county, Kentucky,1,2014,310797,46.40,79.00,11.60,152721,158076,235076,44857,11115,1816,364,289482,21315
21,48006,2148006,Louisville/Jefferson County metro government (balance), Kentucky,1,2014,612775,40.70,76.80,13.40,295925,316850,433942,141930,14568,1455,491,583626,29149
22,05000,2205000,Baton Rouge city, Louisiana,1,2014,228909,47.80,79.20,12.90,107970,120939,88292,128973,6305,545,63,219646,9263
22,08920,2208920,Bossier City city, Louisiana,0,2014,67453,45.00,71.90,13.10,35166,32287,44248,17473,1219,211,1357,61744,5709
22,39475,2239475,Kenner city, Louisiana,1,2014,67058,38.90,82.00,18.10,34296,32762,43967,14145,4168,353,0,49565,17493
22,40735,2240735,Lafayette city, Louisiana,1,2014,126068,43.60,78.80,11.50,60114,65954,85031,36362,2367,149,0,119226,6842
22,41155,2241155,Lake Charles city, Louisiana,1,2014,74875,40.20,76.80,17.00,34435,40440,34284,36649,1900,116,0,71461,3414
22,50115,2250115,Metairie CDP, Louisiana,0,2014,144239,39.20,79.90,16.00,68536,75703,119055,14604,6248,266,0,118711,25528
22,55000,2255000,New Orleans city, Louisiana,1,2014,384320,44.50,79.60,12.10,183107,201213,133630,227369,11598,442,393,363020,21300
22,70000,2270000,Shreveport city, Louisiana,1,2014,197979,40.80,76.10,15.20,92529,105450,75071,115368,2451,724,183,193205,4774
23,60545,2360545,Portland city, Maine,1,2014,66669,48.00,83.30,11.90,32717,33952,56753,6095,1191,0,0,64259,2410
24,04000,2404000,Baltimore city, Maryland,1,2014,622793,44.60,78.80,12.30,294080,328713,188819,390044,16984,1565,108,593345,29448
24,07125,2407125,Bethesda CDP, Maryland,0,2014,62097,31.60,75.40,19.30,29109,32988,49100,2064,8576,0,0,59180,2917
24,19125,2419125,Columbia CDP, Maryland,0,2014,97728,41.70,79.00,12.60,48459,49269,53899,26729,11230,42,0,87955,9773
24,26000,2426000,Ellicott City CDP, Maryland,0,2014,72295,35.40,73.50,14.20,35012,37283,44942,6319,18914,345,0,70317,1978
24,30325,2430325,Frederick city, Maryland,0,2014,68404,44.50,77.00,11.40,32259,36145,44726,14017,4553,268,171,60297,8107
24,31175,2431175,Gaithersburg city, Maryland,0,2014,66807,42.70,75.10,11.70,34190,32617,28701,10523,13015,290,0,47301,19506
24,32025,2432025,Germantown CDP, Maryland,0,2014,85021,41.20,73.00,6.50,41829,43192,44751,15018,16485,1077,0,65944,19077
24,32650,2432650,Glen Burnie CDP, Maryland,0,2014,69906,45.60,77.30,12.90,30951,38955,43934,16527,4915,259,0,63365,6541
24,67675,2467675,Rockville city, Maryland,0,2014,65941,42.00,79.40,16.10,30331,35610,39811,6334,12574,29,0,54258,11683
24,72450,2472450,Silver Spring CDP, Maryland,0,2014,77726,46.70,75.70,9.60,35956,41770,36489,22689,5231,388,47,57765,19961
24,81175,2481175,Waldorf CDP, Maryland,0,2014,72048,45.00,72.50,8.30,34331,37717,24656,38932,2489,113,100,67165,4883
25,07000,2507000,Boston city, Massachusetts,1,2014,656051,54.50,83.50,10.30,316075,339976,347662,160952,64034,2337,59,533709,122342
25,09000,2509000,Brockton city, Massachusetts,1,2014,94780,37.70,74.10,12.50,45695,49085,46817,37951,1144,78,176,83590,11190
25,11000,2511000,Cambridge city, Massachusetts,1,2014,109699,61.00,86.50,9.80,51371,58328,75441,11756,15569,119,41,100656,9043
25,23000,2523000,Fall River city, Massachusetts,1,2014,88705,40.70,80.70,16.20,41896,46809,70903,4835,2460,390,0,79981,8724
25,24960,2524960,Framingham CDP, Massachusetts,0,2014,70744,41.80,77.50,13.90,33797,36947,51521,4042,6464,0,39,60340,10404
25,34550,2534550,Lawrence city, Massachusetts,1,2014,78192,47.10,72.10,8.50,38785,39407,28376,2488,3282,409,0,18101,60091
25,37000,2537000,Lowell city, Massachusetts,1,2014,109931,47.90,79.10,10.50,56340,53591,66372,7234,20392,400,90,85412,24519
25,37490,2537490,Lynn city, Massachusetts,1,2014,92137,43.40,75.60,11.20,45364,46773,42525,10920,8613,692,0,57068,35069
25,45000,2545000,New Bedford city, Massachusetts,1,2014,94855,40.00,77.10,12.90,44533,50322,64226,7997,1553,675,0,76125,18730
25,45560,2545560,Newton city, Massachusetts,1,2014,88298,37.20,78.00,18.70,42068,46230,67118,4292,12648,49,0,83104,5194
25,55745,2555745,Quincy city, Massachusetts,1,2014,93391,43.20,83.20,15.30,46636,46755,61080,6627,23087,71,52,90792,2599
25,62535,2562535,Somerville city, Massachusetts,1,2014,78903,62.10,88.20,9.90,40234,38669,59704,6773,7053,128,47,73439,5464
25,67000,2567000,Springfield city, Massachusetts,1,2014,153994,44.00,73.20,10.90,70676,83318,89178,31162,3018,979,207,88511,65483
25,82000,2582000,Worcester city, Massachusetts,1,2014,183033,46.00,77.70,10.70,90790,92243,127637,23382,12608,701,64,142159,40874
26,03000,2603000,Ann Arbor city, Michigan,1,2014,117759,58.80,84.80,10.40,57940,59819,84224,8320,20215,321,69,112570,5189
26,21000,2621000,Dearborn city, Michigan,1,2014,95546,40.50,71.00,13.20,46803,48743,84605,4626,1766,293,77,91794,3752
26,22000,2622000,Detroit city, Michigan,1,2014,680281,41.10,75.20,12.50,320196,360085,98650,539810,8478,3157,0,631268,49013
26,27440,2627440,Farmington Hills city, Michigan,1,2014,81440,35.20,82.70,21.70,38755,42685,54472,14175,10427,150,0,78268,3172
26,29000,2629000,Flint city, Michigan,1,2014,98990,42.50,74.30,11.70,47223,51767,41403,51099,89,949,103,95085,3905
26,34000,2634000,Grand Rapids city, Michigan,1,2014,193793,48.20,76.20,11.50,96404,97389,129315,41785,3309,1235,182,165512,28281
26,42160,2642160,Kalamazoo city, Michigan,1,2014,75909,57.20,80.50,9.80,37859,38050,50761,17349,1487,369,256,72092,3817
26,46000,2646000,Lansing city, Michigan,1,2014,113659,45.20,75.80,11.60,55114,58545,71402,26253,3446,358,0,101071,12588
26,49000,2649000,Livonia city, Michigan,1,2014,94959,35.10,81.10,18.20,46392,48567,87142,3663,3032,115,0,93487,1472
26,69035,2669035,Rochester Hills city, Michigan,1,2014,73120,36.10,75.30,16.50,36394,36726,56741,4257,9189,120,0,71310,1810
26,74900,2674900,Southfield city, Michigan,1,2014,73001,36.80,82.70,18.60,31235,41766,17612,51281,1398,157,0,72470,531
26,76460,2676460,Sterling Heights city, Michigan,1,2014,131729,39.80,80.70,16.60,64721,67008,110735,8829,7911,0,0,127934,3795
26,80700,2680700,Troy city, Michigan,1,2014,83120,36.50,78.50,15.80,41290,41830,56799,4574,19053,128,151,81758,1362
26,84000,2684000,Warren city, Michigan,1,2014,135099,37.80,76.50,14.50,65255,69844,98314,24664,8262,390,0,132835,2264
26,86000,2686000,Westland city, Michigan,1,2014,82318,40.00,81.80,17.50,39191,43127,56769,19550,3093,741,84,80239,2079
26,88940,2688940,Wyoming city, Michigan,1,2014,74820,42.10,74.50,10.30,36066,38754,57562,3987,1854,1381,0,57551,17269
27,06616,2706616,Bloomington city, Minnesota,1,2014,86319,37.50,83.60,19.60,43282,43037,67923,6534,6444,134,78,79898,6421
27,07966,2707966,Brooklyn Park city, Minnesota,1,2014,78741,43.80,70.20,9.80,35686,43055,43609,20194,10561,0,0,71154,7587
27,17000,2717000,Duluth city, Minnesota,1,2014,86242,47.20,82.70,15.10,43333,42909,77008,2539,1601,1633,0,84095,2147
27,17288,2717288,Eagan city, Minnesota,0,2014,66087,40.50,77.20,11.70,32739,33348,51982,4306,6979,198,0,63459,2628
27,40166,2740166,Maple Grove city, Minnesota,0,2014,66949,37.10,75.20,11.30,32292,34657,-998,-998,-998,-998,-998,66271,678
27,43000,2743000,Minneapolis city, Minnesota,1,2014,407181,52.40,79.70,8.30,205891,201290,265873,79484,22768,5483,138,367727,39454
27,51730,2751730,Plymouth city, Minnesota,1,2014,75065,38.20,74.70,15.40,34760,40305,57747,4959,7600,495,0,72357,2708
27,54880,2754880,Rochester city, Minnesota,1,2014,111398,40.00,76.70,14.50,54456,56942,91434,8325,9073,203,0,105179,6219
27,56896,2756896,St. Cloud city, Minnesota,0,2014,64221,50.90,83.70,11.90,34536,29685,53791,6438,1500,617,0,62546,1675
27,58000,2758000,St. Paul city, Minnesota,1,2014,297644,46.20,74.10,8.90,145625,152019,168906,47793,53863,3274,0,267855,29789
27,71428,2771428,Woodbury city, Minnesota,0,2014,66799,39.80,74.60,11.20,31178,35621,56628,2362,5082,0,97,62714,4085
28,29700,2829700,Gulfport city, Mississippi,1,2014,71747,39.90,76.80,14.00,33872,37875,43523,25345,465,52,10,69367,2380
28,36000,2836000,Jackson city, Mississippi,1,2014,171146,44.40,74.50,11.60,79557,91589,35402,132824,1398,142,0,169213,1933
29,15670,2915670,Columbia city, Missouri,1,2014,116892,56.70,81.40,9.30,55220,61672,91000,13105,6179,57,4,113272,3620
29,35000,2935000,Independence city, Missouri,1,2014,117503,36.80,79.00,17.50,56671,60832,97936,6539,1949,923,482,106218,11285
29,38000,2938000,Kansas City city, Missouri,1,2014,470816,43.20,76.50,12.00,229038,241778,275205,139981,11402,1886,486,423703,47113
29,41348,2941348,Lee's Summit city, Missouri,1,2014,94627,34.00,72.80,14.00,45476,49151,79132,6740,2229,327,233,90431,4196
29,54074,2954074,O'Fallon city, Missouri,1,2014,83999,41.10,72.10,10.20,40841,43158,75050,4185,3168,123,0,82545,1454
29,64082,2964082,St. Charles city, Missouri,0,2014,68087,42.80,82.20,14.90,33584,34503,59340,5406,1404,98,32,65714,2373
29,64550,2964550,St. Joseph city, Missouri,1,2014,76529,41.60,76.60,13.80,37501,39028,66825,5806,682,206,42,71312,5217
29,65000,2965000,St. Louis city, Missouri,1,2014,317419,45.80,79.80,11.40,153044,164375,145959,148875,9411,663,194,305372,12047
29,70000,2970000,Springfield city, Missouri,1,2014,165399,47.40,81.70,15.50,79999,85400,149326,8030,2582,424,59,159111,6288
30,06550,3006550,Billings city, Montana,1,2014,108870,40.90,75.50,14.70,53550,55320,99538,848,208,5368,88,102056,6814
30,50200,3050200,Missoula city, Montana,1,2014,69824,49.40,82.80,12.10,33700,36124,64035,311,921,2850,45,68250,1574
31,28000,3128000,Lincoln city, Nebraska,1,2014,273002,46.60,77.10,11.80,134320,138682,235709,12411,12825,703,47,253590,19412
31,37000,3137000,Omaha city, Nebraska,1,2014,446618,42.80,75.00,12.00,221341,225277,348582,55457,14377,4185,548,384413,62205
32,23770,3223770,Enterprise CDP, Nevada,0,2014,126438,48.90,71.90,6.80,59466,66972,69143,10622,30508,983,574,104626,21812
32,31900,3231900,Henderson city, Nevada,1,2014,277458,37.90,79.50,17.90,136868,140590,207343,14746,21263,756,405,233522,43936
32,40000,3240000,Las Vegas city, Nevada,1,2014,613590,41.90,75.30,13.00,310765,302825,385047,76956,38539,4058,3992,410974,202616
32,51800,3251800,North Las Vegas city, Nevada,1,2014,230793,43.10,73.40,10.70,112013,118780,138073,42971,15439,418,1036,134209,96584
32,54600,3254600,Paradise CDP, Nevada,0,2014,237477,43.80,79.60,12.70,124181,113296,149829,21373,23228,2642,3325,162201,75276
32,60600,3260600,Reno city, Nevada,1,2014,236995,43.40,78.50,13.40,119011,117984,186747,6355,15877,2424,1553,181399,55596
32,68400,3268400,Sparks city, Nevada,1,2014,94704,39.50,75.70,14.80,46409,48295,76841,2638,4405,1458,281,69451,25253
32,68585,3268585,Spring Valley CDP, Nevada,0,2014,192113,41.80,80.30,14.20,97981,94132,103961,18290,37925,171,1261,146292,45821
32,71400,3271400,Sunrise Manor CDP, Nevada,0,2014,189229,43.50,70.20,10.00,91297,97932,101425,27442,11540,766,1439,95183,94046
33,45140,3345140,Manchester city, New Hampshire,1,2014,110451,42.30,79.00,12.70,55657,54794,94388,5330,6190,326,0,99831,10620
33,50260,3350260,Nashua city, New Hampshire,1,2014,87258,40.00,81.80,13.10,43167,44091,73785,3585,4162,197,117,77287,9971
34,03580,3403580,Bayonne city, New Jersey,0,2014,65984,41.90,76.40,12.00,32866,33118,48904,8906,5858,0,0,51191,14793
34,10000,3410000,Camden city, New Jersey,1,2014,77317,44.40,70.60,9.90,37453,39864,10052,37563,2457,280,0,40690,36627
34,13690,3413690,Clifton city, New Jersey,1,2014,85920,45.70,76.40,11.00,40947,44973,57322,5161,10486,465,0,54236,31684
34,19390,3419390,East Orange city, New Jersey,0,2014,65095,39.80,77.70,13.20,28944,36151,2457,57026,243,35,0,58250,6845
34,21000,3421000,Elizabeth city, New Jersey,1,2014,128695,46.10,73.80,9.00,66201,62494,63722,24932,3532,0,0,47653,81042
34,36000,3436000,Jersey City city, New Jersey,1,2014,262146,50.80,79.10,9.50,128065,134081,93409,68555,66351,477,245,189219,72927
34,51000,3451000,Newark city, New Jersey,1,2014,280577,47.20,74.20,8.40,138841,141736,61266,139409,7005,1831,107,179615,100962
34,56550,3456550,Passaic city, New Jersey,1,2014,71517,44.00,66.70,8.40,36960,34557,25325,6514,2177,2031,51,18594,52923
34,57000,3457000,Paterson city, New Jersey,1,2014,146746,42.90,73.30,11.10,70339,76407,37885,45539,1805,89,0,59584,87162
34,73110,3473110,Toms River CDP, New Jersey,0,2014,89490,36.50,78.10,17.50,44271,45219,78475,2720,4720,0,0,81647,7843
34,74000,3474000,Trenton city, New Jersey,1,2014,84047,46.00,74.80,10.40,42846,41201,32116,43825,393,119,0,54893,29154
34,74630,3474630,Union City city, New Jersey,1,2014,68673,44.50,77.90,11.10,33664,35009,53014,2553,3317,42,0,11708,56965
35,02000,3502000,Albuquerque city, New Mexico,1,2014,557172,42.20,76.80,13.40,270432,286740,398390,16453,14980,24818,182,288442,268730
35,39380,3539380,Las Cruces city, New Mexico,1,2014,101405,45.80,77.90,14.30,51368,50037,88627,2391,2258,2085,0,44903,56502
35,63460,3563460,Rio Rancho city, New Mexico,1,2014,93011,39.20,75.20,12.70,45853,47158,71527,2748,1854,1577,0,55072,37939
35,70500,3570500,Santa Fe city, New Mexico,1,2014,70291,36.00,82.20,20.40,33164,37127,58763,540,1120,2022,31,35552,34739
36,01000,3601000,Albany city, New York,1,2014,98566,51.50,85.10,12.50,45030,53536,53323,28610,7111,119,38,88460,10106
36,08026,3608026,Brentwood CDP, New York,0,2014,68580,46.30,70.10,7.50,35479,33101,40751,9816,1902,347,0,26019,42561
36,11000,3611000,Buffalo city, New York,1,2014,258699,45.20,76.90,12.80,122130,136569,122457,96258,14543,1387,85,230991,27708
36,15000,3615000,Cheektowaga CDP, New York,0,2014,73556,38.40,84.40,18.90,36105,37451,60113,7009,3126,232,242,70988,2568
36,49121,3649121,Mount Vernon city, New York,1,2014,68455,40.30,76.30,14.00,30024,38431,17362,42867,1192,411,0,55499,12956
36,50617,3650617,New Rochelle city, New York,1,2014,79630,39.80,79.30,13.90,40639,38991,49484,17528,3535,175,0,61724,17906
36,51000,3651000,New York city, New York,1,2014,8491079,44.60,78.80,12.90,4046394,4444685,3619690,2079129,1172114,33983,2946,6030181,2460898
36,63000,3663000,Rochester city, New York,1,2014,209974,46.60,76.30,10.80,101498,108476,94282,88062,7767,3122,0,173201,36773
36,65508,3665508,Schenectady city, New York,1,2014,65930,42.50,78.70,13.30,32852,33078,39525,13749,4662,33,0,58178,7752
36,73000,3673000,Syracuse city, New York,1,2014,144263,48.90,76.70,12.60,66701,77562,78337,42473,11315,893,0,131752,12511
36,84000,3684000,Yonkers city, New York,1,2014,200665,39.50,78.60,16.60,96562,104103,119897,32408,17238,986,0,134363,66302
37,02140,3702140,Asheville city, North Carolina,1,2014,87884,43.50,84.60,17.90,39294,48590,68074,13150,2877,682,0,83913,3971
37,10740,3710740,Cary town, North Carolina,1,2014,155724,39.90,75.30,11.80,76197,79527,110537,12152,26563,284,13,144928,10796
37,12000,3712000,Charlotte city, North Carolina,1,2014,809974,46.80,75.80,9.40,387737,422237,408296,282495,49863,1781,58,699534,110440
37,14100,3714100,Concord city, North Carolina,1,2014,85571,42.00,70.80,11.30,40623,44948,57214,18644,3481,509,0,75794,9777
37,19000,3719000,Durham city, North Carolina,1,2014,251872,47.10,77.80,10.70,118719,133153,118247,102246,12004,244,226,216760,35112
37,22920,3722920,Fayetteville city, North Carolina,1,2014,203939,47.50,76.30,11.70,98972,104967,96004,84540,6911,1476,468,180475,23464
37,25580,3725580,Gastonia city, North Carolina,1,2014,73696,35.80,76.10,15.90,35175,38521,46382,20271,1377,77,0,67064,6632
37,28000,3728000,Greensboro city, North Carolina,1,2014,282558,45.10,77.40,12.50,130369,152189,133640,118953,13264,1713,206,262355,20203
37,28080,3728080,Greenville city, North Carolina,1,2014,89850,57.60,82.40,10.30,42804,47046,47533,33889,2504,518,25,85968,3882
37,31400,3731400,High Point city, North Carolina,1,2014,107957,41.10,74.80,12.40,51790,56167,58616,36115,5925,246,0,96940,11017
37,34200,3734200,Jacksonville city, North Carolina,1,2014,69031,61.20,74.90,6.00,40694,28337,41263,18486,597,567,18,58881,10150
37,55000,3755000,Raleigh city, North Carolina,1,2014,439884,50.00,77.80,9.40,214254,225630,269502,119672,15736,2095,464,387268,52616
37,74440,3774440,Wilmington city, North Carolina,1,2014,113676,49.30,83.00,13.70,54078,59598,89124,20236,1339,89,0,106737,6939
37,75000,3775000,Winston-Salem city, North Carolina,1,2014,239273,42.70,76.10,13.40,112641,126632,132782,82167,4363,434,0,204660,34613
38,07200,3807200,Bismarck city, North Dakota,0,2014,67666,41.60,78.20,15.90,32762,34904,-998,-998,-998,-998,-998,66087,1579
38,25700,3825700,Fargo city, North Dakota,1,2014,116572,51.20,79.00,10.20,56318,60254,100939,5999,4518,1506,0,113392,3180
39,01000,3901000,Akron city, Ohio,1,2014,197846,41.60,78.80,13.30,95194,102652,122140,59236,7399,215,0,194568,3278
39,12000,3912000,Canton city, Ohio,1,2014,72274,41.60,74.80,13.10,33200,39074,-998,-998,-998,-998,-998,70504,1770
39,15000,3915000,Cincinnati city, Ohio,1,2014,298162,46.60,79.10,11.70,142163,155999,148742,129638,4737,448,86,289264,8898
39,16000,3916000,Cleveland city, Ohio,1,2014,389524,41.50,75.80,12.20,185881,203643,146208,208004,7221,1432,24,347779,41745
39,18000,3918000,Columbus city, Ohio,1,2014,836293,49.20,77.50,9.20,402972,433321,513069,231302,42795,1097,125,787445,48848
39,21000,3921000,Dayton city, Ohio,1,2014,140995,44.10,76.80,11.50,68133,72862,73337,60206,460,1105,0,136871,4124
39,44856,3944856,Lorain city, Ohio,0,2014,63774,37.90,75.60,15.40,29691,34083,48709,9150,547,504,0,44917,18857
39,61000,3961000,Parma city, Ohio,1,2014,80023,38.40,79.00,17.80,40463,39560,72681,2172,1436,679,0,76525,3498
39,77000,3977000,Toledo city, Ohio,1,2014,281014,42.30,76.70,13.50,136050,144964,180887,71542,3897,631,25,259534,21480
39,88000,3988000,Youngstown city, Ohio,1,2014,65051,38.00,76.90,16.70,31553,33498,31947,28618,482,156,0,58639,6412
40,09050,4009050,Broken Arrow city, Oklahoma,1,2014,106226,40.20,73.10,11.00,53042,53184,83827,4298,2998,4121,0,100524,5702
40,23200,4023200,Edmond city, Oklahoma,1,2014,88594,39.30,74.80,12.30,42907,45687,71199,4183,1595,2012,511,83670,4924
40,41850,4041850,Lawton city, Oklahoma,1,2014,97017,48.90,75.70,10.40,50719,46298,57575,20256,1639,5403,581,84240,12777
40,52500,4052500,Norman city, Oklahoma,1,2014,118046,52.80,82.90,11.70,59089,58957,95207,6469,4620,4037,30,107306,10740
40,55000,4055000,Oklahoma City city, Oklahoma,1,2014,620553,42.50,74.60,12.10,304143,316410,421536,90870,29854,18077,370,507192,113361
40,75000,4075000,Tulsa city, Oklahoma,1,2014,399274,41.10,75.60,13.40,192046,207228,255794,59949,11214,16250,813,336318,62956
41,05350,4105350,Beaverton city, Oregon,1,2014,95113,45.10,79.20,10.70,48459,46654,70563,1294,9998,584,1225,77246,17867
41,05800,4105800,Bend city, Oregon,1,2014,84075,41.90,79.10,14.50,41130,42945,77754,635,1995,285,0,78298,5777
41,23850,4123850,Eugene city, Oregon,1,2014,160552,48.30,81.00,13.70,77753,82799,135434,2451,6454,1337,301,144808,15744
41,31250,4131250,Gresham city, Oregon,1,2014,109877,42.40,75.40,13.60,55146,54731,84753,4797,6091,1690,330,91218,18659
41,34100,4134100,Hillsboro city, Oregon,1,2014,99374,46.20,74.70,10.50,48874,50500,75109,1043,9449,1582,548,77218,22156
41,47000,4147000,Medford city, Oregon,1,2014,78560,36.70,77.70,18.10,38187,40373,71608,539,1465,62,0,68123,10437
41,59000,4159000,Portland city, Oregon,1,2014,619445,47.50,81.50,11.50,304728,314717,476461,34381,42807,4680,4477,556251,63194
41,64900,4164900,Salem city, Oregon,1,2014,161648,42.30,76.40,13.90,82584,79064,125796,2330,4870,2779,1612,126699,34949
42,02000,4202000,Allentown city, Pennsylvania,1,2014,119105,44.50,73.30,12.10,57379,61726,63742,17406,2666,559,0,60987,58118
42,06088,4206088,Bethlehem city, Pennsylvania,1,2014,78759,46.10,82.00,14.90,38453,40306,61212,5988,1822,385,0,57475,21284
42,24000,4224000,Erie city, Pennsylvania,1,2014,99466,41.90,77.20,13.90,48855,50611,72897,16471,3147,406,149,92896,6570
42,60000,4260000,Philadelphia city, Pennsylvania,1,2014,1560297,45.10,77.80,12.50,737581,822716,664708,660704,109068,7367,897,1347594,212703
42,61000,4261000,Pittsburgh city, Pennsylvania,1,2014,305434,49.80,84.40,13.50,149146,156288,203801,72766,16972,562,0,296260,9174
42,63624,4263624,Reading city, Pennsylvania,1,2014,87809,45.00,70.20,10.60,43002,44807,41365,10675,311,2530,0,34362,53447
42,69000,4269000,Scranton city, Pennsylvania,1,2014,75278,41.50,79.30,18.30,36422,38856,64820,5937,2885,108,15,66674,8604
44,19180,4419180,Cranston city, Rhode Island,1,2014,81029,36.60,82.20,18.00,38431,42598,66488,4751,5752,201,0,73668,7361
44,54640,4454640,Pawtucket city, Rhode Island,1,2014,71490,44.00,73.90,10.70,34758,36732,46086,12605,1140,216,0,54793,16697
44,59000,4459000,Providence city, Rhode Island,1,2014,179142,53.70,78.40,9.20,85645,93497,89028,30684,12505,2595,385,103910,75232
44,74300,4474300,Warwick city, Rhode Island,1,2014,81964,34.70,82.80,19.30,40731,41233,75191,1190,2705,315,0,78466,3498
45,13330,4513330,Charleston city, South Carolina,1,2014,130750,50.70,82.40,13.00,63648,67102,97218,28229,2470,80,0,127235,3515
45,16000,4516000,Columbia city, South Carolina,1,2014,131758,58.00,83.30,9.20,66710,65048,72731,51665,2787,102,31,123265,8493
45,48535,4548535,Mount Pleasant town, South Carolina,1,2014,77787,36.40,76.20,14.40,36393,41394,-998,-998,-998,-998,-998,76385,1402
45,50875,4550875,North Charleston city, South Carolina,1,2014,107972,46.30,74.60,10.20,54036,53936,46163,52714,3246,190,0,96878,11094
45,61405,4561405,Rock Hill city, South Carolina,1,2014,69967,49.60,76.90,13.60,33081,36886,37827,27268,968,214,99,67930,2037
46,52980,4652980,Rapid City city, South Dakota,1,2014,72642,38.80,75.20,15.20,36009,36633,57259,1562,1082,7532,0,68446,4196
46,59020,4659020,Sioux Falls city, South Dakota,1,2014,168604,43.10,75.90,12.30,83296,85308,145443,8452,3482,5162,0,160991,7613
47,14000,4714000,Chattanooga city, Tennessee,1,2014,173778,42.10,80.60,15.00,82625,91153,105655,58595,3549,143,218,163088,10690
47,15160,4715160,Clarksville city, Tennessee,1,2014,146814,49.20,72.70,8.10,72887,73927,97395,35177,2979,656,0,130439,16375
47,27740,4727740,Franklin city, Tennessee,0,2014,70613,39.30,73.00,10.60,33413,37200,-998,-998,-998,-998,-998,65755,4858
47,37640,4737640,Jackson city, Tennessee,0,2014,67308,43.90,77.10,12.30,32099,35209,33075,31558,986,284,0,64120,3188
47,38320,4738320,Johnson City city, Tennessee,0,2014,65820,45.10,80.20,16.80,30602,35218,57325,4711,1273,167,0,61979,3841
47,40000,4740000,Knoxville city, Tennessee,1,2014,184292,48.90,79.90,13.60,88110,96182,133142,35999,3390,1679,0,172575,11717
47,48000,4748000,Memphis city, Tennessee,1,2014,656876,43.80,75.00,11.20,312021,344855,189255,420976,10640,1117,413,614969,41907
47,51560,4751560,Murfreesboro city, Tennessee,1,2014,120960,51.10,77.70,9.40,58576,62384,89251,21142,4798,59,0,112225,8735
47,52006,4752006,Nashville-Davidson metropolitan government (balance), Tennessee,1,2014,644008,46.90,78.50,10.90,309656,334352,399586,180752,21460,1541,380,578382,65626
48,01000,4801000,Abilene city, Texas,1,2014,120176,46.60,77.20,13.00,61653,58523,88346,11754,2187,1330,107,87912,32264
48,01924,4801924,Allen city, Texas,1,2014,94170,42.00,70.10,6.00,48287,45883,68325,5520,16120,789,0,83571,10599
48,03000,4803000,Amarillo city, Texas,1,2014,200246,42.00,72.90,12.70,97198,103048,167983,11618,7037,784,594,139789,60457
48,04000,4804000,Arlington city, Texas,1,2014,383202,43.70,73.10,9.70,189540,193662,253826,77883,25028,1194,406,268671,114531
48,04462,4804462,Atascocita CDP, Texas,0,2014,73017,42.40,72.10,8.80,34918,38099,52319,10997,1261,0,713,54773,18244
48,05000,4805000,Austin city, Texas,1,2014,912798,52.10,78.50,8.00,463088,449710,701658,72160,64974,2931,315,598438,314360
48,06128,4806128,Baytown city, Texas,1,2014,75670,40.60,71.30,13.70,39187,36483,53295,13249,1248,350,0,42416,33254
48,07000,4807000,Beaumont city, Texas,1,2014,117576,42.20,75.30,12.80,57560,60016,52210,58413,2940,0,0,102098,15478
48,10768,4810768,Brownsville city, Texas,1,2014,183016,42.70,69.30,11.20,89237,93779,175855,911,1119,177,0,10219,172797
48,10912,4810912,Bryan city, Texas,1,2014,80916,47.00,75.30,9.70,39436,41480,50743,14813,929,0,0,48322,32594
48,13024,4813024,Carrollton city, Texas,1,2014,128342,43.00,75.30,9.10,63091,65251,89953,10914,19247,570,313,85165,43177
48,15976,4815976,College Station city, Texas,1,2014,103486,68.30,83.40,5.90,53916,49570,80553,6340,10763,327,0,88421,15065
48,16432,4816432,Conroe city, Texas,0,2014,65873,44.40,73.70,11.10,35443,30430,57234,4880,1416,0,0,38648,27225
48,17000,4817000,Corpus Christi city, Texas,1,2014,320431,41.70,74.70,12.70,156694,163737,282633,14552,6784,1257,131,123939,196492
48,19000,4819000,Dallas city, Texas,1,2014,1281031,46.30,73.80,9.40,637627,643404,792715,310838,42209,4510,753,750233,530798
48,19972,4819972,Denton city, Texas,1,2014,128200,55.80,80.30,9.40,63524,64676,101919,13052,3749,827,0,99527,28673
48,22660,4822660,Edinburg city, Texas,1,2014,83017,47.60,65.90,7.70,37823,45194,-998,-998,-998,-998,-998,8452,74565
48,24000,4824000,El Paso city, Texas,1,2014,679024,42.90,72.90,12.20,333618,345406,568476,28863,8416,3965,319,139684,539340
48,26232,4826232,Flower Mound town, Texas,0,2014,69419,37.00,73.00,9.50,33428,35991,54706,2843,8542,367,0,63739,5680
48,27000,4827000,Fort Worth city, Texas,1,2014,812553,45.10,71.90,9.00,391912,420641,525181,162304,29732,3868,556,534664,277889
48,27684,4827684,Frisco city, Texas,1,2014,145038,42.70,67.10,7.00,72350,72688,102667,10727,22198,732,195,128957,16081
48,29000,4829000,Garland city, Texas,1,2014,235597,40.80,73.20,11.80,113647,121950,145171,28683,24547,711,64,135798,99799
48,30464,4830464,Grand Prairie city, Texas,1,2014,185415,46.90,71.60,7.40,93195,92220,113461,41940,10522,1255,128,106636,78779
48,32372,4832372,Harlingen city, Texas,0,2014,65914,40.30,67.50,13.80,33012,32902,60665,751,675,353,0,12551,53363
48,35000,4835000,Houston city, Texas,1,2014,2240796,46.50,75.00,9.80,1122825,1117971,1291693,524877,154325,10572,1499,1252572,988224
48,37000,4837000,Irving city, Texas,1,2014,232413,47.40,71.30,7.60,113101,119312,138178,29699,39597,829,137,131541,100872
48,39148,4839148,Killeen city, Texas,1,2014,138143,50.70,71.50,5.10,68140,70003,54492,48333,5225,2156,2243,104908,33235
48,41464,4841464,Laredo city, Texas,1,2014,253747,43.60,66.10,8.40,122936,130811,239531,1187,1558,498,0,12142,241605
48,41980,4841980,League City city, Texas,1,2014,94287,43.90,72.70,9.10,47547,46740,74579,5156,6127,143,0,72943,21344
48,42508,4842508,Lewisville city, Texas,1,2014,102283,45.50,75.40,9.20,49999,52284,72624,13752,6900,404,0,70141,32142
48,43888,4843888,Longview city, Texas,1,2014,84313,39.50,73.00,14.50,40687,43626,59794,20993,804,349,0,69668,14645
48,45000,4845000,Lubbock city, Texas,1,2014,243843,48.60,77.00,11.70,118620,125223,189866,19199,5685,1310,28,162707,81136
48,45384,4845384,McAllen city, Texas,1,2014,138584,44.00,70.30,10.10,67120,71464,127923,743,2280,113,199,18701,119883
48,45744,4845744,McKinney city, Texas,1,2014,156753,45.60,70.00,8.80,74082,82671,123936,16145,8200,410,139,130678,26075
48,47892,4847892,Mesquite city, Texas,1,2014,144289,42.10,73.40,9.60,72107,72182,93276,36215,5295,569,0,89283,55006
48,48072,4848072,Midland city, Texas,1,2014,128037,44.20,73.30,10.00,65000,63037,104524,9603,2072,632,0,71812,56225
48,48768,4848768,Mission city, Texas,1,2014,82429,41.70,65.40,11.30,39620,42809,-998,-998,-998,-998,-998,10007,72422
48,48804,4848804,Missouri City city, Texas,1,2014,75128,39.50,75.90,9.60,36542,38586,19740,32932,14534,0,171,63612,11516
48,50820,4850820,New Braunfels city, Texas,0,2014,65714,42.20,73.80,12.60,31941,33773,57397,1910,837,0,135,42335,23379
48,52356,4852356,North Richland Hills city, Texas,0,2014,68527,38.90,73.40,14.00,33502,35025,57446,2790,3766,108,465,56499,12028
48,53388,4853388,Odessa city, Texas,1,2014,116394,44.40,72.00,10.50,58403,57991,91188,6099,2141,785,0,53503,62891
48,56000,4856000,Pasadena city, Texas,1,2014,153914,41.20,71.70,9.50,76935,76979,125529,3005,1310,2204,295,56224,97690
48,56348,4856348,Pearland city, Texas,1,2014,104759,43.90,71.60,9.20,50311,54448,69187,15229,13984,102,0,81787,22972
48,57200,4857200,Pharr city, Texas,1,2014,75381,42.30,63.90,10.90,34522,40859,-998,-998,-998,-998,-998,5124,70257
48,58016,4858016,Plano city, Texas,1,2014,277910,39.90,76.10,12.00,138024,139886,184996,26473,48925,856,114,235559,42351
48,61796,4861796,Richardson city, Texas,1,2014,108609,39.90,78.30,13.90,54032,54577,77567,8570,16287,405,217,91305,17304
48,63500,4863500,Round Rock city, Texas,1,2014,112196,45.10,70.80,7.90,54830,57366,88946,9745,6786,333,39,78088,34108
48,64472,4864472,San Angelo city, Texas,1,2014,97207,45.20,76.10,14.80,49765,47442,79436,4085,1174,264,0,57695,39512
48,65000,4865000,San Antonio city, Texas,1,2014,1436723,44.40,74.30,11.60,707621,729102,1147399,101274,39025,9436,583,520183,916540
48,70808,4870808,Sugar Land city, Texas,1,2014,86775,36.90,76.30,13.60,44002,42773,44300,3648,36098,199,0,80257,6518
48,72176,4872176,Temple city, Texas,0,2014,70785,39.90,71.60,16.40,34995,35790,52306,12362,2219,432,75,54459,16326
48,72656,4872656,The Woodlands CDP, Texas,0,2014,102764,34.90,70.40,12.30,49862,52902,88786,5375,6243,127,235,92202,10562
48,74144,4874144,Tyler city, Texas,1,2014,101436,41.80,74.80,15.10,47766,53670,64210,29261,2512,94,941,82528,18908
48,75428,4875428,Victoria city, Texas,0,2014,66098,41.20,74.00,14.60,32111,33987,58130,4148,1277,192,0,32160,33938
48,76000,4876000,Waco city, Texas,1,2014,130191,48.90,75.50,11.60,64716,65475,90270,27528,1560,1089,0,89476,40715
48,79000,4879000,Wichita Falls city, Texas,1,2014,105107,44.50,76.30,11.90,55751,49356,77633,13350,2630,1388,0,82186,22921
49,43660,4943660,Layton city, Utah,1,2014,72223,45.20,68.80,8.90,38033,34190,63326,1255,1754,78,0,63665,8558
49,50150,4950150,Millcreek CDP, Utah,0,2014,65203,38.90,75.30,17.40,32294,32909,57519,1476,1881,1498,100,59156,6047
49,55980,4955980,Ogden city, Utah,1,2014,84325,46.70,71.70,10.70,43374,40951,69963,800,1348,680,79,55900,28425
49,57300,4957300,Orem city, Utah,1,2014,91781,50.80,69.40,7.90,46695,45086,80733,1317,2404,877,432,76211,15570
49,62470,4962470,Provo city, Utah,1,2014,114807,62.90,77.80,6.40,57890,56917,102375,820,2083,358,1461,98063,16744
49,65330,4965330,St. George city, Utah,1,2014,78509,37.50,74.70,21.60,36947,41562,71467,746,451,1545,1348,69393,9116
49,67000,4967000,Salt Lake City city, Utah,1,2014,190873,52.30,79.10,9.50,102744,88129,137726,3363,10684,3077,4296,151187,39686
49,67440,4967440,Sandy city, Utah,1,2014,91135,39.00,69.50,9.90,43110,48025,83886,731,1139,254,1436,81131,10004
49,82950,4982950,West Jordan city, Utah,1,2014,110917,45.70,65.80,5.70,52423,58494,93447,1753,2768,590,1526,87525,23392
49,83470,4983470,West Valley City city, Utah,1,2014,134492,47.10,67.10,6.80,67157,67335,78508,1361,8061,1112,5805,81177,53315
51,01000,5101000,Alexandria city, Virginia,1,2014,150575,49.70,82.10,10.20,71921,78654,96093,31128,10573,61,138,125518,25057
51,03000,5103000,Arlington CDP, Virginia,0,2014,226908,53.70,82.80,8.90,113432,113476,165090,18950,23472,156,374,191260,35648
51,14440,5114440,Centreville CDP, Virginia,0,2014,77618,44.70,73.90,6.50,38886,38732,42500,5878,23727,207,0,66490,11128
51,16000,5116000,Chesapeake city, Virginia,1,2014,233371,41.20,75.60,11.80,113592,119779,145126,69163,8037,219,859,220927,12444
51,21088,5121088,Dale City CDP, Virginia,0,2014,73809,44.80,72.80,8.60,37083,36726,36438,19252,7034,366,716,53172,20637
51,35000,5135000,Hampton city, Virginia,1,2014,136879,42.20,78.30,13.60,65790,71089,58451,68295,3595,954,0,129564,7315
51,47672,5147672,Lynchburg city, Virginia,1,2014,79047,48.90,80.30,14.40,37304,41743,51500,22915,2290,17,52,76400,2647
51,56000,5156000,Newport News city, Virginia,1,2014,182965,45.00,76.60,11.60,88434,94531,92495,73305,5250,385,362,167450,15515
51,57000,5157000,Norfolk city, Virginia,1,2014,245428,51.30,79.70,9.80,127888,117540,114315,104703,8984,1134,0,227139,18289
51,64000,5164000,Portsmouth city, Virginia,1,2014,96004,41.80,76.50,13.60,46106,49898,39566,49982,1214,681,288,92208,3796
51,67000,5167000,Richmond city, Virginia,1,2014,217853,48.80,81.70,11.40,104055,113798,97755,105349,5125,812,0,203507,14346
51,68000,5168000,Roanoke city, Virginia,1,2014,99428,40.40,78.50,15.30,47953,51475,62351,28553,2462,27,0,93548,5880
51,76432,5176432,Suffolk city, Virginia,1,2014,86806,38.70,75.00,13.00,41797,45009,44473,35933,1347,22,0,83574,3232
51,82000,5182000,Virginia Beach city, Virginia,1,2014,450980,43.60,77.20,12.30,221987,228993,303113,87511,29617,914,123,416110,34870
53,03180,5303180,Auburn city, Washington,1,2014,78769,42.30,73.00,11.10,38383,40386,53751,3799,8370,1529,1544,63718,15051
53,05210,5305210,Bellevue city, Washington,1,2014,136426,42.40,79.80,15.00,67644,68782,81323,2968,45508,474,60,124820,11606
53,05280,5305280,Bellingham city, Washington,1,2014,83363,52.90,85.40,13.60,41236,42127,67939,908,5781,1425,0,76695,6668
53,22640,5322640,Everett city, Washington,1,2014,106741,42.90,75.20,9.00,55110,51631,84546,4368,7882,1810,674,90170,16571
53,23515,5323515,Federal Way city, Washington,1,2014,93428,42.30,77.30,13.30,46718,46710,54704,10211,13248,341,3897,77526,15902
53,35275,5335275,Kennewick city, Washington,1,2014,77424,42.70,74.20,12.50,38883,38541,60281,2796,569,592,124,58072,19352
53,35415,5335415,Kent city, Washington,1,2014,125547,47.20,74.10,9.50,62696,62851,66037,15507,26072,2682,1450,110551,14996
53,35940,5335940,Kirkland city, Washington,0,2014,85778,42.40,81.00,13.10,42029,43749,65009,873,12607,157,62,79690,6088
53,43955,5343955,Marysville city, Washington,0,2014,65088,39.60,74.20,14.70,31187,33901,52105,801,6039,542,584,58973,6115
53,53545,5353545,Pasco city, Washington,0,2014,69807,44.20,65.20,6.10,36039,33768,50393,1497,2063,417,0,30862,38945
53,57745,5357745,Renton city, Washington,1,2014,98382,47.70,77.60,9.10,49656,48726,43702,9168,24165,358,1701,81669,16713
53,63000,5363000,Seattle city, Washington,1,2014,668337,50.80,85.10,12.20,338781,329556,464857,46638,93532,5155,4408,627058,41279
53,67000,5367000,Spokane city, Washington,1,2014,212067,42.30,77.90,14.10,103185,108882,183191,4682,5701,3902,1364,198510,13557
53,67167,5367167,Spokane Valley city, Washington,1,2014,91733,39.70,75.60,14.70,45929,45804,83989,801,1312,1603,409,87609,4124
53,70000,5370000,Tacoma city, Washington,1,2014,205153,43.40,78.40,12.50,103800,101353,130905,20946,17208,2986,4496,180437,24716
53,74060,5374060,Vancouver city, Washington,1,2014,169303,43.20,77.50,13.90,83855,85448,130751,4031,8427,985,3370,148952,20351
53,80010,5380010,Yakima city, Washington,1,2014,93355,40.10,73.60,13.90,46936,46419,72031,843,1136,2547,0,52399,40956
55,02375,5502375,Appleton city, Wisconsin,1,2014,72654,42.30,75.90,10.80,35914,36740,61004,1942,5106,191,0,68250,4404
55,22300,5522300,Eau Claire city, Wisconsin,0,2014,68207,50.70,80.50,12.50,33304,34903,61844,922,3852,494,211,66421,1786
55,31000,5531000,Green Bay city, Wisconsin,1,2014,104893,41.50,75.30,12.20,52705,52188,82850,3720,3222,3974,0,89393,15500
55,39225,5539225,Kenosha city, Wisconsin,1,2014,99898,41.80,75.40,12.50,48149,51749,81775,12493,1148,277,0,84198,15700
55,48000,5548000,Madison city, Wisconsin,1,2014,245674,52.80,82.40,11.00,119983,125691,190300,16596,21925,775,0,230234,15440
55,53000,5553000,Milwaukee city, Wisconsin,1,2014,599653,45.70,74.20,10.10,290147,309506,284178,233522,21848,3558,203,491495,108158
55,60500,5560500,Oshkosh city, Wisconsin,0,2014,66631,48.30,81.60,14.00,34756,31875,61095,2425,1488,272,98,65327,1304
55,66000,5566000,Racine city, Wisconsin,1,2014,78054,41.40,72.50,11.80,37436,40618,50751,18039,405,513,0,60209,17845
55,84250,5584250,Waukesha city, Wisconsin,1,2014,71482,44.80,76.00,10.60,34389,37093,61567,3260,2891,255,0,62771,8711
72,10334,7210334,Caguas zona urbana, Puerto Rico,0,2014,77624,39.10,80.00,20.20,34276,43348,59671,7997,436,0,0,665,76959
72,14290,7214290,Carolina zona urbana, Puerto Rico,0,2014,148712,39.40,79.40,19.50,68443,80269,82770,37911,406,3478,79,1652,147060
72,32522,7232522,Guaynabo zona urbana, Puerto Rico,0,2014,71460,37.70,81.80,19.60,33710,37750,56787,3615,200,191,0,1010,70450
72,63820,7263820,Ponce zona urbana, Puerto Rico,0,2014,124015,38.80,78.40,18.80,58175,65840,101016,6664,66,420,0,603,123412
72,76770,7276770,San Juan zona urbana, Puerto Rico,0,2014,351290,38.80,80.20,19.60,161413,189877,264669,39322,1896,960,69,6225,345065
72,52431,7252431,Mayagüez zona urbana, Puerto Rico,0,2014,64488,41.30,80.70,21.60,30699,33789,25184,2662,0,273,0,531,63957
72,06593,7206593,Bayamón zona urbana, Puerto Rico,0,2014,175826,39.40,80.30,19.90,83664,92162,102110,9493,98,614,49,1411,174415
72,06593,7206593,Bayamón zona urbana, Puerto Rico,0,2015,170259,40.10,80.40,19.60,80128,90131,102122,12028,118,302,0,1104,169155
72,52431,7252431,Mayagüez zona urbana, Puerto Rico,0,2015,66581,41.30,80.30,21.00,30799,35782,17887,2916,155,0,0,1060,65521
01,07000,0107000,Birmingham city, Alabama,1,2015,214911,42.70,79.20,13.80,102122,112789,49826,156354,1394,438,0,205971,8940
01,21184,0121184,Dothan city, Alabama,0,2015,67536,38.60,76.20,16.90,32172,35364,42298,22489,770,238,140,65832,1704
01,35896,0135896,Hoover city, Alabama,1,2015,84839,37.80,74.20,15.50,38040,46799,60365,17378,4505,0,0,81409,3430
01,37000,0137000,Huntsville city, Alabama,1,2015,189114,40.70,79.70,15.80,91764,97350,117924,59235,4785,259,47,178227,10887
01,50000,0150000,Mobile city, Alabama,1,2015,194305,41.10,78.90,15.40,91275,103030,89161,93089,4854,372,0,189076,5229
01,51000,0151000,Montgomery city, Alabama,1,2015,200586,42.50,76.50,13.50,94582,106004,70322,119588,4575,232,16,193938,6648
01,77256,0177256,Tuscaloosa city, Alabama,1,2015,98338,54.10,83.20,10.80,47293,51045,52144,42061,2577,128,275,95863,2475
02,03000,0203000,Anchorage municipality, Alaska,1,2015,298695,45.70,75.20,9.20,152945,145750,188025,18385,29106,19466,5556,271434,27261
04,04720,0404720,Avondale city, Arizona,1,2015,80683,45.40,67.80,7.80,38712,41971,60327,10505,2243,313,73,45967,34716
04,10670,0410670,Casas Adobes CDP, Arizona,0,2015,65265,35.60,81.90,22.80,30890,34375,55162,847,2082,752,603,51656,13609
04,12000,0412000,Chandler city, Arizona,1,2015,260833,42.60,74.00,9.90,128885,131948,199992,12847,28715,3978,0,203674,57159
04,23620,0423620,Flagstaff city, Arizona,0,2015,70317,59.40,81.10,7.50,33224,37093,55560,1749,1830,4520,183,56711,13606
04,27400,0427400,Gilbert town, Arizona,1,2015,247523,42.80,69.30,7.30,116711,130812,204014,7024,16558,4009,276,207586,39937
04,27820,0427820,Glendale city, Arizona,1,2015,240114,42.30,74.20,11.20,116795,123319,193269,12775,12331,1738,468,156403,83711
04,28380,0428380,Goodyear city, Arizona,0,2015,79003,40.90,75.60,15.00,36711,42292,61361,7878,4700,303,103,57400,21603
04,46000,0446000,Mesa city, Arizona,1,2015,471833,40.40,76.40,16.00,234998,236835,397988,17601,10340,10504,2110,340408,131425
04,54050,0454050,Peoria city, Arizona,1,2015,171242,36.20,73.50,15.30,80139,91103,146359,6167,4752,1808,522,130113,41129
04,55000,0455000,Phoenix city, Arizona,1,2015,1563001,44.20,73.70,10.40,786833,776168,1119488,110408,51845,31203,2672,893087,669914
04,64210,0464210,San Tan Valley CDP, Arizona,0,2015,82797,40.30,66.10,10.20,40429,42368,71208,1631,954,2296,0,64064,18733
04,65000,0465000,Scottsdale city, Arizona,1,2015,236844,34.70,84.60,24.10,115712,121132,200629,3831,9212,5212,599,212078,24766
04,71510,0471510,Surprise city, Arizona,1,2015,128442,35.20,72.60,21.10,62875,65567,110910,7720,1605,267,280,103076,25366
04,73000,0473000,Tempe city, Arizona,1,2015,175826,57.60,83.80,9.50,91350,84476,124518,9759,14658,3355,821,131422,44404
04,77000,0477000,Tucson city, Arizona,1,2015,531674,45.50,78.40,13.70,264893,266781,386958,27290,16623,17754,641,300649,231025
04,85540,0485540,Yuma city, Arizona,1,2015,94145,42.70,75.70,15.20,48298,45847,67688,2868,727,498,0,37091,57054
05,23290,0523290,Fayetteville city, Arkansas,1,2015,82832,57.00,81.00,10.30,41959,40873,64520,6403,3305,318,0,77297,5535
05,24550,0524550,Fort Smith city, Arkansas,1,2015,88195,40.10,75.80,14.40,43346,44849,62947,9447,5210,1301,0,71091,17104
05,35710,0535710,Jonesboro city, Arkansas,1,2015,73906,48.20,75.70,12.20,35666,38240,54103,12712,1282,1473,0,69292,4614
05,41000,0541000,Little Rock city, Arkansas,1,2015,197986,41.80,77.10,13.10,96997,100989,100467,84068,7412,37,59,182486,15500
05,50450,0550450,North Little Rock city, Arkansas,0,2015,66506,42.60,71.10,12.90,31671,34835,-998,-998,-998,-998,-998,61646,4860
05,66080,0566080,Springdale city, Arkansas,1,2015,80454,42.80,69.60,9.20,36840,43614,55848,1537,1239,259,5227,50254,30200
06,00562,0600562,Alameda city, California,1,2015,78614,38.80,80.90,14.80,37747,40867,39158,6085,24025,342,758,70349,8265
06,00884,0600884,Alhambra city, California,1,2015,85572,42.50,83.80,15.30,42184,43388,19318,1508,43279,42,243,54186,31386
06,02000,0602000,Anaheim city, California,1,2015,350738,46.50,75.20,10.30,179603,171135,252059,8238,48515,818,1362,149145,201593
06,02252,0602252,Antioch city, California,1,2015,110542,41.10,73.30,9.90,54733,55809,45776,21411,11135,1404,2698,74979,35563
06,02364,0602364,Apple Valley town, California,1,2015,72185,37.00,71.10,17.10,32873,39312,57222,6703,1322,782,45,46257,25928
06,02553,0602553,Arden-Arcade CDP, California,0,2015,96276,39.00,81.20,17.80,47596,48680,65115,11373,5938,599,0,81003,15273
06,03526,0603526,Bakersfield city, California,1,2015,373627,45.00,70.90,9.40,182154,191473,263245,31245,29215,3791,783,193386,180241
06,03666,0603666,Baldwin Park city, California,1,2015,77056,40.20,75.10,13.00,38747,38309,35892,1504,14954,237,0,20774,56282
06,04982,0604982,Bellflower city, California,1,2015,78434,44.30,71.30,11.50,38936,39498,21887,12191,10080,486,151,35962,42472
06,06000,0606000,Berkeley city, California,1,2015,120971,54.30,87.00,14.10,60142,60829,76218,9122,22282,666,100,105542,15429
06,08786,0608786,Buena Park city, California,1,2015,83264,41.10,74.10,12.60,41593,41671,46459,790,23363,158,1856,50349,32915
06,08954,0608954,Burbank city, California,1,2015,105314,41.30,77.60,13.80,50405,54909,75789,2842,12866,525,0,83225,22089
06,10046,0610046,Camarillo city, California,0,2015,67623,35.50,77.60,21.80,31941,35682,56522,919,5247,28,0,51437,16186
06,11194,0611194,Carlsbad city, California,1,2015,113466,36.40,77.50,17.00,55119,58347,96043,513,10219,540,223,100497,12969
06,11390,0611390,Carmichael CDP, California,0,2015,63215,36.90,78.80,18.60,29281,33934,50066,3123,1617,210,268,53924,9291
06,11530,0611530,Carson city, California,1,2015,93296,40.00,80.60,17.10,43790,49506,26187,18859,29489,1579,2389,60358,32938
06,13014,0613014,Chico city, California,1,2015,90336,52.40,81.30,13.20,46168,44168,75512,1191,4554,879,134,74758,15578
06,13210,0613210,Chino city, California,1,2015,85599,46.70,80.90,9.30,50989,34610,38503,4386,10959,504,146,40104,45495
06,13214,0613214,Chino Hills city, California,1,2015,78313,39.10,78.70,10.80,39639,38674,37675,3221,26951,719,124,55774,22539
06,13392,0613392,Chula Vista city, California,1,2015,265754,44.00,74.10,11.40,131485,134269,173466,13412,42433,823,1354,109232,156522
06,13588,0613588,Citrus Heights city, California,1,2015,87053,40.10,78.90,16.80,41982,45071,74148,4782,2215,109,196,72392,14661
06,14218,0614218,Clovis city, California,1,2015,104172,39.50,75.90,14.70,52392,51780,74136,2721,12745,731,0,80428,23744
06,15044,0615044,Compton city, California,1,2015,98448,44.50,71.50,9.00,49264,49184,52935,25938,1624,269,981,30925,67523
06,16000,0616000,Concord city, California,1,2015,128668,41.20,79.00,13.00,62310,66358,86429,5168,13828,145,936,87268,41400
06,16350,0616350,Corona city, California,1,2015,164242,43.10,75.90,10.20,79749,84493,112825,8235,18099,571,221,95650,68592
06,16532,0616532,Costa Mesa city, California,1,2015,113186,49.90,80.20,10.10,59097,54089,84639,2688,7676,1006,1256,74947,38239
06,17918,0617918,Daly City city, California,1,2015,106574,43.90,84.10,14.50,53817,52757,22619,4570,59688,553,2255,82258,24316
06,18100,0618100,Davis city, California,0,2015,67656,55.20,82.90,12.60,33493,34163,43506,1374,14682,97,98,58615,9041
06,19766,0619766,Downey city, California,1,2015,114211,44.70,78.90,10.60,53006,61205,76069,4832,8782,243,101,29405,84806
06,20802,0620802,East Los Angeles CDP, California,0,2015,119666,45.80,73.70,11.00,60460,59206,48057,363,945,451,0,3455,116211
06,21712,0621712,El Cajon city, California,1,2015,103688,43.30,74.40,10.10,54450,49238,78399,5406,2707,168,912,72146,31542
06,22020,0622020,Elk Grove city, California,1,2015,166890,40.90,73.60,9.90,80057,86833,75674,16672,50282,379,3014,138109,28781
06,22230,0622230,El Monte city, California,1,2015,116745,41.80,77.90,14.00,57961,58784,63280,274,32881,426,130,39222,77523
06,22804,0622804,Escondido city, California,1,2015,151458,44.40,76.30,12.30,76551,74907,116093,4333,12671,1333,393,77665,73793
06,23182,0623182,Fairfield city, California,1,2015,112972,41.00,73.90,11.20,55550,57422,57900,15796,18386,578,1590,79996,32976
06,24477,0624477,Florence-Graham CDP, California,0,2015,66359,47.50,70.30,6.50,34186,32173,-998,-998,-998,-998,-998,5464,60895
06,24638,0624638,Folsom city, California,1,2015,76368,39.20,76.80,11.00,41051,35317,53741,2973,13405,311,627,70546,5822
06,24680,0624680,Fontana city, California,1,2015,207472,47.20,69.00,5.60,100644,106828,79854,14490,12449,1206,224,51338,156134
06,26000,0626000,Fremont city, California,1,2015,232191,43.40,77.70,11.40,114383,117808,58670,6071,132865,527,3959,202597,29594
06,27000,0627000,Fresno city, California,1,2015,520072,44.10,70.70,10.10,256130,263942,311604,40021,69359,5904,1257,263927,256145
06,28000,0628000,Fullerton city, California,1,2015,140849,45.20,78.80,12.60,69549,71300,85666,3174,30849,197,394,87390,53459
06,29000,0629000,Garden Grove city, California,1,2015,175384,42.00,78.20,13.70,86779,88605,64048,1084,70118,1148,558,109346,66038
06,30000,0630000,Glendale city, California,1,2015,201025,39.80,83.70,16.60,98181,102844,142232,3539,38323,167,371,170218,30807
06,32548,0632548,Hawthorne city, California,1,2015,88444,46.00,74.80,8.90,43682,44762,22545,20617,7361,339,132,38329,50115
06,33000,0633000,Hayward city, California,1,2015,158300,45.70,77.50,11.10,78152,80148,67679,16822,41446,941,3388,93420,64880
06,33182,0633182,Hemet city, California,1,2015,83873,35.50,71.70,20.20,38622,45251,65152,6421,3196,1181,649,46425,37448
06,33434,0633434,Hesperia city, California,1,2015,93286,41.20,68.90,9.90,43588,49698,76974,4703,1164,1490,65,39521,53765
06,36000,0636000,Huntington Beach city, California,1,2015,201927,37.40,80.20,16.60,99967,101960,145828,2862,22739,1358,643,159624,42303
06,36448,0636448,Indio city, California,1,2015,87526,42.00,72.70,15.50,43803,43723,47273,2887,2120,979,0,28674,58852
06,36546,0636546,Inglewood city, California,1,2015,111656,43.50,75.60,12.20,52995,58661,31421,42220,1677,416,71,50783,60873
06,36770,0636770,Irvine city, California,1,2015,256927,48.00,79.50,10.00,125411,131516,116385,7605,116420,207,362,237661,19266
06,37692,0637692,Jurupa Valley city, California,0,2015,100314,42.40,74.60,10.90,49430,50884,56160,2853,4087,987,69,33789,66525
06,39248,0639248,Laguna Niguel city, California,0,2015,65812,32.00,80.00,17.00,30193,35619,52322,397,6683,800,424,56609,9203
06,39496,0639496,Lake Forest city, California,1,2015,82497,38.90,77.90,13.20,41515,40982,55977,1717,13868,219,0,65087,17410
06,39892,0639892,Lakewood city, California,1,2015,81592,40.40,77.40,13.20,41523,40069,40989,5351,17524,142,2176,56605,24987
06,40130,0640130,Lancaster city, California,1,2015,161113,44.30,71.40,9.10,80668,80445,104759,32622,7274,536,0,103690,57423
06,41992,0641992,Livermore city, California,1,2015,88117,38.20,74.60,11.10,41522,46595,67710,1452,10932,273,109,68535,19582
06,43000,0643000,Long Beach city, California,1,2015,474172,44.70,76.60,11.20,238159,236013,262242,58597,58754,8376,5017,266282,207890
06,44000,0644000,Los Angeles city, California,1,2015,3971896,46.50,78.50,11.50,1958998,2012898,2068389,364740,457354,34816,6663,2035164,1936732
06,44574,0644574,Lynwood city, California,1,2015,72005,48.10,71.40,7.80,35634,36371,47749,4915,865,375,0,8628,63377
06,45484,0645484,Manteca city, California,1,2015,75450,40.70,71.90,10.90,37053,38397,50999,4106,5682,240,820,43898,31552
06,46842,0646842,Menifee city, California,1,2015,87163,36.30,72.60,16.70,42866,44297,58026,4919,4592,742,289,57373,29790
06,46898,0646898,Merced city, California,1,2015,82440,42.70,69.00,10.80,40048,42392,38789,4699,8554,855,20,38756,43684
06,47766,0647766,Milpitas city, California,1,2015,77617,43.20,77.80,12.70,40098,37519,15425,2128,51283,262,349,65802,11815
06,48256,0648256,Mission Viejo city, California,1,2015,97163,35.00,81.60,18.90,48849,48314,76857,1314,10335,83,181,78250,18913
06,48354,0648354,Modesto city, California,1,2015,211257,40.60,74.10,13.40,104852,106405,159183,7428,15852,1721,2287,126116,85141
06,49270,0649270,Moreno Valley city, California,1,2015,204181,47.30,71.70,8.40,98584,105597,86265,33400,9943,722,1165,83571,120610
06,49670,0649670,Mountain View city, California,1,2015,80438,49.60,77.70,8.40,42493,37945,47871,1258,20805,167,135,64041,16397
06,50076,0650076,Murrieta city, California,1,2015,109816,41.10,72.30,11.60,49363,60453,70564,7457,12728,443,591,76872,32944
06,50258,0650258,Napa city, California,1,2015,80429,39.70,76.10,14.50,39828,40601,55882,382,2972,1066,106,47200,33229
06,51182,0651182,Newport Beach city, California,1,2015,87131,32.80,81.90,23.00,43161,43970,72442,168,8056,286,109,79004,8127
06,52526,0652526,Norwalk city, California,1,2015,107145,43.30,77.00,9.90,53125,54020,45320,4740,15214,724,220,31125,76020
06,53000,0653000,Oakland city, California,1,2015,419278,46.90,79.70,11.70,203827,215451,154160,104481,64168,3540,1756,305224,114054
06,53322,0653322,Oceanside city, California,1,2015,175714,41.10,78.90,15.40,87482,88232,130609,9381,14946,1108,1658,113614,62100
06,53896,0653896,Ontario city, California,1,2015,171200,47.10,70.90,7.40,85059,86141,66111,11077,11853,1005,191,52908,118292
06,53980,0653980,Orange city, California,1,2015,140995,44.80,79.40,12.00,67337,73658,97023,2415,19383,351,127,94740,46255
06,54652,0654652,Oxnard city, California,1,2015,207252,45.00,71.20,9.40,101906,105346,159325,5249,15595,4414,1022,52341,154911
06,55156,0655156,Palmdale city, California,1,2015,158350,39.80,70.50,9.60,76361,81989,68892,23906,9034,1670,598,70898,87452
06,55282,0655282,Palo Alto city, California,0,2015,66848,38.50,76.30,17.60,31451,35397,40346,818,21074,36,0,63352,3496
06,56000,0656000,Pasadena city, California,1,2015,142246,43.00,80.50,15.40,67712,74534,72764,14121,21205,395,148,89529,52717
06,56700,0656700,Perris city, California,1,2015,74959,46.80,66.10,5.40,41623,33336,22487,8390,2799,406,0,20561,54398
06,57456,0657456,Pittsburg city, California,0,2015,69427,43.80,75.60,8.90,33309,36118,20444,13169,11579,386,694,40822,28605
06,57792,0657792,Pleasanton city, California,1,2015,79519,34.20,73.20,13.00,36662,42857,46094,1347,24950,232,890,71570,7949
06,58072,0658072,Pomona city, California,1,2015,153252,46.50,74.70,10.40,74945,78307,88854,9971,14478,1532,365,44465,108787
06,59444,0659444,Rancho Cordova city, California,0,2015,71026,43.60,75.70,11.50,34844,36182,42851,6063,10663,773,961,57056,13970
06,59451,0659451,Rancho Cucamonga city, California,1,2015,175232,42.70,74.90,9.50,88127,87105,105040,21610,21614,1060,2321,109409,65823
06,59920,0659920,Redding city, California,1,2015,91579,37.60,79.00,19.80,42530,49049,77152,1536,4608,2691,0,82436,9143
06,59962,0659962,Redlands city, California,1,2015,71028,40.70,77.00,14.80,33993,37035,51625,5686,5231,480,294,51330,19698
06,60018,0660018,Redondo Beach city, California,1,2015,68185,37.90,81.50,12.40,34855,33330,48727,1327,8846,444,112,59327,8858
06,60102,0660102,Redwood City city, California,1,2015,85300,42.10,77.50,12.80,42676,42624,48497,1507,12627,170,1101,56289,29011
06,60466,0660466,Rialto city, California,1,2015,103137,48.00,73.90,8.50,49902,53235,73103,10423,3291,693,0,24566,78571
06,60620,0660620,Richmond city, California,1,2015,109715,44.80,78.50,12.60,52615,57100,32339,24231,18218,236,257,64583,45132
06,62000,0662000,Riverside city, California,1,2015,322423,48.10,76.00,10.20,160613,161810,209493,19928,20371,2582,1804,161726,160697
17,14000,1714000,Chicago city, Illinois,1,2015,2720556,47.40,78.60,11.60,1320015,1400541,1316927,844768,168744,8982,689,1934831,785725
17,14351,1714351,Cicero town, Illinois,1,2015,83867,50.00,69.90,6.10,43153,40714,29745,2643,861,680,0,7442,76425
17,18823,1718823,Decatur city, Illinois,1,2015,72856,39.30,79.20,17.80,34646,38210,52496,14727,602,19,0,71147,1709
17,23074,1723074,Elgin city, Illinois,1,2015,111076,41.20,73.10,13.00,54852,56224,73789,6934,7064,10,0,62855,48221
17,24582,1724582,Evanston city, Illinois,1,2015,75523,43.80,80.50,14.00,34146,41377,51794,10910,7339,22,0,66448,9075
17,38570,1738570,Joliet city, Illinois,1,2015,150025,44.60,70.20,8.60,70863,79162,101876,26112,1686,42,56,104734,45291
17,51622,1751622,Naperville city, Illinois,1,2015,147159,39.40,73.90,11.10,71365,75794,105589,7974,28852,191,0,142231,4928
17,57225,1757225,Palatine village, Illinois,1,2015,69269,40.60,76.40,12.30,36506,32763,45153,1253,6625,0,0,50643,18626
17,59000,1759000,Peoria city, Illinois,1,2015,118661,42.20,74.80,13.70,56229,62432,71113,31525,5699,149,56,111787,6874
17,65000,1765000,Rockford city, Illinois,1,2015,149346,39.50,75.20,15.30,71076,78270,102639,29239,4779,1074,0,120423,28923
17,68003,1768003,Schaumburg village, Illinois,1,2015,75811,41.00,76.40,11.90,35971,39840,41629,1610,20443,633,686,63266,12545
17,70122,1770122,Skokie village, Illinois,0,2015,64819,34.90,78.60,20.00,31382,33437,37834,4816,18129,139,0,58229,6590
17,72000,1772000,Springfield city, Illinois,1,2015,117809,38.80,78.50,16.00,55639,62170,86966,21381,3349,117,0,115071,2738
17,79293,1779293,Waukegan city, Illinois,1,2015,88347,43.80,72.10,9.50,45514,42833,63475,10060,4247,129,8,34133,54214
18,05860,1805860,Bloomington city, Indiana,1,2015,83815,69.00,88.60,9.60,40588,43227,68032,3518,8561,143,0,80172,3643
18,10342,1810342,Carmel city, Indiana,1,2015,89029,36.50,72.60,10.80,42928,46101,-998,-998,-998,-998,-998,85918,3111
18,22000,1822000,Evansville city, Indiana,1,2015,117679,41.20,79.90,16.60,57198,60481,96413,14893,954,69,0,114416,3263
18,23278,1823278,Fishers town, Indiana,1,2015,86071,40.70,66.60,7.10,42161,43910,70703,5329,5714,0,0,82662,3409
18,25000,1825000,Fort Wayne city, Indiana,1,2015,258144,40.80,74.10,13.60,124815,133329,192349,38066,11179,872,602,236910,21234
18,27000,1827000,Gary city, Indiana,1,2015,77354,36.80,73.70,15.20,35876,41478,11887,59741,352,0,0,71088,6266
18,31000,1831000,Hammond city, Indiana,1,2015,77610,41.80,77.40,12.80,38923,38687,38721,18949,1096,98,0,52290,25320
18,36003,1836003,Indianapolis city (balance), Indiana,1,2015,848423,43.00,75.20,11.40,410615,437808,534462,236414,25280,2765,0,764997,83426
18,40788,1840788,Lafayette city, Indiana,1,2015,71170,44.90,77.40,13.80,34313,36857,61705,5403,1126,169,0,62019,9151
18,51876,1851876,Muncie city, Indiana,1,2015,69701,51.70,81.10,12.30,32446,37255,-998,-998,-998,-998,-998,67202,2499
18,71000,1871000,South Bend city, Indiana,1,2015,103757,42.50,71.60,11.20,50483,53274,66559,25812,1377,183,161,87295,16462
19,01855,1901855,Ames city, Iowa,0,2015,65052,67.30,86.90,8.40,33814,31238,54595,703,7817,114,0,63028,2024
19,12000,1912000,Cedar Rapids city, Iowa,1,2015,130405,43.90,77.20,13.80,63109,67296,111571,7397,3280,650,40,125077,5328
19,19000,1919000,Davenport city, Iowa,1,2015,102577,41.30,75.60,14.30,50123,52454,84478,10828,2297,274,29,93446,9131
19,21000,1921000,Des Moines city, Iowa,1,2015,210317,44.80,76.80,11.90,103726,106591,161279,22581,13004,2323,182,185011,25306
19,38595,1938595,Iowa City city, Iowa,1,2015,74227,59.70,82.90,9.40,37089,37138,58305,6839,4195,244,406,70155,4072
19,73335,1973335,Sioux City city, Iowa,1,2015,82776,40.50,74.60,13.40,38827,43949,69391,3353,2996,1307,289,67174,15602
19,82425,1982425,Waterloo city, Iowa,1,2015,68457,39.80,77.10,14.50,34488,33969,50068,10996,1511,292,0,63496,4961
20,36000,2036000,Kansas City city, Kansas,1,2015,151261,41.00,72.40,11.00,74606,76655,89987,36348,6641,638,23,106919,44342
20,38900,2038900,Lawrence city, Kansas,1,2015,93916,56.90,82.10,9.80,45592,48324,76643,4425,5064,2929,0,87481,6435
20,52575,2052575,Olathe city, Kansas,1,2015,134316,42.00,69.30,8.70,65046,69270,114787,6686,4841,569,443,118185,16131
20,53775,2053775,Overland Park city, Kansas,1,2015,186511,40.30,77.30,15.00,93355,93156,156864,8122,15073,424,73,176407,10104
20,64500,2064500,Shawnee city, Kansas,0,2015,65058,40.50,75.80,14.60,32313,32745,53570,5576,2491,0,0,60194,4864
20,71000,2071000,Topeka city, Kansas,1,2015,127257,40.20,76.60,16.60,60879,66378,102787,11283,2360,1520,268,108617,18640
20,79000,2079000,Wichita city, Kansas,1,2015,389955,41.20,74.60,12.80,192354,197601,295195,46253,23902,4628,239,324793,65162
21,46027,2146027,Lexington-Fayette urban county, Kentucky,1,2015,314488,46.60,79.00,12.10,154032,160456,238806,45159,11090,679,85,292722,21766
21,48006,2148006,Louisville/Jefferson County metro government (balance), Kentucky,1,2015,615389,40.10,77.10,14.40,298451,316938,439547,138480,15346,866,424,586677,28712
22,05000,2205000,Baton Rouge city, Louisiana,1,2015,228596,48.60,78.80,12.40,111492,117104,95463,122019,7007,379,72,221168,7428
22,08920,2208920,Bossier City city, Louisiana,0,2015,68097,44.90,76.30,14.00,33428,34669,45426,18387,1357,279,0,62508,5589
22,39475,2239475,Kenner city, Louisiana,1,2015,67106,40.30,77.30,14.70,33993,33113,44286,16899,2573,95,0,49337,17769
22,40735,2240735,Lafayette city, Louisiana,1,2015,127661,44.80,77.10,11.60,64018,63643,83446,38741,2390,235,0,121105,6556
22,41155,2241155,Lake Charles city, Louisiana,1,2015,76066,43.50,76.10,14.30,35678,40388,35334,37057,1203,465,0,72909,3157
22,50115,2250115,Metairie CDP, Louisiana,0,2015,146458,38.40,81.60,17.80,69515,76943,121782,16035,3334,86,0,126755,19703
22,55000,2255000,New Orleans city, Louisiana,1,2015,389617,44.30,79.60,12.50,185736,203881,134004,230722,12136,828,120,367767,21850
22,70000,2270000,Shreveport city, Louisiana,1,2015,196994,41.20,74.80,14.10,93138,103856,76882,110852,3637,311,67,191913,5081
23,60545,2360545,Portland city, Maine,1,2015,66872,43.10,85.00,15.90,31480,35392,56526,5003,1984,46,0,64841,2031
24,04000,2404000,Baltimore city, Maryland,1,2015,621849,44.60,78.90,12.50,294027,327822,193032,382922,16894,952,381,591896,29953
24,19125,2419125,Columbia CDP, Maryland,0,2015,103467,41.00,75.70,13.20,52202,51265,55228,26879,15372,0,0,95434,8033
24,26000,2426000,Ellicott City CDP, Maryland,0,2015,70932,34.10,76.10,15.10,34406,36526,41814,5483,21126,201,70,69330,1602
24,30325,2430325,Frederick city, Maryland,0,2015,69482,43.20,76.60,12.20,33146,36336,47064,11663,4774,128,0,56417,13065
24,31175,2431175,Gaithersburg city, Maryland,0,2015,67445,43.50,77.50,10.40,32211,35234,34739,11660,12515,86,27,48724,18721
24,32025,2432025,Germantown CDP, Maryland,0,2015,84122,42.70,73.00,8.10,41115,43007,41269,20159,14972,275,0,65920,18202
24,32650,2432650,Glen Burnie CDP, Maryland,0,2015,69859,40.00,76.20,13.90,33398,36461,48135,16078,2432,347,0,60722,9137
24,67675,2467675,Rockville city, Maryland,0,2015,66998,41.10,79.30,16.30,31205,35793,38817,6699,14871,157,0,57801,9197
24,72450,2472450,Silver Spring CDP, Maryland,0,2015,82463,47.80,76.40,8.80,40601,41862,34525,19740,7297,460,0,56539,25924
24,81175,2481175,Waldorf CDP, Maryland,0,2015,75512,43.40,72.50,8.10,35640,39872,22935,42702,3277,494,0,70702,4810
25,07000,2507000,Boston city, Massachusetts,1,2015,669469,54.30,83.30,10.60,322149,347320,352667,169390,63603,1282,153,538813,130656
25,09000,2509000,Brockton city, Massachusetts,1,2015,95314,42.60,76.10,12.00,46273,49041,38457,41624,2297,65,0,84424,10890
25,11000,2511000,Cambridge city, Massachusetts,1,2015,110402,62.00,89.50,12.60,55421,54981,77028,10401,16219,0,39,100969,9433
25,23000,2523000,Fall River city, Massachusetts,1,2015,88770,41.90,81.80,13.40,43314,45456,72667,3335,1684,0,246,79689,9081
25,24960,2524960,Framingham CDP, Massachusetts,0,2015,71210,42.10,81.40,12.80,35442,35768,50947,6593,5474,638,0,58210,13000
25,34550,2534550,Lawrence city, Massachusetts,1,2015,80240,45.20,73.50,10.10,37464,42776,37129,5848,2125,121,0,17065,63175
25,37000,2537000,Lowell city, Massachusetts,1,2015,110720,46.00,77.60,9.00,54422,56298,66454,5968,28650,242,0,88625,22095
25,37490,2537490,Lynn city, Massachusetts,1,2015,92459,45.20,75.50,10.80,44598,47861,43612,12130,8190,214,0,59209,33250
25,45000,2545000,New Bedford city, Massachusetts,1,2015,94959,40.20,78.70,15.70,43793,51166,61649,6646,1297,47,0,76623,18336
25,45560,2545560,Newton city, Massachusetts,1,2015,88809,36.50,78.70,17.70,41985,46824,67014,1993,13966,67,0,84019,4790
25,55745,2555745,Quincy city, Massachusetts,1,2015,93629,41.00,83.80,16.40,44129,49500,58004,3902,30135,0,0,91063,2566
25,62535,2562535,Somerville city, Massachusetts,1,2015,80334,64.80,90.50,10.00,41028,39306,60608,6038,8481,21,0,71544,8790
25,67000,2567000,Springfield city, Massachusetts,1,2015,154336,43.70,73.50,11.90,74744,79592,92933,30723,4544,835,0,85127,69209
25,82000,2582000,Worcester city, Massachusetts,1,2015,184806,46.90,81.30,13.20,90951,93855,127455,24337,14105,658,0,145806,39000
26,03000,2603000,Ann Arbor city, Michigan,1,2015,117070,59.80,87.70,12.50,58789,58281,86039,7780,16882,1044,118,111182,5888
26,21000,2621000,Dearborn city, Michigan,1,2015,95180,39.90,71.50,11.80,46482,48698,86285,3409,2357,185,0,91647,3533
26,22000,2622000,Detroit city, Michigan,1,2015,677124,41.10,74.70,12.70,319265,357859,95272,538304,8790,1738,188,623144,53980
26,27440,2627440,Farmington Hills city, Michigan,1,2015,81332,35.80,77.80,18.50,37527,43805,56106,12745,9888,130,0,79280,2052
26,29000,2629000,Flint city, Michigan,1,2015,98297,39.70,74.50,11.90,48984,49313,40994,51578,195,81,0,95772,2525
26,34000,2634000,Grand Rapids city, Michigan,1,2015,195099,47.40,77.30,11.50,95669,99430,134123,34841,4451,596,149,163817,31282
26,42160,2642160,Kalamazoo city, Michigan,1,2015,76040,54.90,80.30,10.30,37175,38865,52812,16101,1276,394,0,71926,4114
26,46000,2646000,Lansing city, Michigan,1,2015,114110,46.80,76.80,10.80,54333,59777,67182,26696,3941,431,0,99865,14245
26,49000,2649000,Livonia city, Michigan,1,2015,94633,32.70,82.00,19.10,45369,49264,86733,4181,2507,116,0,92861,1772
26,69035,2669035,Rochester Hills city, Michigan,1,2015,73432,39.30,76.90,15.80,36356,37076,60905,3046,7546,45,0,70037,3395
26,74900,2674900,Southfield city, Michigan,1,2015,73177,37.70,79.50,19.50,31369,41808,17246,52696,1230,59,0,72604,573
26,76460,2676460,Sterling Heights city, Michigan,1,2015,132062,39.20,80.40,18.40,64985,67077,110631,6990,11293,32,0,129251,2811
26,80700,2680700,Troy city, Michigan,1,2015,83276,34.40,77.50,15.50,42371,40905,53748,4048,21213,1142,0,80876,2400
26,84000,2684000,Warren city, Michigan,1,2015,135356,36.30,80.10,16.30,64063,71293,91619,25478,11717,398,123,132146,3210
26,86000,2686000,Westland city, Michigan,1,2015,81995,38.00,80.20,16.70,37742,44253,59486,15799,4325,133,0,79168,2827
26,88940,2688940,Wyoming city, Michigan,1,2015,75277,40.60,70.60,9.80,35967,39310,54314,5965,2771,1134,0,59952,15325
27,06616,2706616,Bloomington city, Minnesota,1,2015,86436,38.70,80.20,18.60,43318,43118,69711,5174,4191,1008,0,78415,8021
27,07966,2707966,Brooklyn Park city, Minnesota,1,2015,79150,40.70,72.30,9.70,37845,41305,40093,21333,13432,625,0,75012,4138
27,17000,2717000,Duluth city, Minnesota,1,2015,86126,45.90,82.20,15.30,41271,44855,78517,2054,1270,734,144,84145,1981
27,17288,2717288,Eagan city, Minnesota,0,2015,66288,42.00,77.60,9.90,31587,34701,49298,6529,5397,280,0,61960,4328
27,40166,2740166,Maple Grove city, Minnesota,0,2015,68381,33.90,73.10,10.10,31780,36601,-998,-998,-998,-998,-998,66696,1685
27,43000,2743000,Minneapolis city, Minnesota,1,2015,410935,52.40,80.10,9.20,206547,204388,260331,80984,27086,3687,0,370954,39981
27,51730,2751730,Plymouth city, Minnesota,1,2015,75928,37.10,76.70,16.00,39035,36893,62624,6633,5054,66,0,72654,3274
27,54880,2754880,Rochester city, Minnesota,1,2015,112216,41.50,75.20,14.50,54934,57282,90689,7679,8891,710,83,105599,6617
27,56896,2756896,St. Cloud city, Minnesota,0,2015,68253,50.10,77.80,13.00,34311,33942,57354,5588,1765,419,0,65614,2639
27,58000,2758000,St. Paul city, Minnesota,1,2015,300840,47.00,75.80,9.80,149547,151293,178216,46900,53452,1572,39,273533,27307
27,71428,2771428,Woodbury city, Minnesota,0,2015,67850,39.00,72.20,11.30,31982,35868,53593,4307,6131,70,0,64592,3258
28,29700,2829700,Gulfport city, Mississippi,1,2015,71872,42.10,76.20,14.60,33108,38764,40824,26068,1405,260,0,67625,4247
28,36000,2836000,Jackson city, Mississippi,1,2015,170811,43.70,73.80,11.10,79039,91772,28419,139016,801,0,0,167794,3017
29,15670,2915670,Columbia city, Missouri,1,2015,119098,57.10,81.70,7.60,56544,62554,91241,12834,6954,456,310,114142,4956
29,35000,2935000,Independence city, Missouri,1,2015,117255,37.20,77.20,16.10,54348,62907,96658,9295,445,656,501,105019,12236
29,38000,2938000,Kansas City city, Missouri,1,2015,475361,42.10,76.70,12.30,228430,246931,284279,141122,13804,1538,432,429324,46037
29,41348,2941348,Lee's Summit city, Missouri,1,2015,95068,38.60,72.40,14.10,48353,46715,81512,6784,2457,562,457,90564,4504
29,54074,2954074,O'Fallon city, Missouri,1,2015,85032,42.40,72.30,11.60,41762,43270,75531,4502,2514,200,0,82449,2583
29,64082,2964082,St. Charles city, Missouri,0,2015,68801,42.40,79.90,14.40,32054,36747,55837,4777,2643,0,119,64731,4070
29,64550,2964550,St. Joseph city, Missouri,1,2015,76096,41.70,77.30,15.60,37688,38408,65954,6059,605,484,0,70696,5400
29,65000,2965000,St. Louis city, Missouri,1,2015,315685,45.80,79.90,11.60,153026,162659,147897,147176,9152,507,521,303424,12261
29,70000,2970000,Springfield city, Missouri,1,2015,166798,48.40,83.10,16.20,81057,85741,146856,7923,4498,770,93,159698,7100
30,06550,3006550,Billings city, Montana,1,2015,110270,40.60,77.70,15.50,52705,57565,99558,985,1113,4886,0,102744,7526
30,50200,3050200,Missoula city, Montana,1,2015,71024,49.40,82.70,13.40,35002,36022,64376,628,1812,2018,0,68550,2474
31,28000,3128000,Lincoln city, Nebraska,1,2015,277346,46.60,77.20,11.90,138544,138802,237273,12270,11681,1650,270,257050,20296
31,37000,3137000,Omaha city, Nebraska,1,2015,443887,42.50,75.20,12.40,218789,225098,342188,57966,15370,3340,141,380371,63516
32,23770,3223770,Enterprise CDP, Nevada,0,2015,135474,49.30,76.70,8.90,69146,66328,77511,12196,30390,1018,1752,110167,25307
32,31900,3231900,Henderson city, Nevada,1,2015,285658,36.70,79.10,19.70,139412,146246,224975,15173,19916,1666,712,238504,47154
32,40000,3240000,Las Vegas city, Nevada,1,2015,623769,39.30,75.70,13.80,310568,313201,401097,72469,42622,4175,3844,418856,204913
32,51800,3251800,North Las Vegas city, Nevada,1,2015,234793,44.90,71.50,10.40,116350,118443,126034,47918,14114,1261,1321,139989,94804
32,54600,3254600,Paradise CDP, Nevada,0,2015,236946,44.10,79.40,13.00,122784,114162,141059,22312,23303,2562,3710,148599,88347
32,60600,3260600,Reno city, Nevada,1,2015,241443,42.80,78.40,14.70,122292,119151,186593,5277,14038,1522,2018,181541,59902
32,68400,3268400,Sparks city, Nevada,1,2015,96098,40.10,74.90,14.50,47780,48318,74870,3013,5639,1282,635,66939,29159
32,68585,3268585,Spring Valley CDP, Nevada,0,2015,193955,45.60,79.20,12.50,96808,97147,102224,23808,39287,869,1529,153581,40374
32,71400,3271400,Sunrise Manor CDP, Nevada,0,2015,192608,42.80,72.90,9.90,93505,99103,102159,24475,13136,2198,1313,92770,99838
33,45140,3345140,Manchester city, New Hampshire,1,2015,110223,41.60,80.10,13.60,54845,55378,98135,6424,3247,92,0,98261,11962
33,50260,3350260,Nashua city, New Hampshire,1,2015,87975,41.30,78.40,14.40,42926,45049,72795,3634,9593,32,0,77464,10511
34,03580,3403580,Bayonne city, New Jersey,0,2015,66303,39.60,76.60,13.80,32705,33598,40114,6731,6734,0,365,46778,19525
34,10000,3410000,Camden city, New Jersey,1,2015,76131,43.90,67.40,8.80,36437,39694,16938,31608,1686,564,101,34658,41473
34,13690,3413690,Clifton city, New Jersey,1,2015,86341,41.80,78.10,13.70,41932,44409,49736,8194,5489,1438,0,53165,33176
34,19390,3419390,East Orange city, New Jersey,0,2015,64962,44.50,76.60,11.90,29995,34967,2063,56406,472,197,0,58594,6368
34,21000,3421000,Elizabeth city, New Jersey,1,2015,129012,44.20,73.50,9.70,65896,63116,63780,23617,2514,455,0,42556,86456
34,36000,3436000,Jersey City city, New Jersey,1,2015,264277,50.30,79.10,9.90,131765,132512,93626,60304,64310,1317,104,184559,79718
34,51000,3451000,Newark city, New Jersey,1,2015,281913,44.80,75.70,10.70,138040,143873,72760,141422,6216,1439,0,181481,100432
34,56550,3456550,Passaic city, New Jersey,1,2015,71082,43.70,69.40,8.30,36505,34577,28955,4316,3338,137,0,17402,53680
34,57000,3457000,Paterson city, New Jersey,1,2015,147757,43.00,73.20,11.10,70640,77117,44849,38159,7930,245,0,62202,85555
34,73110,3473110,Toms River CDP, New Jersey,0,2015,87750,32.70,76.40,17.10,43864,43886,77182,2590,3420,0,0,77483,10267
34,74000,3474000,Trenton city, New Jersey,1,2015,84231,46.00,74.60,9.00,42581,41650,36595,42639,1182,74,0,53618,30613
34,74630,3474630,Union City city, New Jersey,1,2015,69149,46.60,79.30,10.00,35376,33773,48162,3594,3671,0,0,15975,53174
35,02000,3502000,Albuquerque city, New Mexico,1,2015,559131,41.90,77.10,14.20,273323,285808,392079,20159,13909,24876,391,287277,271854
35,39380,3539380,Las Cruces city, New Mexico,1,2015,101644,44.20,75.50,15.50,47835,53809,89030,2923,1954,1428,0,41030,60614
35,63460,3563460,Rio Rancho city, New Mexico,1,2015,94155,39.40,74.60,13.10,47251,46904,69900,3129,1162,2902,250,55481,38674
35,70500,3570500,Santa Fe city, New Mexico,1,2015,84112,34.40,79.60,21.00,40601,43511,73333,931,997,1307,38,38228,45884
36,01000,3601000,Albany city, New York,1,2015,98452,51.80,85.20,13.60,47627,50825,55009,27825,7187,597,79,89084,9368
36,08026,3608026,Brentwood CDP, New York,0,2015,63792,45.70,75.00,9.10,31395,32397,42265,7846,1211,554,0,23681,40111
36,11000,3611000,Buffalo city, New York,1,2015,258066,44.00,76.90,12.20,124537,133529,122319,96162,12822,1077,123,228410,29656
36,15000,3615000,Cheektowaga CDP, New York,0,2015,76075,38.80,81.50,18.10,37476,38599,62417,9498,1290,88,0,74081,1994
36,49121,3649121,Mount Vernon city, New York,1,2015,68621,41.50,79.70,13.70,31876,36745,12498,48882,1497,293,0,59175,9446
36,50617,3650617,New Rochelle city, New York,1,2015,79838,37.90,78.60,18.80,38871,40967,42145,16317,3887,5,91,56290,23548
36,51000,3651000,New York city, New York,1,2015,8550405,44.30,78.90,13.20,4081698,4468707,3639914,2055137,1205321,35617,1864,6065280,2485125
36,63000,3663000,Rochester city, New York,1,2015,209808,46.40,76.30,9.80,100135,109673,99825,86974,8132,2497,0,171804,38004
36,65508,3665508,Schenectady city, New York,1,2015,65299,44.30,81.50,12.90,32398,32901,37775,13310,3720,145,0,59342,5957
36,73000,3673000,Syracuse city, New York,1,2015,144152,48.60,78.20,12.80,69462,74690,83779,40762,8440,1018,109,130784,13368
36,84000,3684000,Yonkers city, New York,1,2015,201118,41.50,77.70,15.30,96580,104538,122998,34238,12932,292,82,127510,73608
37,02140,3702140,Asheville city, North Carolina,1,2015,88507,43.30,81.90,16.80,42100,46407,76861,8182,1517,253,0,84361,4146
37,10740,3710740,Cary town, North Carolina,1,2015,160514,39.10,75.40,11.40,78932,81582,115843,13474,23885,528,0,150187,10327
37,12000,3712000,Charlotte city, North Carolina,1,2015,827121,46.10,76.30,10.00,396646,430475,430362,285758,50389,2749,119,713390,113731
37,14100,3714100,Concord city, North Carolina,1,2015,87693,41.00,72.40,13.20,42732,44961,59548,17128,3121,86,0,76392,11301
37,19000,3719000,Durham city, North Carolina,1,2015,257598,49.00,77.90,10.40,121153,136445,120911,102819,13919,974,0,221294,36304
37,22920,3722920,Fayetteville city, North Carolina,1,2015,201965,46.70,75.80,11.70,101051,100914,92468,82656,5154,2036,500,176885,25080
37,25580,3725580,Gastonia city, North Carolina,1,2015,74550,39.40,75.30,14.00,35527,39023,45292,21303,2279,369,0,67897,6653
37,28000,3728000,Greensboro city, North Carolina,1,2015,285344,44.10,78.30,13.80,132251,153093,137388,118163,11353,685,27,263197,22147
37,28080,3728080,Greenville city, North Carolina,1,2015,90588,57.30,81.50,9.50,39897,50691,48267,36364,2248,274,0,86179,4409
37,31400,3731400,High Point city, North Carolina,1,2015,109828,41.30,75.50,13.60,51751,58077,54501,37090,9730,218,248,98382,11446
37,34200,3734200,Jacksonville city, North Carolina,1,2015,67363,63.10,79.30,6.20,40015,27348,46591,9854,2849,414,33,55416,11947
37,55000,3755000,Raleigh city, North Carolina,1,2015,451949,49.60,77.90,9.30,219184,232765,264843,133153,20151,1681,348,400163,51786
37,74440,3774440,Wilmington city, North Carolina,1,2015,115947,45.80,81.40,15.10,52346,63601,87929,23226,2518,182,108,109136,6811
37,75000,3775000,Winston-Salem city, North Carolina,1,2015,241232,42.00,75.70,13.70,112520,128712,135068,84731,5272,152,276,202911,38321
38,07200,3807200,Bismarck city, North Dakota,0,2015,70240,41.80,81.00,16.00,34675,35565,63521,1617,769,3038,0,68573,1667
38,25700,3825700,Fargo city, North Dakota,1,2015,119250,52.20,79.60,11.10,60560,58690,104053,5480,3853,1517,0,115683,3567
39,01000,3901000,Akron city, Ohio,1,2015,197553,41.20,79.00,15.10,96886,100667,120353,59364,8006,505,0,193869,3684
39,12000,3912000,Canton city, Ohio,1,2015,71895,41.50,73.70,13.00,34476,37419,-998,-998,-998,-998,-998,68298,3597
39,15000,3915000,Cincinnati city, Ohio,1,2015,298537,46.00,78.50,12.40,143654,154883,154285,125995,6259,521,0,289416,9121
39,16000,3916000,Cleveland city, Ohio,1,2015,388059,41.60,77.50,13.50,186436,201623,156443,196619,8089,2652,197,347456,40603
39,18000,3918000,Columbus city, Ohio,1,2015,849067,48.90,77.80,9.90,413981,435086,522370,235671,42933,1490,145,802212,46855
39,21000,3921000,Dayton city, Ohio,1,2015,140597,43.90,77.00,13.00,66631,73966,80076,51935,1548,265,15,135652,4945
39,44856,3944856,Lorain city, Ohio,0,2015,63651,40.40,73.10,12.80,30844,32807,42890,13001,308,277,52,44309,19342
39,61000,3961000,Parma city, Ohio,1,2015,79943,41.90,82.40,16.90,38425,41518,74751,1559,889,303,38,74582,5361
39,77000,3977000,Toledo city, Ohio,1,2015,279778,40.90,78.00,14.20,135455,144323,174466,76791,5918,740,205,256164,23614
39,88000,3988000,Youngstown city, Ohio,1,2015,64609,39.10,77.40,17.60,30758,33851,30886,29899,200,428,0,57045,7564
40,09050,4009050,Broken Arrow city, Oklahoma,1,2015,107595,39.30,72.60,12.60,52136,55459,83866,4665,3145,3529,0,98404,9191
40,23200,4023200,Edmond city, Oklahoma,1,2015,90090,43.50,74.30,12.20,45191,44899,71800,3631,3317,2273,37,83903,6187
40,41850,4041850,Lawton city, Oklahoma,1,2015,96659,48.80,75.60,9.70,51099,45560,55870,20690,3013,4510,405,82879,13780
40,52500,4052500,Norman city, Oklahoma,1,2015,120297,52.00,80.50,11.00,59483,60814,96299,3687,5341,3303,65,108565,11732
40,55000,4055000,Oklahoma City city, Oklahoma,1,2015,631263,42.10,74.00,12.00,309227,322036,426018,92592,29486,18320,545,513901,117362
40,75000,4075000,Tulsa city, Oklahoma,1,2015,403091,41.40,75.50,13.50,197437,205654,252987,61420,14180,18979,21,341874,61217
41,05350,4105350,Beaverton city, Oregon,1,2015,96577,46.10,78.80,11.00,47325,49252,77453,1735,8321,657,151,81125,15452
41,05800,4105800,Bend city, Oregon,1,2015,87017,39.40,76.80,15.50,42294,44723,80551,334,1120,378,0,78844,8173
41,23850,4123850,Eugene city, Oregon,1,2015,163448,49.60,82.00,14.90,79071,84377,136891,3589,5931,1463,264,146092,17356
41,31250,4131250,Gresham city, Oregon,1,2015,110582,40.40,75.50,13.50,53866,56716,89318,5837,3794,555,904,87006,23576
41,34100,4134100,Hillsboro city, Oregon,1,2015,102360,44.50,74.80,11.30,50926,51434,73977,2064,11233,1835,62,80191,22169
41,47000,4147000,Medford city, Oregon,1,2015,79795,37.30,76.60,16.60,39606,40189,72460,302,1027,335,351,65501,14294
41,59000,4159000,Portland city, Oregon,1,2015,632187,47.80,81.70,11.80,313516,318671,491427,36199,50253,4554,3483,571123,61064
41,64900,4164900,Salem city, Oregon,1,2015,164543,42.70,75.80,12.90,80839,83704,139523,2969,3566,2239,2240,125129,39414
42,02000,4202000,Allentown city, Pennsylvania,1,2015,120207,43.90,74.40,12.50,60626,59581,70022,18843,2326,384,491,61031,59176
42,06088,4206088,Bethlehem city, Pennsylvania,1,2015,74367,44.80,81.00,16.50,35861,38506,59387,3449,3025,84,0,50958,23409
42,24000,4224000,Erie city, Pennsylvania,1,2015,99470,41.60,76.80,13.20,48618,50852,73732,17115,2497,233,41,91611,7859
42,60000,4260000,Philadelphia city, Pennsylvania,1,2015,1567442,45.10,77.90,12.70,741270,826172,657151,664062,113162,5701,1403,1348404,219038
42,61000,4261000,Pittsburgh city, Pennsylvania,1,2015,304385,50.70,84.80,14.60,149690,154695,198438,73962,18101,145,79,295119,9266
42,63624,4263624,Reading city, Pennsylvania,1,2015,87873,44.40,70.60,9.90,43668,44205,51294,9447,861,4149,76,30841,57032
42,69000,4269000,Scranton city, Pennsylvania,1,2015,77112,41.10,80.10,17.50,37975,39137,64728,4746,3855,14,0,65811,11301
44,19180,4419180,Cranston city, Rhode Island,1,2015,81077,39.60,79.30,16.60,38365,42712,62309,5698,5187,364,0,70659,10418
44,54640,4454640,Pawtucket city, Rhode Island,1,2015,71583,40.80,80.00,14.60,36072,35511,45449,13656,1554,474,0,55466,16117
44,59000,4459000,Providence city, Rhode Island,1,2015,179204,51.10,76.70,9.60,89090,90114,92348,25498,10922,1646,211,101236,77968
44,74300,4474300,Warwick city, Rhode Island,1,2015,81698,37.80,81.60,19.10,39289,42409,74943,746,1868,0,0,76975,4723
45,13330,4513330,Charleston city, South Carolina,1,2015,135524,49.20,84.00,14.10,63956,71568,102039,29186,1721,81,0,131595,3929
45,16000,4516000,Columbia city, South Carolina,1,2015,133393,57.20,83.00,9.50,67686,65707,70223,55213,2482,0,368,125848,7545
45,48535,4548535,Mount Pleasant town, South Carolina,1,2015,81309,35.30,74.80,15.20,39429,41880,-998,-998,-998,-998,-998,78740,2569
45,50875,4550875,North Charleston city, South Carolina,1,2015,111864,46.90,74.30,9.00,56549,55315,47275,55160,3624,330,166,98889,12975
45,61405,4561405,Rock Hill city, South Carolina,1,2015,71567,45.50,77.50,12.50,33324,38243,40447,27622,1029,0,0,68722,2845
46,52980,4652980,Rapid City city, South Dakota,1,2015,73568,37.10,77.90,18.20,36122,37446,60421,456,1792,5974,0,70597,2971
46,59020,4659020,Sioux Falls city, South Dakota,1,2015,171530,43.90,75.80,12.20,86596,84934,145668,9251,3347,3808,11,162142,9388
47,14000,4714000,Chattanooga city, Tennessee,1,2015,176597,41.30,79.10,15.60,83640,92957,109636,56353,4027,534,63,165679,10918
47,15160,4715160,Clarksville city, Tennessee,1,2015,149190,50.60,73.90,7.50,75029,74161,98827,36178,4150,1101,659,133186,16004
47,27740,4727740,Franklin city, Tennessee,0,2015,72635,38.70,72.60,11.10,34991,37644,60352,7446,3344,0,0,67719,4916
47,37640,4737640,Jackson city, Tennessee,0,2015,66980,42.70,76.60,12.90,30007,36973,34538,29411,833,0,0,63597,3383
47,38320,4738320,Johnson City city, Tennessee,0,2015,65369,43.30,81.70,17.40,31019,34350,56679,4064,1557,73,0,64255,1114
47,40000,4740000,Knoxville city, Tennessee,1,2015,185312,49.80,82.00,12.40,89978,95334,140724,31513,3214,306,538,176672,8640
47,48000,4748000,Memphis city, Tennessee,1,2015,655760,42.20,75.10,12.00,312237,343523,194557,415300,13630,317,492,609139,46621
47,51560,4751560,Murfreesboro city, Tennessee,1,2015,126121,51.80,78.10,8.60,60704,65417,91738,18962,5814,128,0,117281,8840
47,52006,4752006,Nashville-Davidson metropolitan government (balance), Tennessee,1,2015,654596,46.70,78.70,10.90,314231,340365,415672,178975,20631,2694,76,587070,67526
48,01000,4801000,Abilene city, Texas,1,2015,125876,47.10,76.90,12.90,65212,60664,91254,12829,1695,959,0,92654,33222
48,01924,4801924,Allen city, Texas,1,2015,98138,40.20,71.40,7.90,51324,46814,67438,12163,14781,190,0,87523,10615
48,03000,4803000,Amarillo city, Texas,1,2015,199651,41.20,72.30,11.70,99391,100260,167592,10781,8037,1051,500,134259,65392
48,04000,4804000,Arlington city, Texas,1,2015,388122,45.80,73.70,9.30,191060,197062,242968,88887,28200,1499,523,276044,112078
48,04462,4804462,Atascocita CDP, Texas,0,2015,78240,42.10,70.50,10.40,37424,40816,49107,20990,1976,378,0,57799,20441
48,05000,4805000,Austin city, Texas,1,2015,931840,52.60,79.10,8.10,475718,456122,683349,70992,69994,2832,296,604160,327680
48,06128,4806128,Baytown city, Texas,1,2015,75485,41.00,74.90,12.10,37977,37508,45964,15622,2425,422,0,43813,31672
48,07000,4807000,Beaumont city, Texas,1,2015,118110,42.30,73.30,13.50,57326,60784,52665,57553,3474,586,0,99295,18815
48,10768,4810768,Brownsville city, Texas,1,2015,183888,42.70,68.30,11.20,87689,96199,173090,1018,593,991,35,13847,170041
48,10912,4810912,Bryan city, Texas,1,2015,82106,51.80,76.70,9.10,41761,40345,56109,10411,2388,439,27,52459,29647
48,13024,4813024,Carrollton city, Texas,1,2015,133146,41.80,75.20,10.10,66928,66218,99984,9634,17309,157,0,86296,46850
48,13552,4813552,Cedar Park city, Texas,0,2015,64837,43.40,67.60,7.20,31248,33589,54292,2767,4196,124,0,52965,11872
48,15976,4815976,College Station city, Texas,1,2015,107899,66.30,83.70,6.40,54125,53774,83071,10730,9948,37,27,90115,17784
48,16432,4816432,Conroe city, Texas,0,2015,68592,48.10,74.00,11.20,34907,33685,56980,6471,2099,535,0,44729,23863
48,17000,4817000,Corpus Christi city, Texas,1,2015,324082,42.40,75.30,12.90,160488,163594,288216,13773,7270,1665,84,123345,200737
48,19000,4819000,Dallas city, Texas,1,2015,1300082,45.60,74.20,9.60,639019,661063,813829,308787,40626,3756,141,750116,549966
48,19972,4819972,Denton city, Texas,1,2015,131047,52.40,80.20,11.90,62478,68569,103643,15181,6013,470,0,101697,29350
48,22660,4822660,Edinburg city, Texas,1,2015,84501,45.40,67.30,8.00,39422,45079,-998,-998,-998,-998,-998,9803,74698
48,24000,4824000,El Paso city, Texas,1,2015,681136,42.50,73.10,12.50,332797,348339,576280,29588,10041,4436,75,139119,542017
48,26232,4826232,Flower Mound town, Texas,0,2015,71024,36.60,72.20,7.50,35200,35824,59075,3009,5807,296,0,64875,6149
48,27000,4827000,Fort Worth city, Texas,1,2015,836969,43.70,71.80,9.20,414126,422843,554453,158652,34353,3379,296,540836,296133
48,27684,4827684,Frisco city, Texas,1,2015,154388,40.30,67.40,7.90,73989,80399,107397,8918,28379,1128,0,137295,17093
48,29000,4829000,Garland city, Texas,1,2015,236836,41.10,73.10,11.00,116406,120430,148892,36681,24141,1149,148,145847,90989
48,30464,4830464,Grand Prairie city, Texas,1,2015,187755,46.10,72.10,8.20,90811,96944,110643,51680,10541,705,99,102212,85543
48,32372,4832372,Harlingen city, Texas,0,2015,65769,39.70,67.60,13.00,32404,33365,-998,-998,-998,-998,-998,14042,51727
48,35000,4835000,Houston city, Texas,1,2015,2298628,46.60,74.40,9.60,1149686,1148942,1351048,512039,159292,6484,901,1270480,1028148
48,37000,4837000,Irving city, Texas,1,2015,236617,48.80,73.20,6.70,117189,119428,127979,27907,46414,1416,1000,138755,97862
48,39148,4839148,Killeen city, Texas,1,2015,140809,49.10,69.30,6.40,69442,71367,68172,49263,5210,574,2164,108209,32600
48,41464,4841464,Laredo city, Texas,1,2015,255789,43.70,66.70,8.90,124305,131484,244622,590,1884,736,0,12599,243190
48,41980,4841980,League City city, Texas,1,2015,98350,43.00,76.60,11.30,49354,48996,84120,3597,4206,148,0,83482,14868
48,42508,4842508,Lewisville city, Texas,1,2015,104808,48.60,72.60,7.40,52776,52032,67334,15414,11847,435,0,73051,31757
48,43888,4843888,Longview city, Texas,1,2015,81590,40.10,75.80,14.70,40065,41525,59285,18477,1418,0,0,63976,17614
48,45000,4845000,Lubbock city, Texas,1,2015,249051,48.90,76.30,11.50,122320,126731,200625,18389,6407,3798,40,158345,90706
48,45384,4845384,McAllen city, Texas,1,2015,140253,42.60,71.60,13.50,68332,71921,106149,3024,5252,176,200,26424,113829
48,45744,4845744,McKinney city, Texas,1,2015,162887,43.50,70.40,9.30,77339,85548,126288,15805,12056,1403,87,131182,31705
48,47892,4847892,Mesquite city, Texas,1,2015,145124,40.70,72.80,12.20,69240,75884,94717,35601,3654,1737,0,88371,56753
48,48072,4848072,Midland city, Texas,1,2015,132950,44.80,73.30,10.20,66595,66355,113150,9037,2455,267,58,74273,58677
48,48768,4848768,Mission city, Texas,1,2015,83307,41.40,66.70,10.60,40530,42777,-998,-998,-998,-998,-998,9940,73367
48,48804,4848804,Missouri City city, Texas,1,2015,71778,42.30,76.10,9.80,34932,36846,19531,27835,17013,82,453,61771,10007
48,50820,4850820,New Braunfels city, Texas,0,2015,69923,42.30,74.10,14.90,33071,36852,61830,2687,1021,202,0,47401,22522
48,52356,4852356,North Richland Hills city, Texas,0,2015,69205,34.70,77.20,16.50,35257,33948,56554,4471,4702,426,953,59010,10195
48,53388,4853388,Odessa city, Texas,1,2015,118980,44.80,71.20,10.70,61119,57861,103422,5350,1791,206,0,55394,63586
48,56000,4856000,Pasadena city, Texas,1,2015,153786,41.50,69.40,10.00,78827,74959,138320,5135,1512,1510,54,47915,105871
48,56348,4856348,Pearland city, Texas,1,2015,111665,44.40,72.20,8.30,52336,59329,70772,22385,13255,753,0,85205,26460
48,57200,4857200,Pharr city, Texas,1,2015,76535,41.80,62.60,11.00,35242,41293,-998,-998,-998,-998,-998,3540,72995
48,58016,4858016,Plano city, Texas,1,2015,283619,40.60,76.80,11.20,138565,145054,189774,22521,57564,2413,407,240660,42959
48,61796,4861796,Richardson city, Texas,1,2015,110827,42.80,77.70,13.90,54676,56151,73495,12458,19266,442,0,95065,15762
48,63500,4863500,Round Rock city, Texas,1,2015,115839,45.10,72.60,7.70,56646,59193,87312,10946,8258,546,0,78688,37151
48,64472,4864472,San Angelo city, Texas,1,2015,100413,44.50,76.60,13.80,49669,50744,85141,5718,1585,235,242,57919,42494
48,65000,4865000,San Antonio city, Texas,1,2015,1469824,44.50,74.60,11.60,721405,748419,1203964,106383,43236,12233,1754,532217,937607
48,70808,4870808,Sugar Land city, Texas,1,2015,88129,36.00,78.20,13.70,43889,44240,43575,8522,33081,47,0,80294,7835
48,72176,4872176,Temple city, Texas,0,2015,72297,41.40,73.50,13.80,33512,38785,51316,13403,1164,145,54,50925,21372
48,72656,4872656,The Woodlands CDP, Texas,0,2015,119144,35.80,69.90,11.20,56083,63061,101472,4945,6384,176,0,99570,19574
48,74144,4874144,Tyler city, Texas,1,2015,103705,42.80,77.50,15.30,50422,53283,71429,25271,2175,525,5,82169,21536
48,75428,4875428,Victoria city, Texas,0,2015,67581,40.30,75.30,15.30,32290,35291,57079,4517,1102,40,0,33172,34409
48,76000,4876000,Waco city, Texas,1,2015,132342,46.90,76.10,12.80,63452,68890,94181,28650,3807,260,0,91757,40585
48,79000,4879000,Wichita Falls city, Texas,1,2015,104709,46.10,78.60,11.90,55775,48934,79758,12717,3263,829,27,81648,23061
49,43660,4943660,Layton city, Utah,1,2015,74142,46.50,68.50,7.90,37748,36394,62196,1135,1646,138,809,64019,10123
49,55980,4955980,Ogden city, Utah,1,2015,85450,46.30,74.30,9.90,44323,41127,71725,1502,1230,618,111,57175,28275
49,57300,4957300,Orem city, Utah,1,2015,94457,48.20,70.40,10.00,48695,45762,82523,735,2162,282,1172,76115,18342
49,62470,4962470,Provo city, Utah,1,2015,115258,64.90,77.00,5.40,56231,59027,103725,436,1983,614,1166,98590,16668
49,65330,4965330,St. George city, Utah,1,2015,80207,38.60,75.80,21.00,38732,41475,69691,1198,601,1349,676,69378,10829
49,67000,4967000,Salt Lake City city, Utah,1,2015,192660,50.70,80.20,11.60,98364,94296,145243,4558,10374,2026,2757,152101,40559
49,67440,4967440,Sandy city, Utah,1,2015,93612,40.90,71.60,10.00,46923,46689,82310,331,4046,225,390,86780,6832
49,70850,4970850,South Jordan city, Utah,0,2015,66639,40.30,67.10,9.80,33669,32970,-998,-998,-998,-998,-998,61967,4672
49,82950,4982950,West Jordan city, Utah,1,2015,111942,44.80,67.80,5.80,57898,54044,97241,2565,2815,544,363,90627,21315
49,83470,4983470,West Valley City city, Utah,1,2015,136224,45.60,70.30,8.80,68235,67989,84514,2851,8767,3142,5863,92144,44080
51,01000,5101000,Alexandria city, Virginia,1,2015,153511,49.20,82.10,10.40,74989,78522,97333,31470,10137,280,0,127938,25573
51,03000,5103000,Arlington CDP, Virginia,0,2015,229164,53.00,82.50,9.50,113981,115183,165282,20354,24290,160,202,193253,35911
51,14440,5114440,Centreville CDP, Virginia,0,2015,71782,44.70,78.20,8.20,34749,37033,36167,5462,22402,0,0,62169,9613
51,16000,5116000,Chesapeake city, Virginia,1,2015,235429,41.10,75.80,12.30,114964,120465,144648,70444,8441,506,294,222470,12959
51,21088,5121088,Dale City CDP, Virginia,0,2015,71399,46.00,72.60,7.60,35984,35415,31626,16235,7836,454,215,47531,23868
51,35000,5135000,Hampton city, Virginia,1,2015,136454,42.40,78.90,14.20,66214,70240,58494,67048,3407,817,167,128941,7513
51,47672,5147672,Lynchburg city, Virginia,1,2015,79812,50.10,80.60,13.90,38614,41198,52055,22715,2339,219,0,77123,2689
51,56000,5156000,Newport News city, Virginia,1,2015,182385,44.90,76.60,12.00,88385,94000,88771,73574,6629,346,308,166605,15780
51,57000,5157000,Norfolk city, Virginia,1,2015,246393,51.00,79.80,10.20,128917,117476,120510,102513,9488,1425,159,227633,18760
51,64000,5164000,Portsmouth city, Virginia,1,2015,96201,42.30,76.00,13.80,45900,50301,39779,50543,530,471,0,92305,3896
51,67000,5167000,Richmond city, Virginia,1,2015,220289,48.80,81.80,11.50,104793,115496,98864,104583,4866,2276,112,206030,14259
51,68000,5168000,Roanoke city, Virginia,1,2015,99897,40.10,78.30,15.30,47252,52645,64887,27458,2673,27,0,93806,6091
51,76432,5176432,Suffolk city, Virginia,1,2015,88161,38.80,75.40,13.60,43048,45113,45880,37780,1880,454,0,84622,3539
51,82000,5182000,Virginia Beach city, Virginia,1,2015,452745,43.50,77.40,12.60,222684,230061,304039,88810,28670,1096,252,416436,36309
53,03180,5303180,Auburn city, Washington,1,2015,76580,40.80,78.10,12.80,36837,39743,52577,2213,9115,988,572,65744,10836
53,05210,5305210,Bellevue city, Washington,1,2015,139814,43.00,79.80,14.40,70763,69051,75920,3120,47900,468,270,127599,12215
53,05280,5305280,Bellingham city, Washington,1,2015,85143,53.20,84.60,15.20,41286,43857,70213,934,5927,1499,456,78177,6966
53,22640,5322640,Everett city, Washington,1,2015,108012,44.40,79.20,13.50,56212,51800,81436,4252,8073,1091,1987,92123,15889
53,23515,5323515,Federal Way city, Washington,1,2015,95188,41.60,77.20,13.30,49151,46037,54131,12783,13105,415,3490,81139,14049
53,35275,5335275,Kennewick city, Washington,1,2015,78903,43.90,71.40,11.20,38492,40411,59473,232,1347,344,84,59508,19395
53,35415,5335415,Kent city, Washington,1,2015,126962,46.90,75.30,10.00,61825,65137,62959,16852,23958,1681,1461,105034,21928
53,35940,5335940,Kirkland city, Washington,0,2015,87267,42.10,81.60,15.00,42159,45108,67073,761,12655,207,294,80547,6720
53,43955,5343955,Marysville city, Washington,0,2015,66773,45.50,75.20,9.80,33436,33337,54367,618,4114,453,172,59631,7142
53,53545,5353545,Pasco city, Washington,0,2015,68097,44.60,65.50,7.20,35298,32799,52859,1540,1662,95,30,29214,38883
53,57745,5357745,Renton city, Washington,1,2015,100247,43.30,74.80,10.30,52779,47468,53268,10026,19417,412,1133,84855,15392
53,63000,5363000,Seattle city, Washington,1,2015,684443,51.90,85.40,11.30,345659,338784,473045,50190,96669,4165,1098,641383,43060
53,67000,5367000,Spokane city, Washington,1,2015,213267,42.00,78.50,15.30,102756,110511,182906,4564,5463,3420,1810,199902,13365
53,67167,5367167,Spokane Valley city, Washington,1,2015,94908,38.30,75.60,15.20,49933,44975,88181,676,853,988,285,89798,5110
53,70000,5370000,Tacoma city, Washington,1,2015,207950,42.60,79.80,14.40,100914,107036,135512,22326,20997,1217,1767,182186,25764
53,74060,5374060,Vancouver city, Washington,1,2015,172853,40.80,76.00,14.70,82958,89895,141157,4312,7864,1149,1202,149669,23184
53,80010,5380010,Yakima city, Washington,1,2015,93700,39.40,72.60,15.10,45147,48553,76610,717,1202,1360,0,49528,44172
55,02375,5502375,Appleton city, Wisconsin,1,2015,75255,42.40,76.20,13.60,37217,38038,63023,2390,5076,665,39,70116,5139
55,22300,5522300,Eau Claire city, Wisconsin,0,2015,67433,49.80,81.90,13.30,32327,35106,61486,503,4157,495,36,65945,1488
55,31000,5531000,Green Bay city, Wisconsin,1,2015,105221,43.70,75.20,12.90,52517,52704,77681,3660,4459,4319,28,88435,16786
55,39225,5539225,Kenosha city, Wisconsin,1,2015,99856,40.60,74.40,12.40,49349,50507,82287,10199,2006,604,0,81084,18772
55,48000,5548000,Madison city, Wisconsin,1,2015,248956,55.20,82.80,11.00,122596,126360,195502,16770,20560,809,83,229259,19697
55,53000,5553000,Milwaukee city, Wisconsin,1,2015,600154,45.90,74.00,10.00,286315,313839,276965,233019,22748,3351,274,489819,110335
55,60500,5560500,Oshkosh city, Wisconsin,0,2015,66557,50.00,80.80,13.60,32905,33652,59764,2555,3182,149,0,64585,1972
55,66000,5566000,Racine city, Wisconsin,1,2015,77737,39.50,72.60,11.60,39314,38423,48605,17738,690,73,0,59522,18215
55,84250,5584250,Waukesha city, Wisconsin,1,2015,71976,45.50,79.00,11.90,36263,35713,64380,1197,1758,169,132,62263,9713
72,10334,7210334,Caguas zona urbana, Puerto Rico,0,2015,77008,39.00,80.10,21.00,34743,42265,56613,8251,110,165,0,659,76349
72,14290,7214290,Carolina zona urbana, Puerto Rico,0,2015,142066,38.90,80.30,20.40,64758,77308,84326,25590,197,2015,0,2099,139967
72,32522,7232522,Guaynabo zona urbana, Puerto Rico,0,2015,70492,38.00,80.50,18.90,33066,37426,56571,3511,0,383,0,556,69936
72,63820,7263820,Ponce zona urbana, Puerto Rico,0,2015,121583,37.10,78.10,20.30,56968,64615,94213,6500,169,0,0,878,120705
72,76770,7276770,San Juan zona urbana, Puerto Rico,0,2015,342237,38.60,80.60,20.30,155408,186829,250387,34921,2329,2994,0,6678,335559
06,62938,0662938,Roseville city, California,1,2015,130282,40.30,77.00,15.60,62591,67691,97065,3012,14306,622,573,106783,23499
06,64000,0664000,Sacramento city, California,1,2015,490715,44.60,75.40,12.70,237724,252991,243803,64416,89843,3663,5427,340562,150153
06,64224,0664224,Salinas city, California,1,2015,157386,43.10,68.80,8.80,77765,79621,91528,1387,8974,1736,124,36190,121196
06,65000,0665000,San Bernardino city, California,1,2015,216137,44.50,69.30,8.40,108671,107466,115593,30844,11001,1902,1173,79923,136214
06,65042,0665042,San Buenaventura (Ventura) city, California,1,2015,109717,39.10,78.30,15.40,53932,55785,91617,558,4144,838,481,71254,38463
06,65084,0665084,San Clemente city, California,0,2015,65532,34.40,81.40,19.10,34076,31456,56224,71,2388,0,0,55111,10421
06,66000,0666000,San Diego city, California,1,2015,1394907,47.40,79.60,11.80,693826,701081,890706,94235,225120,3780,6495,969493,425414
06,67000,0667000,San Francisco city, California,1,2015,864816,48.30,86.60,14.60,439752,425064,409361,44843,301034,2945,3769,732702,132114
06,68000,0668000,San Jose city, California,1,2015,1026919,42.60,77.00,11.80,518317,508602,401920,31414,358104,5454,3153,695687,331232
06,68084,0668084,San Leandro city, California,1,2015,90711,38.80,80.60,16.60,43032,47679,35537,9004,32026,533,354,63817,26894
06,68196,0668196,San Marcos city, California,1,2015,92934,43.70,74.00,11.00,45246,47688,69040,3983,9666,211,811,57770,35164
06,68252,0668252,San Mateo city, California,1,2015,103524,41.10,79.40,14.20,50966,52558,58158,1994,26126,279,2548,80373,23151
06,68378,0668378,San Ramon city, California,1,2015,76132,37.30,69.50,10.20,39221,36911,33159,1957,35289,435,191,70683,5449
06,69000,0669000,Santa Ana city, California,1,2015,335423,46.50,71.00,8.30,167503,167920,158061,4801,36204,2868,1184,72987,262436
06,69070,0669070,Santa Barbara city, California,1,2015,91852,45.10,84.00,18.70,45068,46784,71244,1553,4386,457,0,60750,31102
06,69084,0669084,Santa Clara city, California,1,2015,126216,49.80,81.10,11.10,63278,62938,51802,3654,54774,669,2824,103814,22402
06,69088,0669088,Santa Clarita city, California,1,2015,182367,40.20,77.40,13.30,90192,92175,135625,6821,19860,989,73,125423,56944
06,69196,0669196,Santa Maria city, California,1,2015,105082,45.30,67.20,9.40,53320,51762,88586,813,4778,433,0,23531,81551
06,70000,0670000,Santa Monica city, California,1,2015,93219,46.60,85.50,16.20,46732,46487,65561,8727,10972,227,53,78246,14973
06,70098,0670098,Santa Rosa city, California,1,2015,174989,39.80,77.70,15.90,86840,88149,126671,3901,8973,2329,620,120411,54578
06,72016,0672016,Simi Valley city, California,1,2015,126766,40.10,77.00,11.80,63243,63523,102117,1217,12063,533,0,92734,34032
06,73080,0673080,South Gate city, California,1,2015,96399,46.20,73.10,8.80,47758,48641,54464,1163,566,233,279,5087,91312
06,73262,0673262,South San Francisco city, California,0,2015,67271,40.40,79.60,16.50,34177,33094,25141,1658,21420,0,1154,38098,29173
06,75000,0675000,Stockton city, California,1,2015,305650,42.10,72.60,12.70,150976,154674,140690,32533,66745,1604,1265,177434,128216
06,77000,0677000,Sunnyvale city, California,1,2015,151760,47.20,78.20,12.60,79480,72280,65940,3391,64936,39,2247,126122,25638
06,78120,0678120,Temecula city, California,1,2015,112026,40.50,72.00,11.00,54407,57619,78958,4245,10602,1054,229,75780,36246
06,78582,0678582,Thousand Oaks city, California,1,2015,129329,32.80,78.00,18.60,65113,64216,103536,3229,13483,549,5,102575,26754
06,80000,0680000,Torrance city, California,1,2015,148468,37.70,79.80,16.10,73209,75259,72417,4596,48727,1282,1469,122769,25699
06,80238,0680238,Tracy city, California,1,2015,87093,43.00,73.70,8.80,43156,43937,52157,3884,14495,402,394,54283,32810
06,80812,0680812,Turlock city, California,1,2015,72293,42.30,72.50,14.70,33190,39103,56599,1739,3976,520,0,48734,23559
06,80854,0680854,Tustin city, California,1,2015,80563,43.90,74.30,9.50,39511,41052,36003,1812,13813,40,97,46565,33998
06,81204,0681204,Union City city, California,1,2015,74510,41.60,81.20,15.00,38599,35911,14762,4924,42037,34,1653,61303,13207
06,81344,0681344,Upland city, California,1,2015,76447,38.20,79.70,16.20,36226,40221,43368,4846,7442,207,0,45660,30787
06,81554,0681554,Vacaville city, California,1,2015,96794,42.70,76.00,12.40,50091,46703,59975,14032,6100,728,127,73399,23395
06,81666,0681666,Vallejo city, California,1,2015,121269,40.70,80.20,15.50,58379,62890,50511,23995,30069,437,1839,92292,28977
06,82590,0682590,Victorville city, California,1,2015,122236,44.10,68.50,10.20,60989,61247,79737,20295,5017,669,45,61667,60569
06,82954,0682954,Visalia city, California,1,2015,130094,40.90,71.50,11.80,63695,66399,102875,1485,8819,768,221,66612,63482
06,82996,0682996,Vista city, California,1,2015,100884,43.60,71.50,10.30,50680,50204,79998,4369,5780,70,35,51360,49524
06,83346,0683346,Walnut Creek city, California,0,2015,68906,31.30,80.90,27.80,31994,36912,55283,1427,9338,0,139,63694,5212
06,84200,0684200,West Covina city, California,1,2015,108489,41.20,79.40,15.00,51629,56860,44103,2929,29485,255,268,49582,58907
06,84550,0684550,Westminster city, California,1,2015,92111,39.00,81.70,17.30,45538,46573,34249,1365,44685,420,100,73000,19111
06,85292,0685292,Whittier city, California,1,2015,87436,44.00,78.70,12.80,44397,43039,46699,1161,2880,451,83,26187,61249
06,86832,0686832,Yorba Linda city, California,0,2015,67966,32.60,77.40,16.50,31960,36006,-998,-998,-998,-998,-998,57367,10599
06,86972,0686972,Yuba City city, California,0,2015,66944,40.40,72.60,15.20,33654,33290,44313,923,12948,404,336,46054,20890
08,03455,0803455,Arvada city, Colorado,1,2015,115035,36.80,78.30,15.30,54870,60165,104375,2227,1837,1451,0,98616,16419
08,04000,0804000,Aurora city, Colorado,1,2015,358870,43.70,74.20,10.40,177899,180971,222860,53055,17277,2842,1311,249474,109396
08,07850,0807850,Boulder city, Colorado,1,2015,107342,59.90,88.50,12.10,56342,51000,94743,1145,6635,238,92,97547,9795
08,09280,0809280,Broomfield city, Colorado,0,2015,65065,41.50,75.60,12.40,31755,33310,56289,564,4476,43,0,57000,8065
08,12815,0812815,Centennial city, Colorado,1,2015,109726,36.20,77.70,16.20,53222,56504,95222,3427,5459,496,60,101640,8086
08,16000,0816000,Colorado Springs city, Colorado,1,2015,456562,43.50,76.40,13.30,225544,231018,355816,30144,14885,3128,1266,377851,78711
08,20000,0820000,Denver city, Colorado,1,2015,682545,49.10,79.40,11.10,341137,341408,526428,64692,23327,6897,474,474698,207847
08,27425,0827425,Fort Collins city, Colorado,1,2015,161181,54.70,81.70,10.00,80893,80288,144423,2184,5283,832,43,145660,15521
08,32155,0832155,Greeley city, Colorado,1,2015,100883,46.30,73.50,12.90,50792,50091,90728,1941,1832,1433,61,61612,39271
08,36410,0836410,Highlands Ranch CDP, Colorado,0,2015,102467,36.70,71.30,10.20,49186,53281,91815,822,4551,67,100,94074,8393
08,43000,0843000,Lakewood city, Colorado,1,2015,152589,42.80,80.50,15.30,76013,76576,134398,1894,5774,753,0,118959,33630
08,45970,0845970,Longmont city, Colorado,1,2015,92221,38.20,74.20,13.40,43941,48280,83590,808,1767,788,0,67375,24846
08,46465,0846465,Loveland city, Colorado,1,2015,75188,38.00,74.90,17.70,37042,38146,69889,795,878,68,306,61621,13567
08,62000,0862000,Pueblo city, Colorado,1,2015,109419,39.20,77.30,17.50,55635,53784,81692,2983,1099,6397,0,51840,57579
08,77290,0877290,Thornton city, Colorado,1,2015,133459,43.70,70.20,8.60,65482,67977,115872,2776,5837,1810,83,84218,49241
08,83835,0883835,Westminster city, Colorado,1,2015,113117,42.70,80.00,14.00,54866,58251,96987,2198,7342,346,228,89762,23355
09,08000,0908000,Bridgeport city, Connecticut,1,2015,147619,45.50,76.60,10.30,71509,76110,62424,48203,5897,221,71,88583,59036
09,18430,0918430,Danbury city, Connecticut,1,2015,84662,46.60,81.50,13.70,43435,41227,52407,7058,6007,227,130,59517,25145
09,37000,0937000,Hartford city, Connecticut,1,2015,124014,48.80,76.20,10.00,58042,65972,42789,47143,3776,976,0,68055,55959
09,50370,0950370,New Britain city, Connecticut,1,2015,72809,43.70,75.20,11.50,37350,35459,53698,8255,1818,0,0,42621,30188
09,52000,0952000,New Haven city, Connecticut,1,2015,130310,54.00,77.10,8.90,63765,66545,53861,40251,6855,537,0,86747,43563
09,55990,0955990,Norwalk city, Connecticut,1,2015,88483,38.70,81.50,14.80,40880,47603,66738,14667,2583,48,0,63801,24682
09,73000,0973000,Stamford city, Connecticut,1,2015,128877,45.80,78.90,12.30,64941,63936,83375,21738,9889,0,0,95680,33197
09,80000,0980000,Waterbury city, Connecticut,1,2015,108807,42.30,75.70,12.30,52235,56572,66997,25345,3719,223,0,70585,38222
10,77580,1077580,Wilmington city, Delaware,1,2015,71957,41.70,76.80,12.90,32680,39277,22849,43346,1107,177,0,66441,5516
11,50000,1150000,Washington city, District of Columbia,1,2015,672228,51.50,82.50,11.40,319705,352523,269143,318831,25944,1661,475,601099,71129
12,00410,1200410,Alafaya CDP, Florida,0,2015,85264,49.60,74.50,10.60,39504,45760,62633,5979,9545,0,0,50367,34897
12,07300,1207300,Boca Raton city, Florida,1,2015,93226,35.00,84.10,23.80,44760,48466,78273,3915,1872,0,0,78491,14735
12,07875,1207875,Boynton Beach city, Florida,1,2015,73972,33.40,81.90,23.80,33701,40271,48986,19444,1886,42,0,61419,12553
12,08150,1208150,Brandon CDP, Florida,0,2015,113968,44.20,79.20,12.20,55679,58289,77700,21873,8661,221,0,87744,26224
12,10275,1210275,Cape Coral city, Florida,1,2015,175230,35.30,80.80,20.70,85626,89604,160971,6834,2313,134,0,142214,33016
12,12875,1212875,Clearwater city, Florida,1,2015,112979,34.50,83.10,23.40,55225,57754,95058,11469,2156,19,455,95768,17211
12,14400,1214400,Coral Springs city, Florida,1,2015,129502,41.30,72.60,10.10,63316,66186,87562,25860,5359,146,125,88685,40817
12,16475,1216475,Davie town, Florida,1,2015,100894,43.10,82.30,12.00,48754,52140,78456,10313,3912,247,341,65583,35311
12,16725,1216725,Deerfield Beach city, Florida,1,2015,79769,41.90,83.50,22.10,37155,42614,50932,23792,1073,52,54,67040,12729
12,17100,1217100,Delray Beach city, Florida,0,2015,66261,35.30,86.50,28.20,32219,34042,39939,20422,926,56,297,59864,6397
12,17200,1217200,Deltona city, Florida,1,2015,88474,37.40,77.00,16.70,44853,43621,72517,10597,390,0,0,57117,31357
12,24000,1224000,Fort Lauderdale city, Florida,1,2015,178587,36.40,80.10,17.10,93948,84639,106090,60732,3251,218,97,150439,28148
12,24125,1224125,Fort Myers city, Florida,0,2015,74015,40.40,80.80,18.40,36850,37165,48937,16783,3216,0,0,56149,17866
12,25175,1225175,Gainesville city, Florida,1,2015,130133,60.80,85.90,10.70,60803,69330,83842,29840,11202,466,119,117925,12208
12,30000,1230000,Hialeah city, Florida,1,2015,237082,38.00,81.60,19.70,111530,125552,219076,5100,1012,71,0,9574,227508
12,32000,1232000,Hollywood city, Florida,1,2015,149721,37.10,79.30,16.10,75358,74363,101663,29681,3555,371,108,96474,53247
12,32275,1232275,Homestead city, Florida,0,2015,66500,42.50,69.00,7.80,31401,35099,46807,16199,109,0,0,24590,41910
12,35000,1235000,Jacksonville city, Florida,1,2015,868031,42.00,76.70,12.70,419203,448828,518114,268763,39933,1220,1121,787967,80064
12,36100,1236100,Kendall CDP, Florida,0,2015,76466,43.90,82.70,16.50,36658,39808,69695,2429,3364,0,0,28945,47521
12,36950,1236950,Kissimmee city, Florida,0,2015,69152,45.20,77.70,11.70,33283,35869,49689,5684,2571,0,0,25032,44120
12,38250,1238250,Lakeland city, Florida,1,2015,104410,38.70,78.00,19.10,47840,56570,74187,23980,2872,216,0,87909,16501
12,39425,1239425,Largo city, Florida,1,2015,81007,33.70,82.40,22.80,38166,42841,70728,4406,2106,602,0,71446,9561
12,39550,1239550,Lauderhill city, Florida,1,2015,71574,41.60,76.80,14.40,32813,38761,9297,56591,998,179,0,65485,6089
12,39925,1239925,Lehigh Acres CDP, Florida,0,2015,119480,39.40,71.70,12.90,57856,61624,82392,27683,888,68,0,77388,42092
12,43975,1243975,Melbourne city, Florida,1,2015,80136,36.70,81.70,22.00,39180,40956,62581,9874,4145,34,0,74076,6060
12,45000,1245000,Miami city, Florida,1,2015,440989,42.00,82.90,17.00,215840,225149,331087,83318,2631,216,224,121047,319942
12,45025,1245025,Miami Beach city, Florida,1,2015,92311,41.90,85.70,17.30,48090,44221,70792,3503,2555,46,0,44865,47446
12,45060,1245060,Miami Gardens city, Florida,1,2015,113199,41.10,75.20,14.10,50719,62480,-998,-998,-998,-998,-998,89912,23287
12,45975,1245975,Miramar city, Florida,1,2015,137115,42.80,74.90,10.60,66157,70958,56441,63399,10844,72,0,90348,46767
12,53000,1253000,Orlando city, Florida,1,2015,270917,50.40,79.70,10.20,130940,139977,172492,63894,8734,929,0,181611,89306
12,54000,1254000,Palm Bay city, Florida,1,2015,107895,34.80,76.40,19.50,51767,56128,81888,19093,656,923,0,91054,16841
12,54200,1254200,Palm Coast city, Florida,1,2015,82121,30.30,80.70,29.10,39489,42632,65209,10183,2058,325,0,73415,8706
12,55775,1255775,Pembroke Pines city, Florida,1,2015,166624,39.90,79.20,15.70,77050,89574,110866,31573,11620,471,27,106105,60519
12,56825,1256825,Pine Hills CDP, Florida,0,2015,76081,46.20,69.90,9.20,35344,40737,9264,55689,2032,253,0,65585,10496
12,57425,1257425,Plantation city, Florida,1,2015,92555,35.60,78.40,16.00,42881,49674,65097,17927,2883,100,0,66154,26401
12,57900,1257900,Poinciana CDP, Florida,0,2015,73943,44.90,76.10,13.50,38142,35801,42780,23569,796,1187,0,36561,37382
12,58050,1258050,Pompano Beach city, Florida,1,2015,107771,36.70,80.20,21.20,56569,51202,64605,36879,1089,446,0,84546,23225
12,58715,1258715,Port St. Lucie city, Florida,1,2015,179410,36.30,77.80,20.10,84069,95341,132849,28856,4831,1254,0,145170,34240
12,60950,1260950,Riverview CDP, Florida,0,2015,89746,45.20,70.80,9.20,44210,45536,58136,14105,2241,152,0,66429,23317
12,63000,1263000,St. Petersburg city, Florida,1,2015,257088,39.20,81.20,17.60,123524,133564,173419,63792,9671,719,128,236605,20483
12,68350,1268350,Spring Hill CDP, Florida,0,2015,103197,33.70,80.20,23.80,48295,54902,89482,6813,1866,49,78,87359,15838
12,69700,1269700,Sunrise city, Florida,1,2015,92706,41.80,78.50,15.00,41471,51235,52759,32714,2929,0,0,63543,29163
12,70600,1270600,Tallahassee city, Florida,1,2015,189894,59.60,83.70,9.20,89390,100504,108384,65887,8354,204,101,176356,13538
12,71000,1271000,Tampa city, Florida,1,2015,369028,45.30,78.20,11.50,175517,193511,249668,86460,12609,855,0,273874,95154
12,71625,1271625,The Villages CDP, Florida,0,2015,-998,-999999999.00,-999999999.00,-999999999.00,-998,-998,-998,-998,-998,-998,-998,71524,1066
12,72145,1272145,Town 'n' Country CDP, Florida,0,2015,78996,43.30,79.80,14.20,39410,39586,62046,7477,3154,537,0,41052,37944
12,76582,1276582,Weston city, Florida,0,2015,69947,35.50,69.70,12.20,32956,36991,59988,3305,3843,83,38,33260,36687
12,76600,1276600,West Palm Beach city, Florida,1,2015,106782,41.90,81.80,17.00,49262,57520,59541,38472,2986,0,0,80650,26132
13,01052,1301052,Albany city, Georgia,1,2015,71109,41.70,75.60,12.80,31695,39414,16714,52909,461,340,4,69326,1783
13,03440,1303440,Athens-Clarke County unified government (balance), Georgia,1,2015,122563,57.70,82.60,9.70,57415,65148,77353,33239,4998,58,257,109404,13159
13,04000,1304000,Atlanta city, Georgia,1,2015,463875,51.20,82.10,11.80,223960,239915,189153,240599,20416,1303,463,445222,18653
13,04204,1304204,Augusta-Richmond County consolidated government (balance), Georgia,1,2015,196579,42.90,76.70,13.10,94662,101917,74229,110075,3770,469,0,187511,9068
13,19000,1319000,Columbus city, Georgia,1,2015,200579,44.30,75.80,12.30,98785,101794,90995,90408,4487,676,665,185399,15180
13,42425,1342425,Johns Creek city, Georgia,1,2015,83339,39.20,71.80,9.30,40282,43057,46676,10477,22769,531,0,77415,5924
13,49008,1349008,Macon-Bibb County, Georgia,0,2015,153459,39.40,75.10,14.40,71833,81626,63165,84206,2898,195,0,148562,4897
13,67284,1367284,Roswell city, Georgia,1,2015,94496,37.90,73.30,9.90,48637,45859,67622,14020,6440,462,0,77576,16920
13,68516,1368516,Sandy Springs city, Georgia,1,2015,105347,44.20,76.90,14.00,48570,56777,77402,14298,7298,1073,0,91677,13670
13,69000,1369000,Savannah city, Georgia,1,2015,145684,48.80,78.70,11.70,69389,76295,53948,79319,4881,848,0,135950,9734
13,80508,1380508,Warner Robins city, Georgia,1,2015,74002,43.70,72.50,10.60,35093,38909,39114,27651,2166,170,0,68624,5378
15,71550,1571550,Urban Honolulu CDP, Hawaii,0,2015,352766,41.00,83.90,19.10,176807,175959,67139,6660,193580,358,22750,328180,24586
16,08830,1608830,Boise City city, Idaho,1,2015,218280,44.90,76.20,11.80,110099,108181,197253,3227,6733,1375,124,198800,19480
16,52120,1652120,Meridian city, Idaho,1,2015,90753,35.50,72.50,16.70,43353,47400,83313,1809,2166,492,336,84157,6596
16,56260,1656260,Nampa city, Idaho,1,2015,89850,42.50,68.90,10.70,45651,44199,76866,238,721,676,694,67784,22066
17,02154,1702154,Arlington Heights village, Illinois,1,2015,76996,31.80,80.10,20.80,37627,39369,65211,1127,9019,46,117,74254,2742
17,03012,1703012,Aurora city, Illinois,1,2015,203715,44.80,69.40,7.70,101964,101751,112341,20846,15900,633,0,117062,86653
17,06613,1706613,Bloomington city, Illinois,1,2015,78295,45.20,77.90,12.50,37972,40323,59378,10421,5673,77,0,74834,3461
17,07133,1707133,Bolingbrook village, Illinois,1,2015,72096,44.10,72.80,9.00,36295,35801,38698,11770,8636,67,0,55192,16904
17,12385,1712385,Champaign city, Illinois,1,2015,86086,56.00,85.20,9.40,43326,42760,56335,15141,10804,55,0,82071,4015
01,07000,0107000,Birmingham city, Alabama,1,2016,213434,43.40,78.80,14.10,100602,112832,52557,152114,1429,490,0,205831,7603
01,21184,0121184,Dothan city, Alabama,0,2016,67714,37.80,76.50,16.90,32089,35625,41231,23682,977,201,0,65770,1944
01,35896,0135896,Hoover city, Alabama,1,2016,84943,41.00,74.50,14.80,40646,44297,60222,14217,5477,381,69,78520,6423
01,37000,0137000,Huntsville city, Alabama,1,2016,196225,41.60,76.50,14.60,96482,99743,118960,61834,5452,1148,250,183834,12391
01,50000,0150000,Mobile city, Alabama,1,2016,192895,43.00,79.90,16.60,92787,100108,89571,96103,3555,289,20,188007,4888
01,51000,0151000,Montgomery city, Alabama,1,2016,200024,42.00,76.50,13.60,94034,105990,66047,120280,5469,339,0,192750,7274
01,77256,0177256,Tuscaloosa city, Alabama,1,2016,99556,53.00,81.70,11.20,46721,52835,50247,45012,2518,34,0,97119,2437
02,03000,0203000,Anchorage municipality, Alaska,1,2016,298192,45.30,75.20,9.80,152882,145310,184841,16102,27142,23916,7669,271285,26907
04,04720,0404720,Avondale city, Arizona,1,2016,82875,44.70,71.90,9.90,41915,40960,52485,8007,3049,2811,142,40966,41909
04,10670,0410670,Casas Adobes CDP, Arizona,0,2016,70589,38.20,82.50,19.70,33958,36631,56299,1887,1930,949,0,48369,22220
04,12000,0412000,Chandler city, Arizona,1,2016,247459,43.70,74.50,10.50,123184,124275,192384,13397,21216,4798,93,196944,50515
04,23620,0423620,Flagstaff city, Arizona,0,2016,71455,60.10,83.10,8.30,35760,35695,56854,1804,2217,6074,163,57742,13713
04,27400,0427400,Gilbert town, Arizona,1,2016,237120,42.00,68.60,9.20,115040,122080,200099,9482,12422,1284,945,199843,37277
04,27820,0427820,Glendale city, Arizona,1,2016,245849,42.30,76.20,12.00,121450,124399,191090,18925,9289,3923,0,154977,90872
04,28380,0428380,Goodyear city, Arizona,0,2016,77266,38.70,73.30,14.10,37699,39567,54820,8683,2706,657,230,56546,20720
04,46000,0446000,Mesa city, Arizona,1,2016,484622,40.80,75.50,16.30,238380,246242,394155,18359,9735,16166,3037,353981,130641
04,54050,0454050,Peoria city, Arizona,1,2016,164198,35.70,76.30,17.40,80214,83984,139418,6083,7115,537,142,136133,28065
04,55000,0455000,Phoenix city, Arizona,1,2016,1615041,43.80,73.00,10.40,801784,813257,1094662,105572,62518,31693,2728,907949,707092
04,64210,0464210,San Tan Valley CDP, Arizona,0,2016,82911,38.30,73.30,15.80,42051,40860,70508,4109,4352,434,117,64818,18093
04,65000,0465000,Scottsdale city, Arizona,1,2016,246646,33.50,84.30,24.20,120633,126013,220371,2391,11301,1219,76,222578,24068
04,71510,0471510,Surprise city, Arizona,1,2016,132673,33.20,75.00,23.20,63627,69046,111199,7564,4623,72,399,109170,23503
04,73000,0473000,Tempe city, Arizona,1,2016,182499,57.20,86.20,10.40,94223,88276,120498,15599,16777,3728,646,148935,33564
04,77000,0477000,Tucson city, Arizona,1,2016,530690,45.60,78.40,13.80,262581,268109,392894,26295,16571,13520,722,300817,229873
04,85540,0485540,Yuma city, Arizona,1,2016,94892,42.20,73.00,14.70,48650,46242,61744,3292,1777,1359,266,39118,55774
05,15190,0515190,Conway city, Arkansas,0,2016,65300,53.10,79.70,9.40,31768,33532,48156,10539,1265,121,0,61936,3364
05,23290,0523290,Fayetteville city, Arkansas,1,2016,83823,58.20,81.10,7.90,41617,42206,67038,5397,2611,1366,66,75754,8069
05,24550,0524550,Fort Smith city, Arkansas,1,2016,88122,38.60,75.70,16.60,42688,45434,57405,8593,5547,764,74,71436,16686
05,35710,0535710,Jonesboro city, Arkansas,1,2016,74892,44.20,76.50,13.80,36521,38371,54712,15121,1358,0,0,70634,4258
05,41000,0541000,Little Rock city, Arkansas,1,2016,198546,41.40,77.30,14.30,95972,102574,102531,77802,5169,326,0,183219,15327
05,50450,0550450,North Little Rock city, Arkansas,0,2016,66273,44.50,74.60,10.50,31569,34704,-998,-998,-998,-998,-998,62618,3655
05,60410,0560410,Rogers city, Arkansas,0,2016,65016,39.50,69.50,9.90,32030,32986,59523,1069,1041,356,0,43129,21887
05,66080,0566080,Springdale city, Arkansas,1,2016,81799,41.00,67.90,9.30,42048,39751,47888,3265,2010,471,6207,53406,28393
06,00562,0600562,Alameda city, California,1,2016,78907,35.70,79.30,15.50,39227,39680,37670,7688,23696,96,29,69143,9764
06,00884,0600884,Alhambra city, California,1,2016,85465,39.80,81.90,18.10,41638,43827,16749,2515,47433,755,0,57093,28372
06,02000,0602000,Anaheim city, California,1,2016,351066,43.20,74.70,11.60,166967,184099,248856,8350,57839,2315,2128,159206,191860
06,02252,0602252,Antioch city, California,1,2016,110876,39.80,74.60,11.80,51706,59170,43646,28153,11206,463,79,79662,31214
06,02364,0602364,Apple Valley town, California,1,2016,72542,39.50,75.10,16.00,36258,36284,56214,9088,1470,942,67,44695,27847
06,02553,0602553,Arden-Arcade CDP, California,0,2016,106061,38.50,75.70,16.60,49127,56934,64431,11253,7406,164,63,84471,21590
06,03526,0603526,Bakersfield city, California,1,2016,376371,44.30,70.00,9.50,185146,191225,239824,24364,30417,4766,912,186319,190052
06,03666,0603666,Baldwin Park city, California,1,2016,76465,45.30,75.10,10.70,40145,36320,20991,1504,15073,1454,0,18283,58182
06,04982,0604982,Bellflower city, California,1,2016,77789,41.50,74.80,12.00,36731,41058,24932,8343,8732,357,37,30306,47483
06,06000,0606000,Berkeley city, California,1,2016,121241,55.70,86.20,13.40,57788,63453,72306,11953,24133,362,512,110722,10519
06,08786,0608786,Buena Park city, California,1,2016,83148,44.00,79.70,13.70,40769,42379,40928,2738,21345,1034,838,46174,36974
06,08954,0608954,Burbank city, California,1,2016,104451,41.70,80.90,17.70,51931,52520,71897,3676,12783,602,55,82681,21770
06,10046,0610046,Camarillo city, California,0,2016,67345,37.20,79.70,19.50,31155,36190,51928,1496,7161,221,0,51220,16125
06,11194,0611194,Carlsbad city, California,1,2016,113957,34.80,75.80,14.60,53554,60403,95906,1407,7557,70,547,102319,11638
06,11390,0611390,Carmichael CDP, California,0,2016,63064,36.90,78.50,18.20,29193,33871,48970,4276,3548,236,209,56558,6506
06,11530,0611530,Carson city, California,1,2016,92821,41.40,78.80,16.50,44748,48073,23205,23764,24058,254,2413,57850,34971
06,11964,0611964,Castro Valley CDP, California,0,2016,65153,36.80,78.60,18.10,32024,33129,37216,5965,15544,741,232,56808,8345
06,13014,0613014,Chico city, California,1,2016,91545,52.60,80.30,11.90,44558,46987,76753,2661,3313,489,279,76285,15260
06,13210,0613210,Chino city, California,1,2016,87771,44.30,80.30,13.00,52211,35560,44796,5269,10427,229,99,43822,43949
06,13214,0613214,Chino Hills city, California,1,2016,78821,42.20,76.70,11.00,38218,40603,36849,2384,26435,688,85,54773,24048
06,13392,0613392,Chula Vista city, California,1,2016,267169,41.50,75.40,13.10,132477,134692,179666,9150,40423,1018,2465,108016,159153
06,13588,0613588,Citrus Heights city, California,1,2016,87444,40.70,79.70,15.60,41476,45968,73250,2497,4085,340,0,66475,20969
06,14218,0614218,Clovis city, California,1,2016,106587,42.20,72.20,12.00,54097,52490,72172,3098,11440,467,0,76036,30551
06,15044,0615044,Compton city, California,1,2016,97537,42.80,69.90,9.80,47768,49769,36973,26965,930,458,0,29125,68412
06,16000,0616000,Concord city, California,1,2016,128728,41.20,78.20,13.90,64231,64497,78768,5744,15504,510,1050,92817,35911
06,16350,0616350,Corona city, California,1,2016,166774,45.00,77.80,10.40,83486,83288,109979,6685,21124,1021,1330,96913,69861
06,16532,0616532,Costa Mesa city, California,1,2016,112825,48.30,79.30,9.50,56137,56688,86172,1847,8722,501,959,62783,50042
06,17918,0617918,Daly City city, California,1,2016,106484,41.90,83.70,16.30,53497,52987,18424,2283,69028,613,1756,87824,18660
06,18100,0618100,Davis city, California,0,2016,68107,58.30,83.70,11.00,32321,35786,44250,1871,14989,0,388,57998,10109
06,19766,0619766,Downey city, California,1,2016,113267,45.60,73.90,10.30,55551,57716,74414,3145,11489,388,62,29995,83272
06,20802,0620802,East Los Angeles CDP, California,0,2016,127804,45.70,71.60,9.90,64309,63495,46625,367,1258,501,0,5693,122111
06,21712,0621712,El Cajon city, California,1,2016,103769,37.10,70.00,11.80,51470,52299,68209,6248,2519,1720,130,72266,31503
06,22020,0622020,Elk Grove city, California,1,2016,169780,40.70,72.50,11.90,79893,89887,80768,14473,48940,1000,3116,138238,31542
06,22230,0622230,El Monte city, California,1,2016,115800,42.20,75.70,12.70,58900,56900,39737,878,35524,993,420,41456,74344
06,22804,0622804,Escondido city, California,1,2016,151594,43.90,74.90,10.40,76570,75024,112916,4943,12268,2450,1209,70980,80614
06,23182,0623182,Fairfield city, California,1,2016,114757,41.20,75.30,12.80,55719,59038,53856,19644,16835,316,973,78789,35968
06,24477,0624477,Florence-Graham CDP, California,0,2016,63582,47.30,68.10,7.40,32692,30890,-998,-998,-998,-998,-998,4947,58635
06,24638,0624638,Folsom city, California,1,2016,77278,33.60,73.90,12.80,40958,36320,54490,2047,12476,523,251,66987,10291
06,24680,0624680,Fontana city, California,1,2016,209659,45.40,71.60,8.40,101136,108523,92451,14015,14651,1502,1143,64405,145254
06,26000,0626000,Fremont city, California,1,2016,233145,43.70,75.60,11.90,115775,117370,53272,8830,136066,853,2245,201250,31895
06,27000,0627000,Fresno city, California,1,2016,522021,43.90,71.70,11.00,253511,268510,313249,39537,76526,5854,982,264562,257459
06,28000,0628000,Fullerton city, California,1,2016,140734,44.40,78.90,12.90,70350,70384,76843,3838,35250,395,144,90984,49750
06,29000,0629000,Garden Grove city, California,1,2016,174877,42.70,77.00,11.90,89076,85801,68506,2518,73572,899,233,112490,62387
06,30000,0630000,Glendale city, California,1,2016,200826,39.90,81.60,17.10,97089,103737,148856,3623,30555,36,214,165142,35684
06,32548,0632548,Hawthorne city, California,1,2016,88032,45.70,73.00,9.60,42406,45626,25100,19413,5058,376,438,35626,52406
06,33000,0633000,Hayward city, California,1,2016,158969,44.60,78.60,11.40,78456,80513,70470,11846,40554,1039,4808,92499,66470
06,33182,0633182,Hemet city, California,1,2016,84277,30.20,71.30,22.70,41626,42651,60621,8418,3436,1587,646,52817,31460
06,33434,0633434,Hesperia city, California,1,2016,93714,42.90,73.30,10.90,48133,45581,79105,3386,1308,1197,420,38941,54773
06,36000,0636000,Huntington Beach city, California,1,2016,200631,35.70,80.70,18.30,101810,98821,145875,4115,22652,789,1319,164034,36597
06,36448,0636448,Indio city, California,1,2016,88484,36.40,76.30,20.60,42676,45808,43621,3121,2977,713,0,31355,57129
06,36546,0636546,Inglewood city, California,1,2016,110667,43.90,80.10,12.40,52270,58397,23175,50426,2757,1190,317,59819,50848
06,36770,0636770,Irvine city, California,1,2016,266117,45.80,77.30,9.90,129927,136190,128156,2985,115156,79,1280,235819,30298
06,37692,0637692,Jurupa Valley city, California,0,2016,103543,42.50,74.00,10.50,51792,51751,55876,2697,3220,562,164,28403,75140
06,39248,0639248,Laguna Niguel city, California,0,2016,65328,34.40,79.70,17.30,31542,33786,50567,1038,6464,0,63,53060,12268
06,39496,0639496,Lake Forest city, California,1,2016,83236,41.20,79.40,13.40,41675,41561,57897,2422,14035,774,50,66485,16751
06,39892,0639892,Lakewood city, California,1,2016,81121,42.50,75.00,12.20,39022,42099,35226,7879,18132,191,332,53690,27431
06,40130,0640130,Lancaster city, California,1,2016,160107,42.20,73.30,9.90,78409,81698,98986,33008,8726,744,144,96941,63166
06,41992,0641992,Livermore city, California,1,2016,89118,35.80,77.50,12.50,43739,45379,67091,784,10518,197,697,70354,18764
06,43000,0643000,Long Beach city, California,1,2016,470140,45.90,76.60,10.50,230993,239147,236983,59157,58987,3466,4459,260992,209148
06,44000,0644000,Los Angeles city, California,1,2016,3976324,45.90,79.20,12.10,1960672,2015652,2079698,350543,452848,26861,5687,2031566,1944758
06,44574,0644574,Lynwood city, California,1,2016,71184,49.80,69.90,6.80,34824,36360,46024,5908,440,912,849,8908,62276
06,45484,0645484,Manteca city, California,1,2016,76912,39.20,73.30,11.50,36517,40395,53169,3478,5691,951,605,45720,31192
06,46842,0646842,Menifee city, California,1,2016,88510,37.80,75.20,19.80,42767,45743,53175,6773,7407,8,24,57846,30664
06,46898,0646898,Merced city, California,1,2016,82573,48.10,68.60,8.30,42890,39683,46295,6249,9445,348,0,38674,43899
06,47766,0647766,Milpitas city, California,1,2016,77534,43.30,78.80,11.90,39196,38338,7132,2404,57667,179,235,67256,10278
06,48256,0648256,Mission Viejo city, California,1,2016,96386,35.90,78.80,18.40,48808,47578,78098,629,10790,117,273,80517,15869
06,48354,0648354,Modesto city, California,1,2016,212172,40.00,72.80,13.40,105436,106736,151280,10282,15051,1315,1326,127910,84262
06,49270,0649270,Moreno Valley city, California,1,2016,205516,46.60,70.30,7.40,98619,106897,61766,37136,12067,411,1030,86581,118935
06,49670,0649670,Mountain View city, California,1,2016,80459,49.80,79.40,11.10,42117,38342,41580,1620,23434,718,933,64983,15476
06,50076,0650076,Murrieta city, California,1,2016,111682,41.00,71.90,11.40,55717,55965,68812,4585,12427,1550,1093,77562,34120
06,50258,0650258,Napa city, California,1,2016,80412,37.80,77.00,18.00,38320,42092,67757,333,2504,672,0,49519,30893
55,48000,5548000,Madison city, Wisconsin,1,2016,252557,54.90,84.20,11.60,123627,128930,199966,15656,22813,1852,198,237680,14877
55,53000,5553000,Milwaukee city, Wisconsin,1,2016,595070,46.10,73.70,9.60,286000,309070,259589,229503,26295,2533,35,484034,111036
55,60500,5560500,Oshkosh city, Wisconsin,0,2016,66570,49.80,83.30,12.80,34509,32061,61088,2685,1673,220,0,64415,2155
55,66000,5566000,Racine city, Wisconsin,1,2016,77572,42.50,72.40,13.10,38466,39106,49635,17860,756,398,0,59995,17577
55,84250,5584250,Waukesha city, Wisconsin,1,2016,72358,44.80,77.20,14.20,33576,38782,61904,4394,2502,321,99,65841,6517
72,10334,7210334,Caguas zona urbana, Puerto Rico,0,2016,75619,39.50,80.10,20.50,34391,41228,57610,6044,0,38,0,1188,74431
72,14290,7214290,Carolina zona urbana, Puerto Rico,0,2016,141984,38.80,80.50,21.00,65138,76846,71270,33944,190,3617,0,1407,140577
72,32522,7232522,Guaynabo zona urbana, Puerto Rico,0,2016,70097,38.10,81.80,19.30,32034,38063,54848,3396,40,0,0,1170,68927
72,63820,7263820,Ponce zona urbana, Puerto Rico,0,2016,117185,37.70,79.40,21.40,55747,61438,92457,5228,0,0,0,1128,116057
72,76770,7276770,San Juan zona urbana, Puerto Rico,0,2016,333149,37.80,81.20,21.30,151706,181443,221408,47300,860,1073,104,7357,325792
06,51182,0651182,Newport Beach city, California,1,2016,86683,35.60,82.50,22.60,40251,46432,74633,632,8327,81,0,80319,6364
06,52526,0652526,Norwalk city, California,1,2016,106161,42.80,75.50,12.20,52947,53214,41530,7134,13786,363,92,36452,69709
06,53000,0653000,Oakland city, California,1,2016,419987,46.60,80.30,12.70,207048,212939,145374,98666,69038,4168,2201,310225,109762
06,53322,0653322,Oceanside city, California,1,2016,175441,39.30,77.80,16.70,85108,90333,136832,7395,12334,525,1685,110905,64536
06,53896,0653896,Ontario city, California,1,2016,173211,45.00,73.50,9.30,82758,90453,83833,12635,9731,1099,407,51199,122012
06,53980,0653980,Orange city, California,1,2016,140507,43.90,77.60,12.00,70235,70272,102293,2424,15032,943,385,85397,55110
06,54652,0654652,Oxnard city, California,1,2016,207911,43.60,71.50,10.00,103872,104039,158819,5260,13889,2201,267,53750,154161
06,55156,0655156,Palmdale city, California,1,2016,157349,40.60,68.70,8.80,76867,80482,71900,15724,6942,942,105,63102,94247
06,55282,0655282,Palo Alto city, California,0,2016,67021,33.80,79.90,21.00,33449,33572,43085,450,19438,442,61,63167,3854
06,56000,0656000,Pasadena city, California,1,2016,142052,43.50,82.50,15.50,67415,74637,75089,14552,24071,1725,615,92299,49753
06,56700,0656700,Perris city, California,1,2016,76330,48.90,67.80,6.10,36119,40211,23023,8299,3460,1224,0,17767,58563
06,57456,0657456,Pittsburg city, California,0,2016,70677,41.70,73.10,10.80,35895,34782,29015,8648,11345,5,174,37472,33205
06,57792,0657792,Pleasanton city, California,1,2016,82267,32.80,74.30,14.40,39515,42752,46131,2266,30105,162,0,75083,7184
06,58072,0658072,Pomona city, California,1,2016,152476,47.50,74.20,8.00,77504,74972,69891,8562,14262,5099,140,40273,112203
06,59444,0659444,Rancho Cordova city, California,0,2016,72319,43.50,75.20,12.50,37148,35171,45383,6107,8372,142,761,56799,15520
06,59451,0659451,Rancho Cucamonga city, California,1,2016,176540,44.80,77.10,10.50,88004,88536,107626,19228,22079,809,1130,112093,64447
06,59920,0659920,Redding city, California,1,2016,91797,39.10,78.10,18.80,45187,46610,77609,1213,5169,1752,9,83141,8656
06,59962,0659962,Redlands city, California,1,2016,71288,43.60,77.10,15.90,31218,40070,53425,1939,5014,414,134,45899,25389
06,60018,0660018,Redondo Beach city, California,1,2016,67863,35.60,81.60,15.00,34330,33533,50007,2764,8945,486,3,58536,9327
06,60102,0660102,Redwood City city, California,1,2016,84965,45.20,79.50,11.40,42616,42349,50107,690,12462,965,700,49929,35036
06,60466,0660466,Rialto city, California,1,2016,103300,46.70,70.60,8.20,53405,49895,61274,10387,1672,597,0,22954,80346
06,60620,0660620,Richmond city, California,1,2016,109814,43.80,77.40,13.30,53965,55849,53631,19122,17538,85,76,60424,49390
06,62000,0662000,Riverside city, California,1,2016,324727,47.60,75.70,10.40,160990,163737,181923,23186,20389,2330,259,158963,165764
06,62938,0662938,Roseville city, California,1,2016,132683,37.50,76.30,17.40,62589,70094,102160,1954,12815,1250,260,112823,19860
06,64000,0664000,Sacramento city, California,1,2016,495200,44.80,77.50,13.30,245235,249965,244964,66288,91000,4388,7963,353649,141551
06,64224,0664224,Salinas city, California,1,2016,157224,47.50,70.00,8.60,77670,79554,54427,2747,11606,909,102,34021,123203
06,65000,0665000,San Bernardino city, California,1,2016,216242,45.00,68.60,8.40,106167,110075,121909,32249,10983,1708,206,74415,141827
06,65042,0665042,San Buenaventura (Ventura) city, California,1,2016,109591,39.20,79.50,17.00,55721,53870,89654,1394,4480,1684,40,68312,41279
06,65084,0665084,San Clemente city, California,0,2016,65304,32.00,78.10,18.30,30637,34667,52091,573,2416,643,291,54229,11075
06,66000,0666000,San Diego city, California,1,2016,1406622,48.10,80.20,12.30,711531,695091,935881,89910,240027,5664,5072,984657,421965
06,67000,0667000,San Francisco city, California,1,2016,870887,48.40,86.50,14.90,443777,427110,404410,43468,300409,3054,1967,738349,132538
06,68000,0668000,San Jose city, California,1,2016,1025373,43.40,77.00,11.50,520732,504641,400984,30624,357891,4424,6628,696394,328979
06,68084,0668084,San Leandro city, California,1,2016,90460,35.10,80.70,17.70,42568,47892,35510,9636,29463,1089,508,66242,24218
06,68196,0668196,San Marcos city, California,1,2016,95268,40.10,70.60,11.70,47655,47613,67422,3962,9620,1915,867,61516,33752
06,68252,0668252,San Mateo city, California,1,2016,103959,42.80,79.50,16.00,51405,52554,55915,2147,22635,599,2076,77660,26299
06,68378,0668378,San Ramon city, California,1,2016,75643,39.40,73.50,9.80,38178,37465,35078,2026,34798,401,0,70261,5382
06,69000,0669000,Santa Ana city, California,1,2016,334236,47.30,73.00,8.40,171235,163001,149298,2913,39981,1598,549,75981,258255
06,69070,0669070,Santa Barbara city, California,1,2016,91940,41.80,81.70,19.10,45690,46250,74892,1298,3486,1169,0,59043,32897
06,69084,0669084,Santa Clara city, California,1,2016,125938,51.50,79.10,10.90,64954,60984,53870,4430,49727,289,238,104640,21298
06,69088,0669088,Santa Clarita city, California,1,2016,181960,39.00,78.30,13.10,91373,90587,130934,6494,18572,1948,20,126213,55747
06,69196,0669196,Santa Maria city, California,1,2016,106286,44.50,69.80,11.10,52194,54092,83479,1286,7730,279,0,28987,77299
06,70000,0670000,Santa Monica city, California,1,2016,92478,44.00,86.40,17.70,46235,46243,73477,2250,8219,440,86,75778,16700
06,70098,0670098,Santa Rosa city, California,1,2016,175143,38.40,77.60,17.00,84354,90789,114932,5279,10484,2404,1270,121831,53312
06,72016,0672016,Simi Valley city, California,1,2016,126327,38.80,78.60,14.30,61516,64811,97981,2096,12600,633,144,94639,31688
06,73080,0673080,South Gate city, California,1,2016,95537,45.00,72.00,10.00,46708,48829,64017,410,284,586,142,4321,91216
06,73262,0673262,South San Francisco city, California,0,2016,66989,42.80,79.90,14.40,33567,33422,24223,1075,24498,23,1051,43680,23309
06,75000,0675000,Stockton city, California,1,2016,307057,41.60,71.90,12.40,151495,155562,136363,39316,66560,3022,2151,181435,125622
06,77000,0677000,Sunnyvale city, California,1,2016,152762,46.20,77.80,11.70,78330,74432,63833,2494,66240,953,285,122136,30626
06,78120,0678120,Temecula city, California,1,2016,113062,40.10,71.10,9.50,55913,57149,71438,8304,9455,365,337,80543,32519
06,78582,0678582,Thousand Oaks city, California,1,2016,128915,34.50,79.70,17.80,63203,65712,106089,1101,14777,474,286,108347,20568
06,80000,0680000,Torrance city, California,1,2016,147185,38.90,78.80,15.30,70849,76336,69906,4948,54364,319,653,120904,26281
06,80238,0680238,Tracy city, California,1,2016,89263,42.50,72.10,10.00,43458,45805,51226,3765,15052,503,1339,55479,33784
06,80812,0680812,Turlock city, California,1,2016,72808,41.20,76.70,15.40,34547,38261,57912,1407,4196,1125,158,47230,25578
06,80854,0680854,Tustin city, California,1,2016,80379,47.70,76.60,10.20,41576,38803,35186,1472,19695,169,1162,51089,29290
06,81204,0681204,Union City city, California,1,2016,75316,46.10,81.50,14.10,38735,36581,16836,2778,39650,230,1419,60143,15173
06,81344,0681344,Upland city, California,1,2016,76691,39.50,80.50,16.40,37065,39626,53042,5090,6363,472,207,47180,29511
06,81554,0681554,Vacaville city, California,1,2016,98308,40.10,76.50,13.40,50995,47313,60740,10155,8846,603,360,76309,21999
06,81666,0681666,Vallejo city, California,1,2016,121316,40.00,79.10,15.40,59409,61907,40261,26114,29449,317,2153,90145,31171
06,82590,0682590,Victorville city, California,1,2016,122283,42.50,67.90,9.50,60420,61863,78220,24650,3893,546,0,59176,63107
06,82954,0682954,Visalia city, California,1,2016,131069,39.00,68.70,11.90,61182,69887,103706,1665,12008,2453,295,61190,69879
06,82996,0682996,Vista city, California,1,2016,101665,45.80,74.50,8.10,52999,48666,85006,2289,4431,332,69,46008,55657
06,83346,0683346,Walnut Creek city, California,0,2016,69127,36.00,83.80,28.30,31694,37433,53933,577,9241,91,48,61770,7357
06,84200,0684200,West Covina city, California,1,2016,107840,41.30,76.30,13.50,53779,54061,30418,4681,30627,380,559,49984,57856
06,84550,0684550,Westminster city, California,1,2016,91565,36.50,79.40,17.10,45740,45825,35773,853,42497,299,469,67953,23612
06,85292,0685292,Whittier city, California,1,2016,86892,41.10,74.90,13.40,42597,44295,44813,1695,4932,312,0,29298,57594
06,86832,0686832,Yorba Linda city, California,0,2016,68236,34.20,73.60,17.40,33150,35086,46904,640,14797,51,0,53980,14256
06,86972,0686972,Yuba City city, California,0,2016,66837,41.20,74.20,14.10,33083,33754,43391,1492,13501,495,331,49579,17258
08,03455,0803455,Arvada city, Colorado,1,2016,117308,40.20,78.40,15.80,58445,58863,106813,1123,2928,1249,59,100295,17013
08,04000,0804000,Aurora city, Colorado,1,2016,362249,44.70,74.40,10.60,178536,183713,213117,55030,22319,2724,1540,258290,103959
08,07850,0807850,Boulder city, Colorado,1,2016,108108,59.10,87.40,9.80,55989,52119,95279,1316,5517,206,86,96085,12023
08,09280,0809280,Broomfield city, Colorado,0,2016,66529,41.50,76.50,12.90,32659,33870,57480,727,3943,316,0,58387,8142
08,12815,0812815,Centennial city, Colorado,1,2016,109935,34.50,78.20,16.80,55779,54156,95313,3127,4447,743,198,99762,10173
08,16000,0816000,Colorado Springs city, Colorado,1,2016,465084,43.70,75.80,12.80,234287,230797,366682,31193,12345,2488,1567,383920,81164
08,20000,0820000,Denver city, Colorado,1,2016,693060,49.30,79.70,11.20,347500,345560,522284,68262,25721,5462,410,483719,209341
08,27425,0827425,Fort Collins city, Colorado,1,2016,164196,54.80,80.10,10.10,81237,82959,143235,3026,5131,1333,292,142098,22098
08,32155,0832155,Greeley city, Colorado,1,2016,104003,46.00,75.70,11.50,51415,52588,94714,1707,2340,455,0,64711,39292
08,36410,0836410,Highlands Ranch CDP, Colorado,0,2016,112436,38.40,72.40,10.10,56007,56429,95886,1129,9537,773,89,103688,8748
08,43000,0843000,Lakewood city, Colorado,1,2016,154368,42.10,80.90,15.50,75011,79357,138065,2540,5603,1004,100,118846,35522
08,45970,0845970,Longmont city, Colorado,1,2016,92813,39.30,75.50,14.70,43455,49358,84206,816,3569,604,123,67253,25560
08,46465,0846465,Loveland city, Colorado,1,2016,76906,35.80,79.20,17.90,39208,37698,71344,291,733,916,81,68995,7911
08,62000,0862000,Pueblo city, Colorado,1,2016,110295,39.30,77.70,17.00,55276,55019,83387,3517,1014,6608,127,52331,57964
08,77290,0877290,Thornton city, Colorado,1,2016,136690,43.40,73.40,8.90,68659,68031,118495,2599,6417,1015,0,94229,42461
08,83835,0883835,Westminster city, Colorado,1,2016,113865,40.10,74.70,12.70,56405,57460,92803,3927,7283,1601,88,84891,28974
09,08000,0908000,Bridgeport city, Connecticut,1,2016,145934,46.00,77.00,10.70,71174,74760,63324,51009,3536,1202,0,88385,57549
09,18430,0918430,Danbury city, Connecticut,1,2016,85008,40.10,78.20,14.80,43845,41163,54757,8452,6202,332,116,60728,24280
09,37000,0937000,Hartford city, Connecticut,1,2016,123287,47.10,74.50,10.00,60325,62962,42525,42736,2764,247,0,63827,59460
09,50370,0950370,New Britain city, Connecticut,1,2016,72570,41.40,78.20,15.00,36344,36226,52632,7720,1696,44,0,40821,31749
09,52000,0952000,New Haven city, Connecticut,1,2016,129939,49.00,77.50,10.00,60037,69902,60133,40573,6652,510,41,87832,42107
09,55990,0955990,Norwalk city, Connecticut,1,2016,88440,40.00,77.80,14.60,41002,47438,64977,11342,6834,443,208,68429,20011
09,73000,0973000,Stamford city, Connecticut,1,2016,129105,43.50,79.30,13.20,65050,64055,80424,22345,10017,460,0,90187,38918
09,80000,0980000,Waterbury city, Connecticut,1,2016,108269,42.70,74.60,11.60,49818,58451,68233,21850,3188,155,118,67615,40654
10,77580,1077580,Wilmington city, Delaware,1,2016,71455,41.80,76.00,13.00,33567,37888,22212,43011,1310,63,0,62501,8954
11,50000,1150000,Washington city, District of Columbia,1,2016,681170,51.30,82.30,11.60,323591,357579,277268,320554,26436,2004,41,606748,74422
12,00410,1200410,Alafaya CDP, Florida,0,2016,91779,44.70,72.00,7.90,43731,48048,66206,13485,5288,0,0,60013,31766
12,07300,1207300,Boca Raton city, Florida,1,2016,96115,30.30,85.10,29.20,46552,49563,84286,2914,4035,269,0,85648,10467
12,07875,1207875,Boynton Beach city, Florida,1,2016,75569,36.70,81.90,19.30,32846,42723,49512,21773,1285,79,53,64983,10586
12,08150,1208150,Brandon CDP, Florida,0,2016,109582,43.40,78.10,11.80,54881,54701,81669,14703,4657,138,0,77821,31761
12,10275,1210275,Cape Coral city, Florida,1,2016,179795,31.90,81.50,21.50,88291,91504,162071,5054,3202,175,0,139166,40629
12,12875,1212875,Clearwater city, Florida,1,2016,114351,33.20,79.40,21.00,55886,58465,92415,10781,2166,280,149,95584,18767
12,14400,1214400,Coral Springs city, Florida,1,2016,130046,39.20,73.50,11.90,62166,67880,85468,28439,6156,311,68,97865,32181
12,16475,1216475,Davie town, Florida,1,2016,101857,41.90,78.00,13.00,49872,51985,69740,10194,8685,234,336,64154,37703
12,16525,1216525,Daytona Beach city, Florida,0,2016,66649,40.00,83.40,22.80,33120,33529,38702,23397,1309,204,0,60175,6474
12,16725,1216725,Deerfield Beach city, Florida,1,2016,79754,35.70,79.60,20.60,36737,43017,46998,26511,1189,391,0,66689,13065
12,17100,1217100,Delray Beach city, Florida,0,2016,67366,34.00,84.70,25.00,32199,35167,42475,19339,2913,92,0,60266,7100
12,17200,1217200,Deltona city, Florida,1,2016,90139,39.40,78.50,16.10,41338,48801,72090,10298,1670,0,0,60372,29767
12,24000,1224000,Fort Lauderdale city, Florida,1,2016,178764,40.60,82.10,16.70,93835,84929,108667,57749,2902,1520,0,147924,30840
12,24125,1224125,Fort Myers city, Florida,0,2016,77154,34.10,79.60,21.60,37460,39694,49630,20489,964,76,129,59415,17739
12,25175,1225175,Gainesville city, Florida,1,2016,131593,61.20,87.40,10.90,60991,70602,90494,24746,8732,926,524,114935,16658
12,30000,1230000,Hialeah city, Florida,1,2016,236385,37.30,82.80,20.50,109811,126574,216869,6586,646,0,97,9573,226812
12,32000,1232000,Hollywood city, Florida,1,2016,152007,36.00,81.70,18.40,74256,77751,108508,25053,2427,36,216,93374,58633
12,32275,1232275,Homestead city, Florida,0,2016,68000,43.30,62.10,7.40,35896,32104,-998,-998,-998,-998,-998,26470,41530
12,35000,1235000,Jacksonville city, Florida,1,2016,880623,42.00,76.90,13.00,426712,453911,519739,269312,38812,1804,453,798265,82358
12,36100,1236100,Kendall CDP, Florida,0,2016,77619,36.40,79.90,19.80,38130,39489,67812,2795,3423,0,0,23930,53689
12,36950,1236950,Kissimmee city, Florida,0,2016,69369,48.10,75.30,12.00,31774,37595,45062,10427,2616,0,0,22977,46392
12,38250,1238250,Lakeland city, Florida,1,2016,106419,37.90,80.00,22.10,51505,54914,74885,22361,4378,89,126,91198,15221
12,39425,1239425,Largo city, Florida,1,2016,83077,31.00,85.00,27.00,38420,44657,74247,3590,1407,429,278,76788,6289
12,39550,1239550,Lauderhill city, Florida,1,2016,71635,41.40,70.50,10.90,31512,40123,10777,58194,551,117,0,65746,5889
12,39925,1239925,Lehigh Acres CDP, Florida,0,2016,115673,42.60,71.60,10.30,57436,58237,85529,19878,1347,151,0,74615,41058
12,43975,1243975,Melbourne city, Florida,1,2016,81192,36.50,82.50,20.50,40647,40545,66039,6398,2446,418,0,72155,9037
12,45000,1245000,Miami city, Florida,1,2016,453584,42.00,82.60,17.60,223068,230516,354046,71010,4225,2049,470,119714,333870
12,45025,1245025,Miami Beach city, Florida,1,2016,91905,41.00,86.20,16.80,50744,41161,61538,3352,2101,0,359,38340,53565
12,45060,1245060,Miami Gardens city, Florida,1,2016,113045,40.00,78.20,14.00,54855,58190,27551,80596,643,297,0,85015,28030
12,45975,1245975,Miramar city, Florida,1,2016,138461,46.60,79.80,10.20,66968,71493,59449,63479,6993,105,0,91456,47005
12,53000,1253000,Orlando city, Florida,1,2016,277198,49.90,79.20,9.80,136663,140535,171406,66863,16538,325,0,193345,83853
12,54000,1254000,Palm Bay city, Florida,1,2016,110107,36.90,80.20,19.00,52709,57398,80018,22943,2169,69,0,95901,14206
12,54200,1254200,Palm Coast city, Florida,1,2016,88337,31.00,81.50,28.50,42031,46306,71957,11091,2013,0,0,77509,10828
12,55775,1255775,Pembroke Pines city, Florida,1,2016,168587,40.70,81.20,16.50,78280,90307,119719,29914,6724,190,36,90981,77606
12,56825,1256825,Pine Hills CDP, Florida,0,2016,76048,39.30,72.70,12.20,36147,39901,11873,53534,1620,0,0,66411,9637
12,57425,1257425,Plantation city, Florida,1,2016,92717,40.60,80.20,16.00,43822,48895,61607,20844,4425,106,261,67672,25045
12,58050,1258050,Pompano Beach city, Florida,1,2016,109380,38.20,76.70,17.50,55493,53887,66504,36141,1575,235,0,84613,24767
12,58715,1258715,Port St. Lucie city, Florida,1,2016,185136,36.30,78.90,19.30,89187,95949,140563,32441,4368,982,0,146705,38431
12,60950,1260950,Riverview CDP, Florida,0,2016,88941,43.90,72.10,8.10,45301,43640,59779,14214,2534,165,0,64511,24430
12,63000,1263000,St. Petersburg city, Florida,1,2016,260991,40.40,83.40,17.80,125551,135440,180496,57621,9646,437,28,239510,21481
12,68350,1268350,Spring Hill CDP, Florida,0,2016,111189,33.80,78.30,23.00,52557,58632,95781,6864,1970,172,0,91710,19479
12,69700,1269700,Sunrise city, Florida,1,2016,93723,37.50,78.10,17.50,44021,49702,54600,31336,2844,347,0,63911,29812
12,70600,1270600,Tallahassee city, Florida,1,2016,190895,59.00,83.90,10.40,89544,101351,108352,64902,8779,230,256,177966,12929
12,70675,1270675,Tamarac city, Florida,0,2016,65190,30.00,83.40,27.00,31699,33491,37053,21365,1756,476,0,48091,17099
12,71000,1271000,Tampa city, Florida,1,2016,377172,43.20,78.30,13.30,180469,196703,243107,93801,18514,1568,321,285954,91218
12,71569,1271569,The Hammocks CDP, Florida,0,2016,65814,43.70,77.40,11.40,29652,36162,55062,2091,1485,49,0,14803,51011
12,71625,1271625,The Villages CDP, Florida,0,2016,-998,-999999999.00,-999999999.00,-999999999.00,-998,-998,-998,-998,-998,-998,-998,69555,1795
12,72145,1272145,Town 'n' Country CDP, Florida,0,2016,87561,42.20,77.00,12.20,41415,46146,70962,6392,2138,400,501,46487,41074
12,76582,1276582,Weston city, Florida,0,2016,70023,34.10,70.00,11.20,31201,38822,55982,2035,5173,0,0,39098,30925
12,76600,1276600,West Palm Beach city, Florida,1,2016,108149,42.60,84.10,20.20,52914,55235,65998,36086,2355,359,0,85256,22893
13,01052,1301052,Albany city, Georgia,1,2016,74904,43.40,74.50,13.50,33691,41213,16133,55766,583,258,50,73047,1857
13,01696,1301696,Alpharetta city, Georgia,0,2016,65334,36.60,72.30,10.20,34157,31177,41339,7482,14187,126,0,60428,4906
13,03440,1303440,Athens-Clarke County unified government (balance), Georgia,1,2016,123456,56.70,82.90,10.00,59489,63967,77831,34730,5209,181,33,110043,13413
13,04000,1304000,Atlanta city, Georgia,1,2016,472506,50.80,80.60,11.10,235065,237441,190892,240202,20450,2895,209,449408,23098
13,04204,1304204,Augusta-Richmond County consolidated government (balance), Georgia,1,2016,196194,43.20,76.80,13.50,94946,101248,73228,112659,4084,584,848,186448,9746
13,19000,1319000,Columbus city, Georgia,1,2016,197485,43.20,75.40,12.70,96919,100566,86603,90127,4160,1159,0,182510,14975
13,42425,1342425,Johns Creek city, Georgia,1,2016,83884,34.90,71.80,9.10,39626,44258,52237,6332,20513,220,0,76605,7279
13,49008,1349008,Macon-Bibb County, Georgia,0,2016,152527,39.40,75.00,14.70,71586,80941,61167,82447,3089,98,0,147672,4855
13,67284,1367284,Roswell city, Georgia,1,2016,94592,38.10,74.10,11.50,46806,47786,-998,-998,-998,-998,-998,80306,14286
13,68516,1368516,Sandy Springs city, Georgia,1,2016,105720,49.70,82.00,11.90,50712,55008,62228,24294,7108,5442,0,88018,17702
13,69000,1369000,Savannah city, Georgia,1,2016,146762,48.40,79.40,13.50,71289,75473,56773,78846,3496,374,360,138033,8729
13,80508,1380508,Warner Robins city, Georgia,1,2016,74401,41.30,76.20,13.10,34897,39504,38579,27641,3142,495,0,68639,5762
15,71550,1571550,Urban Honolulu CDP, Hawaii,0,2016,351769,39.40,81.90,19.50,173691,178078,63646,5819,183327,638,34345,326336,25433
16,08830,1608830,Boise City city, Idaho,1,2016,223152,44.40,77.00,12.90,107555,115597,192811,5055,9096,903,377,201142,22010
16,52120,1652120,Meridian city, Idaho,1,2016,95627,37.60,71.30,14.10,50803,44824,-998,-998,-998,-998,-998,89134,6493
16,56260,1656260,Nampa city, Idaho,1,2016,91375,42.10,66.40,11.60,44119,47256,73424,48,591,1438,652,65866,25509
17,02154,1702154,Arlington Heights village, Illinois,1,2016,74397,32.90,77.10,18.90,36830,37567,-998,-998,-998,-998,-998,70597,3800
17,03012,1703012,Aurora city, Illinois,1,2016,197107,44.20,71.00,9.00,97162,99945,113373,20755,14434,689,414,107521,89586
17,06613,1706613,Bloomington city, Illinois,1,2016,78024,45.80,79.80,12.80,38600,39424,59864,7882,6404,185,0,73171,4853
17,07133,1707133,Bolingbrook village, Illinois,1,2016,73367,42.50,74.50,9.50,37933,35434,35288,13239,10160,116,0,54652,18715
17,12385,1712385,Champaign city, Illinois,1,2016,86649,57.60,87.20,10.30,47048,39601,58594,14078,10589,58,0,81082,5567
17,14000,1714000,Chicago city, Illinois,1,2016,2704965,47.30,78.80,11.80,1313049,1391916,1309585,802457,172298,8551,1261,1901489,803476
17,14351,1714351,Cicero town, Illinois,1,2016,82991,47.20,68.70,7.30,42304,40687,-998,-998,-998,-998,-998,9391,73600
17,18823,1718823,Decatur city, Illinois,1,2016,71435,36.70,78.60,19.20,33298,38137,49798,13342,670,211,0,69323,2112
17,23074,1723074,Elgin city, Illinois,1,2016,114521,41.50,73.40,12.50,58238,56283,59780,5576,8098,894,0,59186,55335
17,24582,1724582,Evanston city, Illinois,1,2016,74899,46.10,80.50,14.40,34349,40550,47073,15095,7431,97,0,66007,8892
17,38570,1738570,Joliet city, Illinois,1,2016,146410,43.40,72.40,10.90,71405,75005,96170,22839,6221,1181,0,109950,36460
17,51622,1751622,Naperville city, Illinois,1,2016,148063,38.80,72.80,10.70,73017,75046,105313,7876,27981,407,46,138144,9919
17,57225,1757225,Palatine village, Illinois,1,2016,68725,41.60,75.10,10.70,33742,34983,49708,1338,9280,88,0,60344,8381
17,59000,1759000,Peoria city, Illinois,1,2016,115588,41.60,76.10,14.50,55260,60328,68927,32475,6684,542,0,108345,7243
17,65000,1765000,Rockford city, Illinois,1,2016,147404,38.50,75.50,16.20,72137,75267,99031,31666,5617,103,0,118711,28693
17,68003,1768003,Schaumburg village, Illinois,1,2016,73803,41.40,78.60,15.10,37322,36481,43398,2204,19882,494,0,64693,9110
17,70122,1770122,Skokie village, Illinois,0,2016,64292,34.50,75.20,18.50,30312,33980,36120,6716,16857,627,0,55411,8881
17,72000,1772000,Springfield city, Illinois,1,2016,115511,39.40,78.40,17.10,55778,59733,84336,24183,3078,35,107,112192,3319
17,79293,1779293,Waukegan city, Illinois,1,2016,84467,47.70,72.50,8.90,42281,42186,40852,14079,5346,98,0,36864,47603
18,05860,1805860,Bloomington city, Indiana,1,2016,86654,68.20,88.00,8.00,43793,42861,71129,3168,8697,310,0,82974,3680
18,10342,1810342,Carmel city, Indiana,1,2016,90533,37.40,72.40,12.60,44615,45918,74047,2568,10491,97,0,87527,3006
18,22000,1822000,Evansville city, Indiana,1,2016,119407,42.60,77.70,14.30,57965,61442,95744,14647,1138,310,1210,115325,4082
18,23278,1823278,Fishers city, Indiana,1,2016,88930,41.80,71.20,7.40,43375,45555,75152,5027,5216,0,0,84059,4871
18,25000,1825000,Fort Wayne city, Indiana,1,2016,261342,40.60,74.40,13.50,126384,134958,197350,39177,11820,322,102,236493,24849
18,27000,1827000,Gary city, Indiana,1,2016,74186,36.50,76.40,18.40,34029,40157,9357,61511,169,101,53,70193,3993
18,31000,1831000,Hammond city, Indiana,1,2016,77131,43.00,71.70,9.40,36789,40342,36718,19262,688,24,42,47140,29991
18,36003,1836003,Indianapolis city (balance), Indiana,1,2016,852506,42.90,75.20,11.60,409836,442670,518799,238317,26159,2843,244,763167,89339
18,40788,1840788,Lafayette city, Indiana,1,2016,71311,45.50,78.80,13.50,34193,37118,58419,7599,443,104,0,62963,8348
18,51876,1851876,Muncie city, Indiana,1,2016,68707,51.30,85.20,14.50,33993,34714,55587,8135,1473,226,163,66571,2136
18,71000,1871000,South Bend city, Indiana,1,2016,102442,40.10,71.30,13.50,49114,53328,64131,26796,649,707,125,84961,17481
19,01855,1901855,Ames city, Iowa,0,2016,66190,67.40,88.70,10.10,34238,31952,53860,1342,8289,157,0,63469,2721
19,12000,1912000,Cedar Rapids city, Iowa,1,2016,131118,41.80,76.80,14.70,64618,66500,113375,8301,4837,191,90,126067,5051
19,19000,1919000,Davenport city, Iowa,1,2016,102608,41.30,75.10,13.80,50581,52027,83468,13300,2329,416,0,93947,8661
19,21000,1921000,Des Moines city, Iowa,1,2016,215328,44.90,76.00,11.50,108057,107271,160964,24403,13071,299,71,186490,28838
19,38595,1938595,Iowa City city, Iowa,1,2016,74384,59.10,85.10,10.40,35713,38671,57711,6352,5634,0,0,68913,5471
19,73335,1973335,Sioux City city, Iowa,1,2016,82105,41.10,73.70,14.30,41223,40882,67712,3720,3013,627,749,66405,15700
19,82425,1982425,Waterloo city, Iowa,1,2016,67940,39.90,76.60,14.80,34814,33126,52068,10609,1849,437,719,63788,4152
20,36000,2036000,Kansas City city, Kansas,1,2016,153893,41.60,71.50,11.20,76722,77171,88976,36001,5963,1134,0,107776,46117
20,38900,2038900,Lawrence city, Kansas,1,2016,95355,57.70,81.90,9.60,47286,48069,76293,4714,5732,1486,10,89232,6123
20,52575,2052575,Olathe city, Kansas,1,2016,135474,41.60,72.00,11.40,67456,68018,115769,8300,5444,383,0,122855,12619
20,53775,2053775,Overland Park city, Kansas,1,2016,188955,38.70,75.60,14.30,90959,97996,159728,9308,12327,181,0,175723,13232
20,64500,2064500,Shawnee city, Kansas,0,2016,65215,40.50,77.90,11.50,31965,33250,53945,2244,4882,0,0,61657,3558
20,71000,2071000,Topeka city, Kansas,1,2016,126812,39.30,75.90,16.50,60214,66598,94906,14271,1928,1060,127,106429,20383
20,79000,2079000,Wichita city, Kansas,1,2016,389927,40.90,74.30,13.40,191350,198577,290548,40640,18943,3125,0,324046,65881
21,08902,2108902,Bowling Green city, Kentucky,0,2016,65239,54.90,79.40,11.80,31658,33581,47357,10170,3883,58,0,60568,4671
21,46027,2146027,Lexington-Fayette urban county, Kentucky,1,2016,318449,46.20,79.00,12.10,156230,162219,238917,46097,11699,1080,201,296501,21948
21,48006,2148006,Louisville/Jefferson County metro government (balance), Kentucky,1,2016,616261,40.10,77.70,14.40,298261,318000,432485,146430,16079,907,355,584105,32156
22,05000,2205000,Baton Rouge city, Louisiana,1,2016,227707,46.60,77.50,13.50,108481,119226,84704,127685,8216,156,0,219060,8647
22,08920,2208920,Bossier City city, Louisiana,0,2016,68485,43.00,75.10,11.80,35806,32679,46170,18259,1173,173,123,63079,5406
22,39475,2239475,Kenner city, Louisiana,1,2016,67094,38.10,74.00,14.60,32714,34380,39750,19622,1846,183,0,51996,15098
22,40735,2240735,Lafayette city, Louisiana,1,2016,127625,43.20,79.70,14.60,60899,66726,77710,43551,2386,220,0,124335,3290
22,41155,2241155,Lake Charles city, Louisiana,1,2016,76861,41.50,76.10,15.30,37100,39761,34343,38397,796,320,0,73734,3127
22,50115,2250115,Metairie CDP, Louisiana,0,2016,143475,38.80,80.20,19.10,69252,74223,118166,12781,4607,212,0,120153,23322
22,55000,2255000,New Orleans city, Louisiana,1,2016,391495,44.20,79.60,13.00,186998,204497,133434,233836,11721,434,97,369565,21930
22,70000,2270000,Shreveport city, Louisiana,1,2016,194472,40.80,75.60,14.60,90716,103756,74555,111255,3228,422,0,189055,5417
23,60545,2360545,Portland city, Maine,1,2016,66945,47.50,82.60,14.40,33470,33475,55083,6415,2757,443,0,64067,2878
24,04000,2404000,Baltimore city, Maryland,1,2016,614664,44.50,79.00,12.90,289086,325578,189260,384465,15149,1800,604,583520,31144
24,19125,2419125,Columbia CDP, Maryland,0,2016,107308,41.30,78.70,15.60,51686,55622,60356,25419,14815,179,56,96119,11189
24,26000,2426000,Ellicott City CDP, Maryland,0,2016,68683,34.50,74.80,15.30,32545,36138,39723,7059,19451,114,0,66959,1724
24,30325,2430325,Frederick city, Maryland,0,2016,70062,43.00,80.10,13.60,34329,35733,45504,14990,6639,413,58,61278,8784
24,31175,2431175,Gaithersburg city, Maryland,0,2016,67760,46.80,78.40,11.30,32064,35696,35630,13969,10407,555,0,48856,18904
24,32025,2432025,Germantown CDP, Maryland,0,2016,89940,43.10,74.50,8.00,43391,46549,44676,22214,17495,0,0,68639,21301
24,32650,2432650,Glen Burnie CDP, Maryland,0,2016,69499,41.10,79.90,15.30,34152,35347,42028,16211,4146,164,0,62157,7342
24,67675,2467675,Rockville city, Maryland,0,2016,66927,40.40,77.20,15.90,31322,35605,42281,7271,11610,109,0,55720,11207
24,72450,2472450,Silver Spring CDP, Maryland,0,2016,85988,51.10,77.40,9.00,42554,43434,34148,28099,7464,0,0,69862,16126
24,81175,2481175,Waldorf CDP, Maryland,0,2016,75448,40.50,73.40,9.00,35344,40104,21002,46501,3073,193,0,70495,4953
25,07000,2507000,Boston city, Massachusetts,1,2016,672840,54.30,83.90,11.00,323186,349654,358210,173312,65982,2296,252,544377,128463
25,09000,2509000,Brockton city, Massachusetts,1,2016,95623,39.40,73.70,13.80,45789,49834,37260,38925,866,306,0,83856,11767
25,11000,2511000,Cambridge city, Massachusetts,1,2016,110644,62.30,88.10,12.20,53974,56670,70479,12602,19813,603,54,100005,10639
25,23000,2523000,Fall River city, Massachusetts,1,2016,88929,40.30,78.50,17.90,43076,45853,69825,4468,1544,9,0,78387,10542
25,24960,2524960,Framingham CDP, Massachusetts,0,2016,71583,41.20,79.50,16.70,33223,38360,52862,3933,6419,56,0,63283,8300
25,34550,2534550,Lawrence city, Massachusetts,1,2016,80216,46.00,72.60,10.10,39769,40447,54819,4582,1564,462,0,17120,63096
25,37000,2537000,Lowell city, Massachusetts,1,2016,110572,46.80,77.10,9.80,54926,55646,66794,8912,25541,708,177,91640,18932
25,37490,2537490,Lynn city, Massachusetts,1,2016,92708,42.70,76.80,13.70,47755,44953,42184,10866,6618,387,169,53885,38823
25,45000,2545000,New Bedford city, Massachusetts,1,2016,95035,41.60,75.60,14.00,45355,49680,60966,6507,1818,59,65,76719,18316
25,45560,2545560,Newton city, Massachusetts,1,2016,89041,37.50,76.30,18.10,41564,47477,68478,1976,12285,193,27,82812,6229
25,55745,2555745,Quincy city, Massachusetts,1,2016,93686,43.50,83.60,15.30,44812,48874,55449,4817,28905,387,0,90579,3107
25,62535,2562535,Somerville city, Massachusetts,1,2016,81324,66.90,89.10,7.30,40098,41226,59418,5658,8985,236,0,71901,9423
25,67000,2567000,Springfield city, Massachusetts,1,2016,154079,43.80,76.30,12.20,72582,81497,101679,32511,2963,341,0,86795,67284
25,82000,2582000,Worcester city, Massachusetts,1,2016,184509,46.10,81.90,13.40,91316,93193,122478,26775,14312,712,49,146513,37996
26,03000,2603000,Ann Arbor city, Michigan,1,2016,120777,60.10,87.70,11.50,61533,59244,86008,7583,19147,15,179,115129,5648
26,21000,2621000,Dearborn city, Michigan,1,2016,94430,41.50,71.10,12.60,46467,47963,86617,3368,1454,176,0,92201,2229
26,22000,2622000,Detroit city, Michigan,1,2016,672829,41.80,74.30,12.70,320634,352195,91180,531876,12282,2173,69,625546,47283
26,27440,2627440,Farmington Hills city, Michigan,1,2016,81130,33.50,80.70,18.60,38600,42530,54491,16354,8113,30,0,79601,1529
26,29000,2629000,Flint city, Michigan,1,2016,97379,39.40,72.40,11.30,45674,51705,40448,51392,302,245,0,91750,5629
26,34000,2634000,Grand Rapids city, Michigan,1,2016,196458,47.90,76.20,11.40,99579,96879,131297,36737,4295,795,67,166633,29825
26,42160,2642160,Kalamazoo city, Michigan,1,2016,75988,54.60,77.80,9.60,37752,38236,54153,15050,1262,0,0,68503,7485
26,46000,2646000,Lansing city, Michigan,1,2016,117400,46.40,76.80,10.20,56190,61210,71639,26068,4377,704,187,102985,14415
26,49000,2649000,Livonia city, Michigan,1,2016,94044,33.30,79.90,17.80,45486,48558,83902,5150,2916,46,62,91255,2789
26,69035,2669035,Rochester Hills city, Michigan,1,2016,73418,38.40,75.80,16.00,35384,38034,55002,4961,11280,112,0,68356,5062
26,74900,2674900,Southfield city, Michigan,1,2016,73093,37.90,81.00,20.20,34589,38504,14906,51660,1870,193,0,71372,1721
26,76460,2676460,Sterling Heights city, Michigan,1,2016,132442,39.60,78.50,15.70,64059,68383,111033,7902,9448,416,0,129117,3325
26,80700,2680700,Troy city, Michigan,1,2016,83651,36.10,79.90,17.80,41138,42513,60510,2082,18926,149,0,81938,1713
26,84000,2684000,Warren city, Michigan,1,2016,135121,39.30,76.50,16.10,67399,67722,97309,23298,11198,163,0,131643,3478
26,86000,2686000,Westland city, Michigan,1,2016,81543,38.70,80.70,16.10,38969,42574,61033,14778,2186,605,81,78411,3132
26,88940,2688940,Wyoming city, Michigan,1,2016,75560,44.50,76.60,10.40,37609,37951,58050,6068,1326,645,0,59391,16169
27,06616,2706616,Bloomington city, Minnesota,1,2016,85337,37.00,81.30,22.60,41737,43600,63158,8460,3280,440,70,76501,8836
27,07966,2707966,Brooklyn Park city, Minnesota,1,2016,79708,40.70,70.50,10.10,36903,42805,37162,25670,12079,502,252,74987,4721
27,17000,2717000,Duluth city, Minnesota,1,2016,86300,46.50,80.90,14.30,42552,43748,76930,2365,1686,2877,35,84735,1565
27,17288,2717288,Eagan city, Minnesota,0,2016,66431,38.00,79.00,12.20,32889,33542,53795,5911,3577,510,0,62766,3665
27,40166,2740166,Maple Grove city, Minnesota,0,2016,69569,36.90,71.50,10.70,34293,35276,58432,3867,4833,40,0,69092,477
27,43000,2743000,Minneapolis city, Minnesota,1,2016,413645,52.10,80.40,9.30,213568,200077,265776,74766,27385,6083,39,377210,36435
27,51730,2751730,Plymouth city, Minnesota,1,2016,77231,36.80,76.50,14.50,38690,38541,62217,2290,9482,503,0,73488,3743
27,54880,2754880,Rochester city, Minnesota,1,2016,114008,42.20,76.10,14.40,55524,58484,90714,8806,8682,900,0,107106,6902
27,56896,2756896,St. Cloud city, Minnesota,0,2016,67396,50.80,81.90,12.90,35868,31528,52486,10786,2003,208,0,65995,1401
27,58000,2758000,St. Paul city, Minnesota,1,2016,302403,45.90,74.60,10.20,149460,152943,172623,45923,55056,2283,114,273175,29228
27,71428,2771428,Woodbury city, Minnesota,0,2016,68824,40.60,69.90,9.50,34055,34769,52205,5341,6347,143,66,64573,4251
28,29700,2829700,Gulfport city, Mississippi,1,2016,72077,40.00,77.10,13.70,34662,37415,42464,25043,1559,981,0,66026,6051
28,36000,2836000,Jackson city, Mississippi,1,2016,169141,44.00,74.50,11.60,77607,91534,-998,-998,-998,-998,-998,166884,2257
29,15670,2915670,Columbia city, Missouri,1,2016,120606,55.30,81.70,11.60,58198,62408,90760,14038,8900,775,0,117106,3500
29,35000,2935000,Independence city, Missouri,1,2016,117031,37.00,76.80,17.20,55920,61111,93723,8276,2579,488,1999,106454,10577
29,38000,2938000,Kansas City city, Missouri,1,2016,481360,42.80,76.70,12.40,234706,246654,296737,137333,14876,1368,1010,429130,52230
29,41348,2941348,Lee's Summit city, Missouri,1,2016,95782,35.10,71.80,14.90,45586,50196,81770,7660,1049,389,0,91510,4272
29,54074,2954074,O'Fallon city, Missouri,1,2016,86276,39.80,74.80,11.50,41243,45033,-998,-998,-998,-998,-998,84157,2119
29,64082,2964082,St. Charles city, Missouri,0,2016,69293,44.00,81.00,15.70,33080,36213,58544,3824,3560,294,0,65086,4207
29,64550,2964550,St. Joseph city, Missouri,1,2016,76506,41.20,78.10,13.90,39027,37479,66049,4448,1048,336,0,71196,5310
29,65000,2965000,St. Louis city, Missouri,1,2016,311404,45.80,80.20,11.80,150976,160428,144752,145886,10264,762,88,298857,12547
29,70000,2970000,Springfield city, Missouri,1,2016,167313,47.80,82.20,14.50,79502,87811,144488,8173,2659,1498,110,160168,7145
30,06550,3006550,Billings city, Montana,1,2016,110314,38.40,77.10,15.90,54579,55735,99661,823,934,4856,0,104006,6308
30,50200,3050200,Missoula city, Montana,1,2016,72362,50.70,82.80,11.80,37203,35159,66023,690,1298,2037,0,69579,2783
31,28000,3128000,Lincoln city, Nebraska,1,2016,280369,46.20,77.50,12.80,140163,140206,239577,12309,12093,1863,3,259666,20703
31,37000,3137000,Omaha city, Nebraska,1,2016,446956,42.60,75.60,12.70,220500,226456,349668,54432,16599,1316,284,384620,62336
32,23770,3223770,Enterprise CDP, Nevada,0,2016,139509,45.00,76.10,10.10,67103,72406,73283,11682,33565,527,1641,111258,28251
32,31900,3231900,Henderson city, Nevada,1,2016,292977,36.30,78.10,19.50,145091,147886,227367,15739,19841,2274,2751,246284,46693
32,40000,3240000,Las Vegas city, Nevada,1,2016,632916,40.10,76.10,14.70,315737,317179,397592,87268,40180,3233,3947,429866,203050
32,51800,3251800,North Las Vegas city, Nevada,1,2016,238689,44.10,72.10,9.60,119210,119479,138581,46263,14661,2133,1632,141455,97234
32,54600,3254600,Paradise CDP, Nevada,0,2016,242013,44.40,80.10,13.90,127736,114277,147322,21728,30095,969,2794,160844,81169
32,60600,3260600,Reno city, Nevada,1,2016,245251,43.90,78.60,14.30,124768,120483,186547,6881,15733,3211,1637,182474,62777
32,68400,3268400,Sparks city, Nevada,1,2016,98346,37.50,76.60,14.90,48922,49424,75152,1527,6995,509,457,71208,27138
32,68585,3268585,Spring Valley CDP, Nevada,0,2016,205933,43.80,79.10,13.00,100357,105576,102742,23948,43110,1228,2477,159275,46658
32,71400,3271400,Sunrise Manor CDP, Nevada,0,2016,193357,42.00,72.50,9.80,93238,100119,99257,23391,10593,2333,921,81871,111486
33,45140,3345140,Manchester city, New Hampshire,1,2016,110499,44.80,80.60,13.60,58548,51951,94304,5058,6062,234,0,98872,11627
33,50260,3350260,Nashua city, New Hampshire,1,2016,87889,37.00,81.10,17.50,41978,45911,74604,3104,5392,170,32,77434,10455
34,03580,3403580,Bayonne city, New Jersey,0,2016,66224,39.90,76.20,15.30,33479,32745,40253,5665,6941,67,202,44781,21443
34,10000,3410000,Camden city, New Jersey,1,2016,74417,43.00,71.10,9.70,36767,37650,19692,28699,2230,743,0,39298,35119
34,13690,3413690,Clifton city, New Jersey,1,2016,85847,40.00,80.00,15.50,40510,45337,58072,4920,9904,22,180,55925,29922
34,19390,3419390,East Orange city, New Jersey,0,2016,64797,40.50,74.70,11.50,31587,33210,2425,54171,498,384,0,56379,8418
34,21000,3421000,Elizabeth city, New Jersey,1,2016,128638,44.20,72.60,9.20,62266,66372,51210,25183,2157,431,0,51069,77569
34,36000,3436000,Jersey City city, New Jersey,1,2016,264161,51.30,79.30,9.60,131030,133131,88979,61338,67062,1040,195,190153,74008
34,51000,3451000,Newark city, New Jersey,1,2016,281770,46.30,76.70,10.00,137771,143999,85918,140673,5556,767,0,184752,97018
34,56550,3456550,Passaic city, New Jersey,1,2016,70646,42.80,66.70,8.50,34688,35958,50865,8124,1310,426,0,17023,53623
34,57000,3457000,Paterson city, New Jersey,1,2016,147011,42.60,75.10,12.20,71201,75810,50202,38447,4954,119,0,57766,89245
34,73110,3473110,Toms River CDP, New Jersey,0,2016,88283,33.90,79.70,19.40,42104,46179,78571,2032,3188,84,71,80871,7412
34,74000,3474000,Trenton city, New Jersey,1,2016,84065,43.20,74.10,11.00,43472,40593,38904,41065,1138,274,0,52685,31380
34,74630,3474630,Union City city, New Jersey,1,2016,69298,43.50,79.30,11.50,33843,35455,51525,4333,3079,70,279,20163,49135
35,02000,3502000,Albuquerque city, New Mexico,1,2016,559270,41.50,77.00,14.70,273023,286247,395010,17927,16427,27901,498,292852,266418
35,39380,3539380,Las Cruces city, New Mexico,1,2016,101760,43.40,77.30,16.00,50333,51427,91988,2831,2095,924,69,41067,60693
35,63460,3563460,Rio Rancho city, New Mexico,1,2016,96022,38.20,76.90,15.60,46528,49494,76335,2909,1271,3133,0,59924,36098
35,70500,3570500,Santa Fe city, New Mexico,1,2016,83881,35.50,81.20,21.10,40020,43861,74454,904,404,1952,20,38932,44949
36,01000,3601000,Albany city, New York,1,2016,98106,51.70,82.30,12.10,47513,50593,51681,30354,6418,224,0,88353,9753
36,08026,3608026,Brentwood CDP, New York,0,2016,62132,45.70,74.60,8.10,29094,33038,38085,8268,690,268,0,21401,40731
36,11000,3611000,Buffalo city, New York,1,2016,256908,45.70,77.40,12.00,123296,133612,120967,94657,16617,1281,240,229304,27604
36,15000,3615000,Cheektowaga CDP, New York,0,2016,73199,37.40,80.90,17.70,33802,39397,60001,9361,2122,68,0,71593,1606
36,49121,3649121,Mount Vernon city, New York,1,2016,68348,35.90,78.50,15.80,30724,37624,18891,40981,1682,246,0,54723,13625
36,50617,3650617,New Rochelle city, New York,1,2016,79558,43.00,79.50,14.50,38507,41051,51526,14741,3484,41,0,53487,26071
36,51000,3651000,New York city, New York,1,2016,8537673,44.10,78.90,13.50,4075642,4462031,3627375,2073102,1205911,31806,4940,6048583,2489090
36,63000,3663000,Rochester city, New York,1,2016,208886,47.10,76.90,9.80,101014,107872,99699,85771,4967,1552,61,168491,40395
36,65508,3665508,Schenectady city, New York,1,2016,64907,44.70,78.80,13.20,31051,33856,37382,12691,3291,258,191,57362,7545
36,73000,3673000,Syracuse city, New York,1,2016,143378,47.60,80.10,12.80,68132,75246,78868,41560,8529,959,0,130363,13015
36,84000,3684000,Yonkers city, New York,1,2016,200792,40.40,79.20,17.30,95561,105231,97326,43358,15158,537,76,130564,70228
37,02140,3702140,Asheville city, North Carolina,1,2016,89098,43.80,83.10,17.20,43135,45963,72342,11111,2570,57,0,83454,5644
37,10740,3710740,Cary town, North Carolina,1,2016,164007,36.60,73.20,12.80,81504,82503,113872,11114,28520,951,0,148740,15267
37,12000,3712000,Charlotte city, North Carolina,1,2016,842029,46.30,75.60,9.60,403118,438911,414560,302904,53235,2358,786,726092,115937
37,14100,3714100,Concord city, North Carolina,1,2016,89895,39.00,74.80,12.50,42625,47270,60717,17296,4079,53,49,81007,8888
37,19000,3719000,Durham city, North Carolina,1,2016,262989,47.60,77.40,10.70,123173,139816,130718,100950,14462,392,267,225417,37572
37,22920,3722920,Fayetteville city, North Carolina,1,2016,204777,46.70,76.20,12.80,100760,104017,91948,88517,5341,2215,510,180824,23953
37,25580,3725580,Gastonia city, North Carolina,1,2016,75537,36.60,75.20,15.80,34378,41159,48137,19907,1885,45,0,67663,7874
37,28000,3728000,Greensboro city, North Carolina,1,2016,287019,44.70,77.60,13.10,133246,153773,139564,115211,14430,1220,295,265176,21843
37,28080,3728080,Greenville city, North Carolina,1,2016,91500,54.80,81.10,9.30,42274,49226,50433,34227,2208,537,64,84903,6597
37,31400,3731400,High Point city, North Carolina,1,2016,115299,40.40,74.10,14.00,54638,60661,58540,41346,8100,300,0,100186,15113
37,34200,3734200,Jacksonville city, North Carolina,1,2016,67795,60.90,74.30,6.40,38783,29012,48166,9896,1179,376,275,57456,10339
37,55000,3755000,Raleigh city, North Carolina,1,2016,458862,49.80,79.80,10.10,218960,239902,272643,133592,21468,1445,87,412213,46649
37,74440,3774440,Wilmington city, North Carolina,1,2016,117545,46.80,81.40,14.20,57072,60473,89065,21336,1666,453,0,110594,6951
37,75000,3775000,Winston-Salem city, North Carolina,1,2016,242200,40.90,76.10,14.60,113238,128962,138133,84404,5279,825,21,208416,33784
38,07200,3807200,Bismarck city, North Dakota,0,2016,68780,39.10,78.70,17.50,33495,35285,61360,2026,674,3448,131,67163,1617
38,25700,3825700,Fargo city, North Dakota,1,2016,120235,50.30,79.70,12.00,64231,56004,103380,6237,4151,1367,0,116295,3940
39,01000,3901000,Akron city, Ohio,1,2016,197634,41.10,78.40,14.60,93194,104440,116967,61945,9274,378,0,192725,4909
39,12000,3912000,Canton city, Ohio,1,2016,71329,39.30,76.10,14.60,34016,37313,45306,18226,286,0,0,67457,3872
39,15000,3915000,Cincinnati city, Ohio,1,2016,298802,46.60,77.70,12.10,143760,155042,152794,124696,5095,102,0,286222,12580
39,16000,3916000,Cleveland city, Ohio,1,2016,385810,41.00,77.70,13.10,189401,196409,154487,191178,8047,1528,135,343415,42395
39,18000,3918000,Columbus city, Ohio,1,2016,862643,48.20,77.00,9.70,420416,442227,519035,249181,44835,1222,747,812893,49750
39,21000,3921000,Dayton city, Ohio,1,2016,140478,44.60,78.80,13.20,68691,71787,77082,57999,1481,127,270,134657,5821
39,44856,3944856,Lorain city, Ohio,0,2016,63736,41.10,75.60,15.00,29986,33750,44806,11485,554,362,174,45213,18523
39,61000,3961000,Parma city, Ohio,1,2016,79423,39.30,80.80,17.20,38615,40808,71112,2978,1798,0,0,74797,4626
39,77000,3977000,Toledo city, Ohio,1,2016,278512,41.50,76.60,14.00,135322,143190,175137,76608,2722,727,146,253968,24544
39,88000,3988000,Youngstown city, Ohio,1,2016,64301,37.30,79.60,16.40,30439,33862,32155,25980,309,122,0,57694,6607
40,09050,4009050,Broken Arrow city, Oklahoma,1,2016,109439,38.90,75.00,14.70,53158,56281,86693,3966,3507,5688,0,100873,8566
40,23200,4023200,Edmond city, Oklahoma,1,2016,91187,42.50,72.70,12.70,43632,47555,74020,5258,2691,1789,0,85543,5644
40,41850,4041850,Lawton city, Oklahoma,1,2016,94652,46.30,76.20,10.70,49640,45012,56540,21074,2400,3863,170,81065,13587
40,52500,4052500,Norman city, Oklahoma,1,2016,122186,50.80,81.70,13.50,60931,61255,93564,6069,7458,5080,112,112955,9231
40,55000,4055000,Oklahoma City city, Oklahoma,1,2016,638311,42.60,74.20,11.70,312300,326011,433765,92689,25383,21571,986,518876,119435
40,75000,4075000,Tulsa city, Oklahoma,1,2016,403622,41.50,75.00,13.20,196133,207489,255063,61480,13046,19345,279,338644,64978
41,05350,4105350,Beaverton city, Oregon,1,2016,97602,42.50,82.30,13.70,47965,49637,72296,2177,9606,325,98,80023,17579
41,05800,4105800,Bend city, Oregon,1,2016,91123,41.30,79.30,18.30,44253,46870,86288,538,1102,159,0,83148,7975
41,23850,4123850,Eugene city, Oregon,1,2016,166581,48.00,83.00,16.20,82581,84000,141176,2998,7272,2394,490,150119,16462
41,31250,4131250,Gresham city, Oregon,1,2016,111521,38.80,77.10,13.50,55501,56020,90533,5483,4357,1900,318,91802,19719
41,34100,4134100,Hillsboro city, Oregon,1,2016,105171,48.20,73.40,9.60,52078,53093,70620,3134,13785,567,1861,80168,25003
41,47000,4147000,Medford city, Oregon,1,2016,81621,36.10,78.20,19.80,40031,41590,69756,503,1559,1481,404,70902,10719
41,59000,4159000,Portland city, Oregon,1,2016,639635,47.70,81.70,12.40,316918,322717,497999,38807,49174,3558,4329,574581,65054
41,64900,4164900,Salem city, Oregon,1,2016,167421,43.80,77.50,15.30,80020,87401,137347,1449,5528,1611,1992,129572,37849
42,02000,4202000,Allentown city, Pennsylvania,1,2016,120440,44.20,72.20,11.40,57911,62529,74100,16625,2408,0,0,56962,63478
42,06088,4206088,Bethlehem city, Pennsylvania,1,2016,76427,46.20,79.90,14.80,37531,38896,62136,5918,2185,320,0,54787,21640
42,24000,4224000,Erie city, Pennsylvania,1,2016,98601,41.60,76.30,13.30,47527,51074,74635,15557,3468,427,153,90241,8360
42,60000,4260000,Philadelphia city, Pennsylvania,1,2016,1567872,45.00,77.90,12.90,743380,824492,634111,661032,110733,5521,480,1341552,226320
42,61000,4261000,Pittsburgh city, Pennsylvania,1,2016,303624,49.20,84.70,14.60,149497,154127,205201,69010,17031,338,245,295174,8450
42,63624,4263624,Reading city, Pennsylvania,1,2016,87575,43.70,71.60,10.90,43631,43944,47324,8057,786,3377,0,28136,59439
42,69000,4269000,Scranton city, Pennsylvania,1,2016,77294,41.00,79.10,17.60,38431,38863,65080,4855,3102,176,0,66416,10878
44,19180,4419180,Cranston city, Rhode Island,1,2016,81025,38.70,82.50,19.70,40454,40571,68119,3943,3904,350,48,67349,13676
44,54640,4454640,Pawtucket city, Rhode Island,1,2016,71434,44.00,79.30,11.40,36950,34484,46471,10676,2391,937,135,55955,15479
44,59000,4459000,Providence city, Rhode Island,1,2016,179214,52.50,76.80,9.10,86129,93085,94085,23938,10651,3066,175,98864,80350
44,74300,4474300,Warwick city, Rhode Island,1,2016,81576,34.30,83.40,21.50,38823,42753,73326,1557,2691,196,128,77280,4296
45,13330,4513330,Charleston city, South Carolina,1,2016,137539,48.20,83.90,14.40,64687,72852,100430,32447,2724,123,0,134396,3143
45,16000,4516000,Columbia city, South Carolina,1,2016,133972,58.10,84.10,10.00,69415,64557,70338,53642,3734,42,545,126351,7621
45,30850,4530850,Greenville city, South Carolina,0,2016,67447,47.80,78.90,14.00,31445,36002,45907,17812,1719,149,0,64234,3213
45,48535,4548535,Mount Pleasant town, South Carolina,1,2016,84177,38.40,73.50,14.40,41966,42211,77894,3142,977,417,0,80805,3372
45,50875,4550875,North Charleston city, South Carolina,1,2016,112147,46.40,76.50,10.10,53150,58997,57640,47074,1919,86,0,100333,11814
45,61405,4561405,Rock Hill city, South Carolina,1,2016,72926,44.50,75.40,13.00,35118,37808,37188,28992,1979,0,38,67897,5029
46,52980,4652980,Rapid City city, South Dakota,1,2016,74050,37.60,76.60,17.50,37179,36871,58856,660,1149,9240,0,70311,3739
46,59020,4659020,Sioux Falls city, South Dakota,1,2016,174350,43.20,74.40,12.70,86920,87430,147395,9170,5214,3859,39,165209,9141
47,14000,4714000,Chattanooga city, Tennessee,1,2016,177582,43.00,79.70,15.30,83440,94142,109586,58157,4913,89,0,164897,12685
47,15160,4715160,Clarksville city, Tennessee,1,2016,150280,47.60,73.10,9.00,73216,77064,100415,34363,4612,1383,1375,132790,17490
47,27740,4727740,Franklin city, Tennessee,0,2016,74788,38.30,74.90,12.70,36173,38615,63519,3459,4923,0,0,67250,7538
47,37640,4737640,Jackson city, Tennessee,0,2016,67006,40.10,77.20,15.70,30223,36783,34444,30599,767,53,0,64809,2197
47,38320,4738320,Johnson City city, Tennessee,0,2016,66976,44.10,81.80,15.50,32437,34539,57820,4234,1601,903,64,63311,3665
47,40000,4740000,Knoxville city, Tennessee,1,2016,186238,49.50,81.80,13.20,89619,96619,139049,32994,4349,1081,261,175254,10984
47,48000,4748000,Memphis city, Tennessee,1,2016,652752,42.60,74.80,12.10,309773,342979,183086,421114,10394,1994,98,606554,46198
47,51560,4751560,Murfreesboro city, Tennessee,1,2016,131939,53.00,77.20,8.20,65248,66691,99290,22653,4537,0,0,122183,9756
47,52006,4752006,Nashville-Davidson metropolitan government (balance), Tennessee,1,2016,660393,46.90,78.60,11.20,317555,342838,422479,184132,25558,1108,605,591736,68657
48,01000,4801000,Abilene city, Texas,1,2016,128272,46.20,77.20,12.40,66846,61426,93584,13479,3471,1258,8,94261,34011
48,01924,4801924,Allen city, Texas,1,2016,99166,38.70,73.00,10.10,50564,48602,67115,9165,16807,191,0,88525,10641
48,03000,4803000,Amarillo city, Texas,1,2016,197812,42.00,73.20,13.20,96597,101215,161939,13360,7837,1071,239,132878,64934
48,04000,4804000,Arlington city, Texas,1,2016,392787,44.90,74.30,10.60,193410,199377,246424,84751,23540,2107,942,276315,116472
48,04462,4804462,Atascocita CDP, Texas,0,2016,72763,40.60,71.90,9.90,35968,36795,52055,14522,2259,75,329,56080,16683
48,05000,4805000,Austin city, Texas,1,2016,947897,52.10,78.50,8.50,480741,467156,706658,72371,66777,4941,783,618413,329484
48,06128,4806128,Baytown city, Texas,1,2016,76834,44.10,71.60,8.60,39541,37293,53202,11090,3008,323,0,39828,37006
48,07000,4807000,Beaumont city, Texas,1,2016,118309,42.90,74.80,13.90,57581,60728,55572,54771,4780,483,32,98377,19932
48,10768,4810768,Brownsville city, Texas,1,2016,183829,41.10,68.50,13.50,88261,95568,178281,980,1779,38,35,12846,170983
48,10912,4810912,Bryan city, Texas,1,2016,83265,47.60,76.00,11.60,42600,40665,57877,13219,529,0,107,46796,36469
48,13024,4813024,Carrollton city, Texas,1,2016,133351,43.00,76.30,10.90,63528,69823,90192,12840,19477,754,244,89424,43927
48,13552,4813552,Cedar Park city, Texas,0,2016,70498,43.20,67.90,8.30,33639,36859,56895,1004,7115,346,0,56219,14279
48,15976,4815976,College Station city, Texas,1,2016,112142,67.80,82.80,5.40,56766,55376,87999,8638,12088,235,0,96448,15694
48,16432,4816432,Conroe city, Texas,0,2016,82296,42.20,75.40,12.90,41479,40817,68828,5480,3611,396,0,54430,27866
48,17000,4817000,Corpus Christi city, Texas,1,2016,325734,41.90,75.30,13.70,162179,163555,292170,14774,6628,1403,211,118915,206819
48,19000,4819000,Dallas city, Texas,1,2016,1317942,46.00,75.10,10.00,655438,662504,814974,324829,46997,2090,179,772759,545183
48,19972,4819972,Denton city, Texas,1,2016,133803,54.50,79.20,9.50,62917,70886,103969,13659,5920,917,264,99773,34030
48,22660,4822660,Edinburg city, Texas,1,2016,87642,46.10,65.10,6.60,42445,45197,-998,-998,-998,-998,-998,6649,80993
48,24000,4824000,El Paso city, Texas,1,2016,683088,42.60,72.70,12.70,334071,349017,561325,28025,10758,3850,299,131533,551555
48,26232,4826232,Flower Mound town, Texas,0,2016,73289,36.40,69.80,7.30,35882,37407,60475,2657,6443,193,34,66291,6998
48,27000,4827000,Fort Worth city, Texas,1,2016,855897,44.40,71.60,9.40,421697,434200,545285,162955,39260,3337,454,558091,297806
48,27684,4827684,Frisco city, Texas,1,2016,163631,40.20,68.30,7.90,79644,83987,112304,11038,33350,558,35,150810,12821
48,29000,4829000,Garland city, Texas,1,2016,234588,41.10,71.60,10.50,117667,116921,158211,34752,24919,518,0,131650,102938
48,29336,4829336,Georgetown city, Texas,0,2016,67137,34.80,82.80,29.00,33184,33953,61995,1829,312,0,0,52541,14596
48,30464,4830464,Grand Prairie city, Texas,1,2016,190626,41.60,71.30,9.20,94691,95935,121743,40206,15551,409,0,102158,88468
48,32372,4832372,Harlingen city, Texas,0,2016,65533,39.00,69.10,15.00,31935,33598,58336,871,237,303,85,12645,52888
48,35000,4835000,Houston city, Texas,1,2016,2304388,45.80,74.70,10.20,1152283,1152105,1318837,520127,171312,5044,968,1272510,1031878
48,37000,4837000,Irving city, Texas,1,2016,238284,49.30,73.80,8.20,117317,120967,113047,31480,46029,1303,531,134546,103738
48,39148,4839148,Killeen city, Texas,1,2016,143397,50.60,69.10,5.60,69917,73480,62075,59327,4855,1476,2217,107627,35770
48,41464,4841464,Laredo city, Texas,1,2016,257988,43.50,66.10,9.00,125058,132930,245694,1139,832,358,0,11757,246231
48,41980,4841980,League City city, Texas,1,2016,101619,44.30,74.20,10.80,49050,52569,80612,10912,4686,973,0,78808,22811
48,42508,4842508,Lewisville city, Texas,1,2016,104676,46.80,74.40,9.10,51726,52950,66383,11573,9229,373,315,69599,35077
48,43888,4843888,Longview city, Texas,1,2016,81712,39.50,75.40,15.60,40335,41377,57039,20621,1545,408,0,67156,14556
48,45000,4845000,Lubbock city, Texas,1,2016,252514,49.20,77.00,12.20,126017,126497,202208,20501,5184,3576,1000,163017,89497
48,45384,4845384,McAllen city, Texas,1,2016,142203,40.10,70.10,13.90,70602,71601,93259,1630,4412,1320,0,22947,119256
48,45744,4845744,McKinney city, Texas,1,2016,172318,41.50,72.10,10.50,85585,86733,129425,18887,13596,679,162,139088,33230
48,46452,4846452,Mansfield city, Texas,0,2016,65205,41.20,69.40,8.50,29873,35332,41470,10686,5950,487,264,53548,11657
48,47892,4847892,Mesquite city, Texas,1,2016,143763,40.50,70.80,9.80,66752,77011,94356,36061,4066,1146,244,87465,56298
48,48072,4848072,Midland city, Texas,1,2016,134613,44.50,72.30,10.70,66313,68300,112486,11052,3386,341,88,73833,60780
48,48768,4848768,Mission city, Texas,1,2016,83556,39.40,66.10,11.10,41732,41824,-998,-998,-998,-998,-998,7210,76346
48,48804,4848804,Missouri City city, Texas,1,2016,74875,37.70,76.80,13.80,33732,41143,27403,33846,8361,220,0,62777,12098
48,50820,4850820,New Braunfels city, Texas,0,2016,70999,39.50,75.50,15.80,33937,37062,64295,2006,1304,73,0,47689,23310
48,52356,4852356,North Richland Hills city, Texas,0,2016,69807,37.60,76.50,15.80,31684,38123,59726,3335,802,0,0,58774,11033
48,53388,4853388,Odessa city, Texas,1,2016,117749,43.60,72.20,10.70,58611,59138,98075,7301,1426,849,0,50650,67099
48,56000,4856000,Pasadena city, Texas,1,2016,153359,42.20,69.80,9.50,72603,80756,136040,5370,2409,1340,0,52916,100443
48,56348,4856348,Pearland city, Texas,1,2016,117367,43.20,73.30,10.30,57380,59987,69095,21685,17246,2460,0,96772,20595
48,57200,4857200,Pharr city, Texas,1,2016,77314,39.10,66.30,14.30,34139,43175,-998,-998,-998,-998,-998,5795,71519
48,58016,4858016,Plano city, Texas,1,2016,286047,42.00,76.60,11.40,140905,145142,188085,30299,52511,1179,495,241615,44432
48,61796,4861796,Richardson city, Texas,1,2016,113368,41.70,75.10,13.90,56337,57031,74781,14373,16656,225,0,94404,18964
48,63500,4863500,Round Rock city, Texas,1,2016,120528,47.20,74.60,8.80,59570,60958,86455,11983,9200,0,0,78937,41591
48,64472,4864472,San Angelo city, Texas,1,2016,103526,43.80,76.30,15.30,50621,52905,91526,5803,1259,455,0,60128,43398
48,65000,4865000,San Antonio city, Texas,1,2016,1492494,44.30,74.70,11.90,738297,754197,1184876,110885,41863,11402,727,536995,955499
48,70808,4870808,Sugar Land city, Texas,1,2016,88187,35.70,77.80,15.80,44478,43709,42580,5788,35725,167,0,80872,7315
48,72176,4872176,Temple city, Texas,0,2016,73597,37.50,73.50,18.60,35677,37920,57045,10162,764,432,0,52048,21549
48,72656,4872656,The Woodlands CDP, Texas,0,2016,112076,33.10,71.40,14.00,54153,57923,97357,3720,5460,0,0,93091,18985
48,74144,4874144,Tyler city, Texas,1,2016,104796,41.80,74.00,14.80,48952,55844,71494,23237,2799,280,0,80756,24040
48,75428,4875428,Victoria city, Texas,0,2016,67672,42.20,74.60,13.70,32496,35176,58049,5009,1396,101,164,31097,36575
48,76000,4876000,Waco city, Texas,1,2016,134422,48.50,77.20,12.20,65206,69216,90117,30745,2498,640,149,90935,43487
48,79000,4879000,Wichita Falls city, Texas,1,2016,104735,46.50,77.50,13.30,55483,49252,78901,12703,3329,856,151,81204,23531
49,43660,4943660,Layton city, Utah,1,2016,75658,43.80,66.70,10.20,36808,38850,63061,1525,1754,705,821,66484,9174
49,55980,4955980,Ogden city, Utah,1,2016,86709,44.50,70.70,9.50,45066,41643,74796,1432,1771,1065,141,56789,29920
49,57300,4957300,Orem city, Utah,1,2016,97508,50.40,71.10,9.80,50281,47227,85801,1368,1635,1358,784,80939,16569
49,62470,4962470,Provo city, Utah,1,2016,116874,66.60,78.40,5.30,58285,58589,104399,515,3532,890,1799,93429,23445
49,65330,4965330,St. George city, Utah,1,2016,82315,39.80,74.40,19.40,40330,41985,69725,456,629,789,869,69443,12872
49,67000,4967000,Salt Lake City city, Utah,1,2016,193776,50.70,79.00,10.50,100186,93590,140022,7022,9569,1730,2946,154048,39728
49,67440,4967440,Sandy city, Utah,1,2016,95827,38.00,73.80,14.10,46834,48993,88549,348,3046,422,208,86999,8828
49,70850,4970850,South Jordan city, Utah,0,2016,69034,43.60,68.70,9.20,35059,33975,-998,-998,-998,-998,-998,66404,2630
49,82950,4982950,West Jordan city, Utah,1,2016,113688,43.40,67.90,6.30,59223,54465,92944,322,2341,636,3886,91787,21901
49,83470,4983470,West Valley City city, Utah,1,2016,136579,43.50,68.40,8.40,70993,65586,76838,4588,6569,376,3713,82183,54396
51,01000,5101000,Alexandria city, Virginia,1,2016,155810,49.10,81.70,10.10,74560,81250,92717,34500,9726,99,146,129608,26202
51,03000,5103000,Arlington CDP, Virginia,0,2016,230050,51.90,82.20,9.60,114984,115066,162749,19802,23558,962,411,194678,35372
51,14440,5114440,Centreville CDP, Virginia,0,2016,68024,42.20,74.80,7.90,33867,34157,38736,4861,18770,84,329,58513,9511
51,16000,5116000,Chesapeake city, Virginia,1,2016,237940,40.70,75.80,12.50,116137,121803,147623,71159,7197,68,0,224343,13597
51,21088,5121088,Dale City CDP, Virginia,0,2016,72073,42.40,73.60,8.80,36227,35846,31207,17879,8570,0,0,50774,21299
51,35000,5135000,Hampton city, Virginia,1,2016,135410,42.00,79.00,14.20,64156,71254,56219,68730,3506,75,476,127980,7430
51,47672,5147672,Lynchburg city, Virginia,1,2016,80212,50.40,80.70,14.30,35920,44292,53004,23624,795,312,0,77404,2808
51,56000,5156000,Newport News city, Virginia,1,2016,181825,44.00,76.90,12.20,88786,93039,86739,73750,4472,430,202,165749,16076
51,57000,5157000,Norfolk city, Virginia,1,2016,245115,50.90,79.80,10.30,127741,117374,115675,100685,9313,832,496,226094,19021
51,64000,5164000,Portsmouth city, Virginia,1,2016,95252,41.60,76.40,14.00,45634,49618,38231,49467,1626,265,1001,91224,4028
51,67000,5167000,Richmond city, Virginia,1,2016,223170,49.00,82.10,11.90,106262,116908,101987,105155,4903,650,115,208656,14514
51,68000,5168000,Roanoke city, Virginia,1,2016,99660,39.10,77.60,15.20,47335,52325,63615,30307,3200,68,123,93444,6216
51,76432,5176432,Suffolk city, Virginia,1,2016,89273,38.30,75.20,13.70,43617,45656,45912,37324,1688,191,89,85640,3633
51,82000,5182000,Virginia Beach city, Virginia,1,2016,452602,43.00,77.50,13.20,222398,230204,303452,82660,30196,901,175,416167,36435
53,03180,5303180,Auburn city, Washington,1,2016,75968,38.70,73.90,11.00,37339,38629,48026,5401,6948,2449,1790,65302,10666
53,05210,5305210,Bellevue city, Washington,1,2016,141415,41.00,78.90,15.20,70126,71289,75456,4794,50111,121,470,133020,8395
53,05280,5305280,Bellingham city, Washington,1,2016,87577,53.70,83.90,13.40,42659,44918,69699,2085,5425,947,290,78598,8979
53,22640,5322640,Everett city, Washington,1,2016,109035,44.50,79.00,12.10,57171,51864,79608,4681,9952,1508,1564,92340,16695
53,23515,5323515,Federal Way city, Washington,1,2016,96748,41.00,74.60,13.80,45881,50867,57647,5951,12444,905,2451,75674,21074
53,35275,5335275,Kennewick city, Washington,1,2016,80469,39.80,71.30,13.40,40538,39931,65134,1110,2206,344,0,57073,23396
53,35415,5335415,Kent city, Washington,1,2016,127506,44.50,75.70,10.80,64371,63135,62039,14175,25478,534,1645,103952,23554
53,35940,5335940,Kirkland city, Washington,0,2016,87672,43.50,79.10,13.30,43922,43750,66935,1252,13587,180,0,81270,6402
53,43955,5343955,Marysville city, Washington,0,2016,67625,38.40,75.90,14.30,32175,35450,58328,277,4286,125,376,61614,6011
53,53545,5353545,Pasco city, Washington,0,2016,71934,44.00,65.80,7.60,36814,35120,42553,1382,647,609,759,30963,40971
53,57745,5357745,Renton city, Washington,1,2016,100952,43.80,78.00,11.50,50545,50407,47180,12634,22178,755,2890,90002,10950
53,63000,5363000,Seattle city, Washington,1,2016,704358,51.50,85.00,12.30,354197,350161,475419,50146,104955,2701,2098,659164,45194
53,67000,5367000,Spokane city, Washington,1,2016,215964,42.30,77.00,14.50,105039,110925,181230,3434,6186,5330,2166,201497,14467
53,67167,5367167,Spokane Valley city, Washington,1,2016,96337,40.10,78.40,16.30,48190,48147,87705,967,1238,855,360,90304,6033
53,70000,5370000,Tacoma city, Washington,1,2016,211304,43.50,77.10,12.00,106317,104987,132869,21790,21480,4164,2037,185493,25811
53,74060,5374060,Vancouver city, Washington,1,2016,174836,41.40,77.50,16.50,83469,91367,137738,4197,10538,909,2477,150234,24602
53,80010,5380010,Yakima city, Washington,1,2016,93974,39.20,70.70,13.90,45743,48231,70908,3116,1206,1899,0,47317,46657
55,02375,5502375,Appleton city, Wisconsin,1,2016,75465,41.60,73.10,12.20,37552,37913,64422,2402,4571,493,65,69972,5493
55,22300,5522300,Eau Claire city, Wisconsin,0,2016,67776,49.70,80.90,13.70,33255,34521,62345,614,3114,196,0,66448,1328
55,31000,5531000,Green Bay city, Wisconsin,1,2016,105142,42.80,75.90,10.90,53154,51988,82200,3493,4112,3765,0,90981,14161
55,39225,5539225,Kenosha city, Wisconsin,1,2016,99634,39.80,74.60,12.50,48717,50917,80060,10507,1629,688,175,83290,16344
72,06593,7206593,Bayamón zona urbana, Puerto Rico,0,2016,163941,39.70,81.30,20.30,76664,87277,115073,15784,459,51,0,1137,162804
15,71550,1571550,Urban Honolulu CDP, Hawaii,0,2017,350388,39.30,83.10,19.70,172554,177834,56481,7082,192699,545,22833,326056,24332
16,08830,1608830,Boise City city, Idaho,1,2017,226567,44.10,78.20,13.80,115099,111468,201009,4659,6275,697,181,205764,20803
16,52120,1652120,Meridian city, Idaho,1,2017,99938,39.30,70.70,12.60,49540,50398,92630,105,2075,120,0,92261,7677
16,56260,1656260,Nampa city, Idaho,1,2017,93585,47.00,73.50,13.40,48680,44905,77618,1172,570,876,51,69652,23933
17,02154,1702154,Arlington Heights village, Illinois,1,2017,75097,34.20,78.70,20.40,35849,39248,62493,2407,6096,0,0,68960,6137
17,03012,1703012,Aurora city, Illinois,1,2017,202548,42.80,71.40,10.50,102123,100425,117300,20307,20708,1051,1013,114093,88455
17,06613,1706613,Bloomington city, Illinois,1,2017,77941,45.60,79.40,13.20,37024,40917,60636,7954,7244,469,0,74089,3852
17,07133,1707133,Bolingbrook village, Illinois,1,2017,72155,41.70,74.30,9.60,35618,36537,33573,15452,9856,0,0,55062,17093
17,12385,1712385,Champaign city, Illinois,1,2017,87426,57.60,82.20,8.90,42539,44887,56068,17268,10388,160,0,81212,6214
17,14000,1714000,Chicago city, Illinois,1,2017,2716462,46.90,79.20,12.20,1317691,1398771,1354634,809079,181505,7819,390,1928484,787978
17,14351,1714351,Cicero town, Illinois,1,2017,82560,46.70,71.60,8.20,41727,40833,28317,1327,505,0,0,7842,74718
17,18823,1718823,Decatur city, Illinois,1,2017,68645,38.40,78.00,20.40,31752,36893,48035,15310,576,338,19,66360,2285
17,23074,1723074,Elgin city, Illinois,1,2017,114459,40.50,72.90,11.20,57155,57304,73410,4954,4553,2480,0,61167,53292
17,24582,1724582,Evanston city, Illinois,1,2017,74752,43.80,81.40,16.60,36507,38245,48766,13752,6534,0,0,65755,8997
17,38570,1738570,Joliet city, Illinois,1,2017,147150,43.90,73.10,10.30,73801,73349,92151,24986,2583,226,113,98116,49034
17,51622,1751622,Naperville city, Illinois,1,2017,148584,38.80,74.60,12.60,72503,76081,109460,6362,28152,0,0,140984,7600
17,57225,1757225,Palatine village, Illinois,1,2017,68610,39.80,74.70,13.00,33762,34848,45882,1328,6832,45,0,51858,16752
17,59000,1759000,Peoria city, Illinois,1,2017,115637,38.70,76.20,16.80,55272,60365,72979,30682,6504,71,0,108443,7194
17,65000,1765000,Rockford city, Illinois,1,2017,148287,37.60,75.30,16.50,72168,76119,102643,32584,4067,451,28,120190,28097
17,68003,1768003,Schaumburg village, Illinois,1,2017,73118,39.50,79.60,15.90,35365,37753,45922,3292,19196,130,0,67723,5395
17,70122,1770122,Skokie village, Illinois,0,2017,63984,32.00,77.50,19.30,28938,35046,41288,4253,15054,55,250,54194,9790
17,72000,1772000,Springfield city, Illinois,1,2017,114663,37.60,77.70,17.20,53725,60938,83754,22906,3925,16,58,111179,3484
17,79293,1779293,Waukegan city, Illinois,1,2017,88805,45.30,72.40,10.00,44364,44441,32882,20018,4365,985,82,41164,47641
18,05860,1805860,Bloomington city, Indiana,1,2017,85551,68.10,89.00,9.50,43444,42107,69976,3226,8148,189,47,81347,4204
18,10342,1810342,Carmel city, Indiana,1,2017,93148,36.90,73.60,14.20,46260,46888,75921,2618,10578,817,85,90848,2300
18,22000,1822000,Evansville city, Indiana,1,2017,117940,40.40,79.70,17.00,56350,61590,96714,14880,593,239,0,114507,3433
18,23278,1823278,Fishers city, Indiana,1,2017,90907,38.60,70.60,9.00,43587,47320,75954,6562,5782,0,0,86701,4206
18,25000,1825000,Fort Wayne city, Indiana,1,2017,254796,40.50,75.10,14.10,122966,131830,184984,38292,14039,792,0,230072,24724
18,27000,1827000,Gary city, Indiana,1,2017,76430,38.30,76.50,18.10,35534,40896,12035,60467,186,40,0,72072,4358
18,31000,1831000,Hammond city, Indiana,1,2017,76627,41.90,71.60,11.40,37766,38861,37528,15444,1492,332,0,46005,30622
18,36003,1836003,Indianapolis city (balance), Indiana,1,2017,857386,43.30,75.40,12.20,414040,443346,537680,238723,27007,1388,144,764344,93042
18,40788,1840788,Lafayette city, Indiana,1,2017,71225,42.70,76.30,13.90,36678,34547,62310,4896,611,73,0,59496,11729
18,51876,1851876,Muncie city, Indiana,1,2017,68450,53.50,83.30,13.20,32979,35471,56115,7578,859,0,0,65920,2530
18,71000,1871000,South Bend city, Indiana,1,2017,96143,43.10,75.20,13.30,47953,48190,61969,24718,973,309,0,81585,14558
19,01855,1901855,Ames city, Iowa,0,2017,66500,65.40,88.20,10.30,36003,30497,54844,2606,7553,79,0,64188,2312
19,12000,1912000,Cedar Rapids city, Iowa,1,2017,132240,41.30,76.20,16.00,64205,68035,110013,11145,3848,251,456,125980,6260
19,19000,1919000,Davenport city, Iowa,1,2017,102314,41.00,77.70,14.70,50424,51890,84720,10765,2699,348,0,93287,9027
19,21000,1921000,Des Moines city, Iowa,1,2017,217508,43.50,75.70,12.30,106125,111383,158470,22848,17604,862,307,186175,31333
19,38595,1938595,Iowa City city, Iowa,1,2017,75788,61.70,86.30,10.50,38131,37657,60817,5082,6623,65,0,70338,5450
19,73335,1973335,Sioux City city, Iowa,1,2017,84034,40.80,72.70,13.50,41218,42816,69598,3248,2845,2446,584,67356,16678
19,82425,1982425,Waterloo city, Iowa,1,2017,67588,39.60,77.00,15.80,32726,34862,51144,10773,1559,175,212,62601,4987
20,36000,2036000,Kansas City city, Kansas,1,2017,155031,40.70,71.90,11.50,76813,78218,89973,35200,6809,691,0,108024,47007
20,38900,2038900,Lawrence city, Kansas,1,2017,95000,57.30,83.30,11.70,45922,49078,76085,4424,6367,2940,0,88601,6399
20,52575,2052575,Olathe city, Kansas,1,2017,137500,42.60,70.70,10.50,67517,69983,115688,8912,6555,415,70,123803,13697
20,53775,2053775,Overland Park city, Kansas,1,2017,191263,40.50,78.30,15.50,96051,95212,157658,9203,16290,1703,210,177174,14089
20,64500,2064500,Shawnee city, Kansas,0,2017,65505,36.80,75.20,13.50,31849,33656,-998,-998,-998,-998,-998,61001,4504
20,71000,2071000,Topeka city, Kansas,1,2017,126588,39.30,76.70,17.50,62259,64329,99349,14888,2264,720,0,108406,18182
20,79000,2079000,Wichita city, Kansas,1,2017,390599,40.00,75.40,14.70,192567,198032,279723,43005,19548,1951,659,322210,68389
21,08902,2108902,Bowling Green city, Kentucky,0,2017,67067,52.70,78.60,10.40,31418,35649,49671,7621,3129,0,1532,62368,4699
21,46027,2146027,Lexington-Fayette urban county, Kentucky,1,2017,321959,46.00,78.90,12.90,158325,163634,243170,46595,11729,814,145,298823,23136
21,48006,2148006,Louisville/Jefferson County metro government (balance), Kentucky,1,2017,621337,40.40,77.20,14.40,302759,318578,430744,149461,18182,909,285,585310,36027
22,05000,2205000,Baton Rouge city, Louisiana,1,2017,225370,46.70,77.40,13.50,105153,120217,88963,121365,7850,1111,267,217704,7666
22,08920,2208920,Bossier City city, Louisiana,0,2017,68564,43.90,74.80,13.90,32500,36064,44446,20091,843,307,114,61436,7128
22,39475,2239475,Kenner city, Louisiana,1,2017,67464,38.20,77.20,16.00,31953,35511,41165,17984,2395,0,0,49076,18388
22,40735,2240735,Lafayette city, Louisiana,1,2017,126847,42.90,77.40,13.30,61386,65461,76388,42310,4003,270,0,122724,4123
22,41155,2241155,Lake Charles city, Louisiana,1,2017,77125,39.40,80.30,17.20,37138,39987,37445,36492,1931,49,0,74538,2587
22,50115,2250115,Metairie CDP, Louisiana,0,2017,146847,37.90,79.40,19.50,71251,75596,115612,16061,6835,371,0,123064,23783
22,55000,2255000,New Orleans city, Louisiana,1,2017,393292,43.50,79.90,14.10,186954,206338,133124,234026,11587,597,28,370968,22324
22,70000,2270000,Shreveport city, Louisiana,1,2017,191715,40.20,75.30,15.50,90501,101214,67308,113251,3320,1039,0,186799,4916
23,60545,2360545,Portland city, Maine,1,2017,66878,49.60,84.90,15.20,32838,34040,55865,7045,2281,144,0,64398,2480
24,04000,2404000,Baltimore city, Maryland,1,2017,611648,44.30,79.40,13.50,286883,324765,183988,383508,16415,2347,128,579153,32495
24,07125,2407125,Bethesda CDP, Maryland,0,2017,68297,33.90,75.60,17.70,32866,35431,54271,4860,6945,6,0,63786,4511
24,19125,2419125,Columbia CDP, Maryland,0,2017,103709,40.90,77.70,14.60,47681,56028,52035,30334,12689,1197,0,96102,7607
24,26000,2426000,Ellicott City CDP, Maryland,0,2017,76727,36.50,75.60,15.80,37833,38894,44377,6441,21104,99,0,73635,3092
24,30325,2430325,Frederick city, Maryland,0,2017,71397,42.80,78.70,13.70,35132,36265,48471,10174,5363,172,0,60668,10729
24,31175,2431175,Gaithersburg city, Maryland,0,2017,68721,41.30,73.60,12.70,34652,34069,29627,11718,10980,316,0,49625,19096
24,32025,2432025,Germantown CDP, Maryland,0,2017,95711,44.00,75.80,8.30,47329,48382,41630,23897,20023,409,0,71853,23858
24,32650,2432650,Glen Burnie CDP, Maryland,0,2017,70108,45.90,79.50,13.20,31493,38615,40118,19348,4224,0,163,65201,4907
24,67675,2467675,Rockville city, Maryland,0,2017,68400,39.80,76.90,16.40,32214,36186,36687,6827,14831,466,0,57517,10883
24,72450,2472450,Silver Spring CDP, Maryland,0,2017,80265,51.00,79.10,10.20,39156,41109,34516,23144,5146,481,0,61137,19128
24,81175,2481175,Waldorf CDP, Maryland,0,2017,69519,39.70,75.60,11.30,32712,36807,23841,38545,2900,354,57,63848,5671
25,07000,2507000,Boston city, Massachusetts,1,2017,683015,54.40,84.50,11.70,329816,353199,360756,176868,66207,2133,40,543522,139493
25,09000,2509000,Brockton city, Massachusetts,1,2017,95664,41.70,75.10,13.30,43880,51784,32762,39480,2163,485,0,86735,8929
25,11000,2511000,Cambridge city, Massachusetts,1,2017,113631,63.00,88.30,12.20,56985,56646,76656,11826,19018,58,87,104035,9596
25,23000,2523000,Fall River city, Massachusetts,1,2017,89415,36.20,77.70,15.90,42019,47396,67839,9721,2046,0,0,80296,9119
25,24960,2524960,Framingham CDP, Massachusetts,0,2017,72045,37.50,74.90,13.20,34545,37500,49786,8305,5038,514,0,60184,11861
25,34550,2534550,Lawrence city, Massachusetts,1,2017,80183,46.70,72.80,10.80,39406,40777,63108,3103,432,271,0,12302,67881
25,37000,2537000,Lowell city, Massachusetts,1,2017,111343,45.80,79.70,12.10,56472,54871,69623,7526,28244,825,67,89196,22147
25,37490,2537490,Lynn city, Massachusetts,1,2017,94064,44.00,79.70,13.60,48764,45300,48700,13404,6558,463,0,58592,35472
25,45000,2545000,New Bedford city, Massachusetts,1,2017,95110,42.70,79.10,15.00,46139,48971,61843,5578,2029,0,0,76355,18755
25,45560,2545560,Newton city, Massachusetts,1,2017,88989,39.40,79.90,17.40,40356,48633,67804,3299,13305,0,0,83491,5498
25,55745,2555745,Quincy city, Massachusetts,1,2017,94165,45.10,85.20,15.90,46122,48043,52409,4592,32865,69,365,91443,2722
25,62535,2562535,Somerville city, Massachusetts,1,2017,81361,61.50,87.30,9.20,41380,39981,62971,6214,7605,0,4,70597,10764
25,67000,2567000,Springfield city, Massachusetts,1,2017,154763,44.40,76.20,12.30,72705,82058,103166,33235,2832,1021,56,85296,69467
25,82000,2582000,Worcester city, Massachusetts,1,2017,185685,47.00,80.50,13.60,87756,97929,129300,24025,12612,1788,55,143349,42336
26,03000,2603000,Ann Arbor city, Michigan,1,2017,121461,61.30,87.10,12.10,59659,61802,85136,8567,22374,326,0,116127,5334
26,21000,2621000,Dearborn city, Michigan,1,2017,94497,42.60,69.60,11.90,46237,48260,84918,3477,1938,40,0,91291,3206
26,22000,2622000,Detroit city, Michigan,1,2017,673103,41.00,75.10,14.00,319063,354040,97402,532057,11938,2656,134,624775,48328
26,27440,2627440,Farmington Hills city, Michigan,1,2017,81048,38.10,83.40,19.70,40019,41029,50870,14166,13445,166,30,79314,1734
26,29000,2629000,Flint city, Michigan,1,2017,96439,41.50,78.60,13.80,48391,48048,36807,51514,1229,790,0,91871,4568
26,34000,2634000,Grand Rapids city, Michigan,1,2017,198811,49.60,77.80,11.40,99549,99262,131052,39083,7056,631,0,166795,32016
26,42160,2642160,Kalamazoo city, Michigan,1,2017,75802,57.70,82.30,11.30,38105,37697,52529,16826,1785,43,0,70736,5066
26,46000,2646000,Lansing city, Michigan,1,2017,115451,46.20,77.20,11.50,54786,60665,70081,26706,6457,692,0,100839,14612
26,49000,2649000,Livonia city, Michigan,1,2017,94108,35.50,81.70,20.70,45552,48556,84937,4907,2541,56,0,91758,2350
26,69035,2669035,Rochester Hills city, Michigan,1,2017,74198,35.50,77.60,18.30,35910,38288,60712,2413,8020,136,0,71789,2409
26,74900,2674900,Southfield city, Michigan,1,2017,73203,37.70,81.30,19.40,33365,39838,15034,51991,1513,36,0,71199,2004
26,76460,2676460,Sterling Heights city, Michigan,1,2017,132628,40.40,80.00,16.90,65147,67481,108981,8139,9319,402,0,125101,7527
26,80700,2680700,Troy city, Michigan,1,2017,83826,38.30,78.50,15.90,41435,42391,57206,3109,21178,405,0,81806,2020
26,84000,2684000,Warren city, Michigan,1,2017,135029,38.00,78.50,16.10,67195,67834,91620,27976,12584,38,80,132290,2739
26,86000,2686000,Westland city, Michigan,1,2017,81750,36.80,81.00,17.70,38107,43643,59182,14468,3353,623,0,78081,3669
26,88940,2688940,Wyoming city, Michigan,1,2017,75938,38.90,75.50,12.60,37409,38529,56169,4524,1555,717,139,59932,16006
27,06616,2706616,Bloomington city, Minnesota,1,2017,85863,34.60,81.60,21.10,41762,44101,64527,11314,3708,85,0,79504,6359
27,07966,2707966,Brooklyn Park city, Minnesota,1,2017,80573,39.10,72.70,13.00,38988,41585,37054,22323,15905,612,0,77031,3542
27,17000,2717000,Duluth city, Minnesota,1,2017,86048,46.80,81.80,15.30,41532,44516,77606,1874,1127,1667,60,83691,2357
27,17288,2717288,Eagan city, Minnesota,0,2017,66623,41.60,76.20,12.20,31886,34737,49683,7637,6322,32,289,64000,2623
27,40166,2740166,Maple Grove city, Minnesota,0,2017,71069,35.90,72.20,12.20,34557,36512,55995,7225,4497,240,0,69988,1081
27,43000,2743000,Minneapolis city, Minnesota,1,2017,422326,51.70,80.10,10.00,211482,210844,265357,76107,27118,7272,81,375951,46375
27,51730,2751730,Plymouth city, Minnesota,1,2017,78388,37.30,76.20,14.40,36128,42260,64168,4107,7139,678,0,74219,4169
27,54880,2754880,Rochester city, Minnesota,1,2017,115733,42.00,75.90,14.80,55312,60421,92692,9459,7560,329,0,109246,6487
27,56896,2756896,St. Cloud city, Minnesota,0,2017,65403,47.40,79.00,12.40,32876,32527,51348,9253,1987,394,0,63431,1972
27,58000,2758000,St. Paul city, Minnesota,1,2017,306604,47.40,74.30,10.20,151108,155496,171021,52354,61082,2382,123,276597,30007
27,71428,2771428,Woodbury city, Minnesota,0,2017,69755,38.90,71.00,12.10,33593,36162,55898,4404,7101,236,9,66920,2835
28,29700,2829700,Gulfport city, Mississippi,1,2017,71812,40.50,75.40,14.50,32958,38854,40391,28821,292,596,0,68197,3615
28,36000,2836000,Jackson city, Mississippi,1,2017,167250,43.30,74.80,12.40,78721,88529,-998,-998,-998,-998,-998,165245,2005
29,15670,2915670,Columbia city, Missouri,1,2017,121720,56.00,82.10,10.80,59077,62643,92780,13174,7066,437,1769,117401,4319
29,35000,2935000,Independence city, Missouri,1,2017,117308,38.00,74.60,16.70,56585,60723,89404,6683,1383,923,1527,100200,17108
29,38000,2938000,Kansas City city, Missouri,1,2017,488825,43.40,77.30,12.70,237521,251304,293200,139386,15452,2850,647,442850,45975
29,41348,2941348,Lee's Summit city, Missouri,1,2017,97101,36.40,72.70,15.30,46677,50424,85727,5690,2185,174,80,92382,4719
29,54074,2954074,O'Fallon city, Missouri,1,2017,87578,40.30,70.30,11.60,45455,42123,79044,2341,2964,0,0,83942,3636
29,64082,2964082,St. Charles city, Missouri,0,2017,70335,46.10,84.20,16.80,32658,37677,60311,4562,1806,72,0,67526,2809
29,64550,2964550,St. Joseph city, Missouri,1,2017,76643,40.40,77.00,16.10,37686,38957,65430,3591,959,270,1209,70779,5864
29,65000,2965000,St. Louis city, Missouri,1,2017,308626,45.30,80.60,12.90,149544,159082,142956,144539,10477,1196,0,296179,12447
29,70000,2970000,Springfield city, Missouri,1,2017,167376,46.80,81.80,16.10,81045,86331,148924,6072,3879,1000,384,158815,8561
30,06550,3006550,Billings city, Montana,1,2017,109642,39.00,77.40,17.90,53417,56225,96903,1174,893,4263,579,102706,6936
30,50200,3050200,Missoula city, Montana,1,2017,73338,52.10,81.30,12.60,36751,36587,68104,106,1424,1033,0,71579,1759
31,28000,3128000,Lincoln city, Nebraska,1,2017,284734,45.90,76.90,13.10,143324,141410,241622,11717,14122,2053,174,262813,21921
31,37000,3137000,Omaha city, Nebraska,1,2017,466903,42.20,75.20,13.00,230216,236687,365552,57454,17470,2358,312,400847,66056
32,23770,3223770,Enterprise CDP, Nevada,0,2017,168011,45.90,74.70,11.30,85073,82938,90654,17653,37983,161,2445,135975,32036
32,31900,3231900,Henderson city, Nevada,1,2017,302535,36.50,79.70,20.70,148218,154317,228746,19170,32103,612,703,258058,44477
32,40000,3240000,Las Vegas city, Nevada,1,2017,641708,39.80,76.30,14.20,320805,320903,398287,68390,45490,5423,5832,422488,219220
32,51800,3251800,North Las Vegas city, Nevada,1,2017,242949,42.50,71.30,10.40,121077,121872,124071,51743,18558,1956,736,138538,104411
32,54600,3254600,Paradise CDP, Nevada,0,2017,235123,44.60,80.50,12.60,117778,117345,113030,28737,31043,1584,2169,159104,76019
32,60600,3260600,Reno city, Nevada,1,2017,248860,42.40,77.60,14.50,123719,125141,184947,7791,16988,2949,2309,183895,64965
32,68400,3268400,Sparks city, Nevada,1,2017,100878,40.30,78.70,16.70,50909,49969,77994,1341,6289,1878,44,72984,27894
32,68585,3268585,Spring Valley CDP, Nevada,0,2017,211280,41.70,78.30,13.90,104664,106616,113309,27443,32931,548,1793,153780,57500
32,71400,3271400,Sunrise Manor CDP, Nevada,0,2017,193055,44.70,72.80,10.10,96010,97045,90714,28130,10516,3191,968,89830,103225
33,45140,3345140,Manchester city, New Hampshire,1,2017,111194,44.90,79.00,12.40,57626,53568,97724,5688,4146,127,57,100098,11096
33,50260,3350260,Nashua city, New Hampshire,1,2017,88350,40.20,80.20,15.60,42371,45979,69419,5078,8908,112,0,77171,11179
34,03580,3403580,Bayonne city, New Jersey,0,2017,67178,40.70,78.50,14.60,32340,34838,45540,4683,4339,201,0,42123,25055
34,10000,3410000,Camden city, New Jersey,1,2017,74534,44.00,69.80,10.40,33364,41170,23168,32032,2286,438,155,39823,34711
34,13690,3413690,Clifton city, New Jersey,1,2017,86615,40.90,81.00,15.50,41581,45034,54474,4764,10170,59,0,51725,34890
34,19390,3419390,East Orange city, New Jersey,0,2017,65399,44.90,78.70,13.30,29543,35856,2274,55684,1294,0,0,57358,8041
34,21000,3421000,Elizabeth city, New Jersey,1,2017,130222,42.90,71.90,10.10,64678,65544,52817,23971,1752,837,0,41920,88302
34,36000,3436000,Jersey City city, New Jersey,1,2017,270750,49.40,78.80,11.40,133799,136951,92904,63621,71641,1910,70,190928,79822
34,51000,3451000,Newark city, New Jersey,1,2017,285156,44.80,75.40,10.60,138029,147127,77158,144527,5106,488,215,182070,103086
34,56550,3456550,Passaic city, New Jersey,1,2017,71245,42.90,65.50,7.50,36728,34517,57198,4576,1420,6,0,18393,52852
34,57000,3457000,Paterson city, New Jersey,1,2017,148678,44.50,72.80,10.60,70773,77905,48001,36991,6700,71,0,58610,90068
34,73110,3473110,Toms River CDP, New Jersey,0,2017,89861,35.10,77.60,18.20,41960,47901,75116,5295,3349,82,0,82388,7473
34,74000,3474000,Trenton city, New Jersey,1,2017,84971,43.70,73.70,10.10,42531,42440,34506,45681,442,117,0,53874,31097
34,74630,3474630,Union City city, New Jersey,1,2017,70409,48.80,78.00,9.90,33693,36716,54528,3016,1953,154,0,18091,52318
35,02000,3502000,Albuquerque city, New Mexico,1,2017,558558,41.50,77.20,15.50,272308,286250,427155,17234,16181,24814,460,281307,277251
35,39380,3539380,Las Cruces city, New Mexico,1,2017,101706,43.60,76.40,14.30,51099,50607,84861,3342,1437,1263,0,39541,62165
35,63460,3563460,Rio Rancho city, New Mexico,1,2017,96168,39.60,76.00,15.20,46502,49666,82754,2060,1536,1581,102,54581,41587
35,70500,3570500,Santa Fe city, New Mexico,1,2017,83763,36.70,80.80,21.70,39549,44214,72668,1471,1556,1139,272,35878,47885
36,01000,3601000,Albany city, New York,1,2017,98252,50.50,80.90,13.50,46328,51924,52325,27944,8647,337,0,87833,10419
36,08026,3608026,Brentwood CDP, New York,0,2017,66458,46.70,75.20,7.80,32322,34136,41852,9367,543,189,0,15254,51204
36,11000,3611000,Buffalo city, New York,1,2017,258592,45.80,77.70,12.00,123489,135103,120836,92529,17442,894,8,227211,31381
36,15000,3615000,Cheektowaga CDP, New York,0,2017,73232,39.40,81.40,17.70,35834,37398,58081,11004,1355,212,0,71215,2017
36,49121,3649121,Mount Vernon city, New York,1,2017,68702,41.80,83.40,19.10,30077,38625,12392,47745,2322,374,0,59765,8937
36,50617,3650617,New Rochelle city, New York,1,2017,79956,40.10,81.90,16.40,38526,41430,44955,16122,4005,0,129,57014,22942
36,51000,3651000,New York city, New York,1,2017,8622698,43.70,79.30,14.30,4112539,4510159,3635789,2094132,1252589,35124,4501,6105269,2517429
36,63000,3663000,Rochester city, New York,1,2017,208049,46.50,78.80,11.80,100561,107488,94639,84754,7937,1946,0,171663,36386
36,65508,3665508,Schenectady city, New York,1,2017,65626,41.80,79.30,12.70,30251,35375,39908,14336,5001,211,0,59067,6559
36,73000,3673000,Syracuse city, New York,1,2017,143398,47.00,77.10,11.90,67752,75646,75611,44421,12536,1368,11,129008,14390
36,84000,3684000,Yonkers city, New York,1,2017,202008,39.90,77.90,17.10,98347,103661,107404,36815,15098,2446,247,124103,77905
37,02140,3702140,Asheville city, North Carolina,1,2017,91916,42.10,83.10,19.90,43818,48098,77066,11683,1015,173,0,86161,5755
37,10740,3710740,Cary town, North Carolina,1,2017,166032,37.10,75.10,12.80,82634,83398,113595,10200,33395,579,0,152017,14015
37,12000,3712000,Charlotte city, North Carolina,1,2017,859052,46.20,76.90,10.30,413747,445305,422843,295190,55381,4117,376,736148,122904
37,14100,3714100,Concord city, North Carolina,1,2017,92072,40.60,73.50,12.00,46815,45257,61079,19412,4309,772,0,78193,13879
37,19000,3719000,Durham city, North Carolina,1,2017,267932,47.00,78.50,12.10,124894,143038,133399,103002,13345,567,123,232506,35426
37,22920,3722920,Fayetteville city, North Carolina,1,2017,209913,48.10,77.40,12.20,106697,103216,93664,87632,6798,2293,1425,183656,26257
37,25580,3725580,Gastonia city, North Carolina,1,2017,76606,38.40,77.20,16.70,36117,40489,50071,21548,1302,233,0,68351,8255
37,28000,3728000,Greensboro city, North Carolina,1,2017,290201,43.50,79.00,13.80,136581,153620,139750,124515,12969,1430,199,270237,19964
37,28080,3728080,Greenville city, North Carolina,1,2017,92171,54.70,80.10,10.70,41413,50758,53154,32920,1174,0,176,87071,5100
37,31400,3731400,High Point city, North Carolina,1,2017,111213,40.60,76.00,15.80,50953,60260,58283,40001,7755,731,19,101085,10128
37,34200,3734200,Jacksonville city, North Carolina,1,2017,72448,63.40,76.90,6.30,44516,27932,49008,15370,2855,357,0,60751,11697
37,55000,3755000,Raleigh city, North Carolina,1,2017,464972,50.00,78.90,10.10,225445,239527,264298,135972,23510,1169,373,413886,51086
37,74440,3774440,Wilmington city, North Carolina,1,2017,119048,44.10,82.70,16.20,54908,64140,91907,20586,1167,464,1124,111685,7363
37,75000,3775000,Winston-Salem city, North Carolina,1,2017,244592,42.20,77.50,14.20,115929,128663,141837,82611,7328,1179,325,210114,34478
38,07200,3807200,Bismarck city, North Dakota,0,2017,71574,40.80,78.20,16.00,35793,35781,64899,1791,685,2807,0,70005,1569
38,25700,3825700,Fargo city, North Dakota,1,2017,123590,51.90,79.00,10.90,63384,60206,103635,9715,4778,1565,68,120005,3585
39,01000,3901000,Akron city, Ohio,1,2017,197849,41.70,79.10,14.80,93399,104450,118028,61571,8007,618,231,192313,5536
39,12000,3912000,Canton city, Ohio,1,2017,70893,42.30,76.50,13.10,33880,37013,51995,13771,370,136,43,68528,2365
39,15000,3915000,Cincinnati city, Ohio,1,2017,301305,46.60,78.90,13.00,146042,155263,151869,128044,7944,258,531,289518,11787
39,16000,3916000,Cleveland city, Ohio,1,2017,385552,41.10,77.10,13.70,182588,202964,150623,187759,9319,1871,36,337590,47962
39,18000,3918000,Columbus city, Ohio,1,2017,881901,48.20,77.40,10.20,432198,449703,520193,252625,53100,2698,369,826119,55782
39,21000,3921000,Dayton city, Ohio,1,2017,140379,44.60,79.50,12.00,70968,69411,75045,57356,897,404,0,134614,5765
39,44856,3944856,Lorain city, Ohio,0,2017,63840,38.10,76.10,17.80,30683,33157,45638,10618,1035,766,0,44826,19014
39,61000,3961000,Parma city, Ohio,1,2017,79159,37.00,83.50,17.90,38766,40393,71137,3035,1173,494,0,75621,3538
39,77000,3977000,Toledo city, Ohio,1,2017,276494,40.90,76.90,14.10,132740,143754,174497,76093,3679,675,85,253698,22796
39,88000,3988000,Youngstown city, Ohio,1,2017,64585,39.20,77.90,16.20,32365,32220,30019,26630,586,382,44,56541,8044
40,09050,4009050,Broken Arrow city, Oklahoma,1,2017,110468,38.40,73.50,13.60,54357,56111,85818,4618,4496,5246,80,102271,8197
40,23200,4023200,Edmond city, Oklahoma,1,2017,91936,40.50,74.50,15.70,43683,48253,73117,5530,3575,1629,0,86620,5316
40,41850,4041850,Lawton city, Oklahoma,1,2017,93717,46.50,76.10,11.90,48139,45578,54392,16567,3103,5095,657,80593,13124
40,52500,4052500,Norman city, Oklahoma,1,2017,122842,53.10,81.60,12.20,62107,60735,92920,6656,5142,4087,0,113222,9620
40,55000,4055000,Oklahoma City city, Oklahoma,1,2017,643574,41.90,73.60,12.10,319377,324197,434367,96880,29388,15701,469,514916,128658
40,75000,4075000,Tulsa city, Oklahoma,1,2017,402227,41.10,75.90,14.20,193052,209175,259527,60102,16462,17280,546,334361,67866
41,05350,4105350,Beaverton city, Oregon,1,2017,97529,44.20,80.70,13.90,46400,51129,70799,1911,14708,1184,0,84681,12848
41,05800,4105800,Bend city, Oregon,1,2017,94527,36.00,76.00,18.40,43773,50754,88534,969,2026,564,0,83551,10976
41,23850,4123850,Eugene city, Oregon,1,2017,168909,47.50,82.90,16.60,82936,85973,142508,2008,7442,558,94,154429,14480
41,31250,4131250,Gresham city, Oregon,1,2017,111039,42.20,76.20,13.10,55341,55698,84795,7469,5908,1758,51,91684,19355
41,34100,4134100,Hillsboro city, Oregon,1,2017,106903,47.90,75.90,9.00,53652,53251,76436,2689,12829,146,394,80780,26123
41,47000,4147000,Medford city, Oregon,1,2017,81777,37.80,76.10,19.00,39261,42516,73369,398,1186,2594,34,69393,12384
41,59000,4159000,Portland city, Oregon,1,2017,648121,47.60,81.60,12.50,321499,326622,500694,35587,52428,5994,4952,580570,67551
41,64900,4164900,Salem city, Oregon,1,2017,169790,41.40,75.60,14.90,88283,81507,136140,2379,4644,1450,3930,127946,41844
42,02000,4202000,Allentown city, Pennsylvania,1,2017,121278,46.00,74.10,11.30,58637,62641,77546,15967,2797,1486,0,57171,64107
42,06088,4206088,Bethlehem city, Pennsylvania,1,2017,76469,45.70,80.20,13.80,35861,40608,57747,9135,1945,57,0,54885,21584
42,24000,4224000,Erie city, Pennsylvania,1,2017,97369,41.90,77.50,14.70,48482,48887,71712,14495,3175,91,47,90026,7343
42,60000,4260000,Philadelphia city, Pennsylvania,1,2017,1580863,44.80,78.20,13.40,748125,832738,665060,663708,115279,5742,406,1346680,234183
42,61000,4261000,Pittsburgh city, Pennsylvania,1,2017,302414,51.00,85.70,15.40,149787,152627,202557,66826,19576,748,104,293202,9212
42,63624,4263624,Reading city, Pennsylvania,1,2017,88418,43.80,69.60,10.20,42478,45940,43674,16110,402,1730,0,29682,58736
42,69000,4269000,Scranton city, Pennsylvania,1,2017,77597,42.60,78.40,16.90,38262,39335,66389,2822,4825,24,78,66416,11181
44,19180,4419180,Cranston city, Rhode Island,1,2017,81192,39.50,78.10,17.70,41677,39515,63746,4899,6707,554,41,67660,13532
44,54640,4454640,Pawtucket city, Rhode Island,1,2017,72006,44.20,79.10,13.70,36738,35268,43971,11299,1669,384,42,54104,17902
44,59000,4459000,Providence city, Rhode Island,1,2017,180388,47.70,77.60,11.80,87472,92916,109883,31037,9371,1578,648,102495,77893
44,74300,4474300,Warwick city, Rhode Island,1,2017,80873,37.30,82.20,19.20,38411,42462,73430,1430,2890,39,0,75850,5023
45,13330,4513330,Charleston city, South Carolina,1,2017,139906,47.10,82.30,13.50,68879,71027,105774,29800,1330,247,0,135404,4502
45,16000,4516000,Columbia city, South Carolina,1,2017,133578,57.20,84.50,9.30,67831,65747,67486,56854,4285,323,14,125993,7585
45,30850,4530850,Greenville city, South Carolina,0,2017,68223,48.10,84.80,13.20,33265,34958,47062,16321,1541,357,246,64037,4186
45,48535,4548535,Mount Pleasant town, South Carolina,1,2017,86668,35.10,78.30,18.60,40963,45705,76930,3615,1947,219,0,85208,1460
45,50875,4550875,North Charleston city, South Carolina,1,2017,112742,44.80,76.50,11.40,55158,57584,58536,49050,1333,325,0,100185,12557
45,61405,4561405,Rock Hill city, South Carolina,1,2017,73064,47.00,77.20,11.00,34458,38606,40955,28137,1680,162,0,69745,3319
46,52980,4652980,Rapid City city, South Dakota,1,2017,74418,38.90,76.90,18.20,36967,37451,59634,957,1246,8444,198,70601,3817
46,59020,4659020,Sioux Falls city, South Dakota,1,2017,176898,41.60,75.70,12.80,87562,89336,150977,11396,3756,2802,37,167837,9061
47,14000,4714000,Chattanooga city, Tennessee,1,2017,179130,41.90,81.20,17.70,82083,97047,109476,57983,6361,259,0,167052,12078
47,15160,4715160,Clarksville city, Tennessee,1,2017,153210,50.40,72.30,8.10,76094,77116,102154,35411,3369,672,860,135017,18193
47,27740,4727740,Franklin city, Tennessee,0,2017,78311,38.00,77.80,15.00,36895,41416,64193,6198,5472,31,0,73128,5183
47,37640,4737640,Jackson city, Tennessee,0,2017,66856,39.90,76.30,14.60,30743,36113,-998,-998,-998,-998,-998,63198,3658
47,38320,4738320,Johnson City city, Tennessee,0,2017,65816,46.40,79.80,14.20,31173,34643,55454,5230,2360,206,0,61761,4055
47,40000,4740000,Knoxville city, Tennessee,1,2017,187344,48.50,80.00,12.60,90919,96425,142909,32623,4006,287,0,175285,12059
47,48000,4748000,Memphis city, Tennessee,1,2017,652231,42.90,74.70,12.50,307409,344822,190438,415179,10949,1332,346,601850,50381
47,51560,4751560,Murfreesboro city, Tennessee,1,2017,136372,50.60,74.00,8.70,66707,69665,97605,29076,3869,264,0,125994,10378
47,52006,4752006,Nashville-Davidson metropolitan government (balance), Tennessee,1,2017,665967,47.00,79.00,11.60,321749,344218,427261,181659,24150,1507,598,596393,69574
48,01000,4801000,Abilene city, Texas,1,2017,123304,47.40,76.20,13.10,64353,58951,83534,13074,2945,1155,0,90033,33271
48,01924,4801924,Allen city, Texas,1,2017,100679,37.60,70.20,8.70,48298,52381,70552,6575,17968,231,0,90031,10648
48,03000,4803000,Amarillo city, Texas,1,2017,200558,41.60,72.80,12.70,100562,99996,164362,12974,7261,763,231,132272,68286
48,04000,4804000,Arlington city, Texas,1,2017,396407,43.70,73.00,10.20,192415,203992,235389,99168,22775,1188,404,277928,118479
48,04462,4804462,Atascocita CDP, Texas,0,2017,84443,40.50,67.90,8.10,42445,41998,58675,14677,3068,433,0,57819,26624
48,05000,4805000,Austin city, Texas,1,2017,950714,51.70,79.70,9.40,481582,469132,680312,73472,71831,7793,208,625741,324973
48,06128,4806128,Baytown city, Texas,1,2017,77862,42.60,73.60,12.40,37885,39977,60862,11978,525,242,133,42260,35602
48,07000,4807000,Beaumont city, Texas,1,2017,119126,42.00,73.30,13.00,58577,60549,54560,55796,3269,0,155,97717,21409
48,10768,4810768,Brownsville city, Texas,1,2017,183292,42.00,70.40,12.70,90216,93076,177940,364,441,367,0,10964,172328
48,10912,4810912,Bryan city, Texas,1,2017,84029,49.40,76.40,11.50,41713,42316,61756,14189,1590,95,33,50285,33744
48,13024,4813024,Carrollton city, Texas,1,2017,135709,43.50,75.60,9.60,66354,69355,97380,13698,18079,1307,0,85001,50708
48,13552,4813552,Cedar Park city, Texas,0,2017,75238,46.40,69.00,7.20,39202,36036,59069,2046,6511,209,40,57448,17790
48,15976,4815976,College Station city, Texas,1,2017,113563,66.00,82.60,6.00,58488,55075,88010,8571,11197,503,0,95997,17566
48,16432,4816432,Conroe city, Texas,0,2017,84379,40.80,72.40,12.90,40632,43747,70336,8748,1624,136,73,54650,29729
48,17000,4817000,Corpus Christi city, Texas,1,2017,325600,41.50,75.20,13.90,160180,165420,294497,12879,7659,1462,137,120023,205577
48,19000,4819000,Dallas city, Texas,1,2017,1341103,46.60,74.90,10.50,661926,679177,843610,328114,49720,4245,959,779648,561455
48,19972,4819972,Denton city, Texas,1,2017,136266,51.80,81.40,11.50,66388,69878,104612,13388,6396,443,280,101015,35251
48,22660,4822660,Edinburg city, Texas,1,2017,90271,45.60,66.40,8.00,41853,48418,80715,2184,2828,355,0,11318,78953
48,24000,4824000,El Paso city, Texas,1,2017,683583,42.60,73.10,12.70,334472,349111,519553,25511,10178,3424,812,127004,556579
48,26232,4826232,Flower Mound town, Texas,0,2017,76592,33.10,72.90,11.00,37006,39586,58946,5153,8547,204,83,69863,6729
48,27000,4827000,Fort Worth city, Texas,1,2017,876060,45.00,73.00,9.90,427742,448318,556658,155053,38469,2323,404,559724,316336
48,27684,4827684,Frisco city, Texas,1,2017,177281,40.00,68.50,7.90,88785,88496,116863,11427,36615,889,33,152238,25043
48,29000,4829000,Garland city, Texas,1,2017,237607,40.70,74.70,12.20,119791,117816,156964,34742,25466,884,0,142898,94709
48,29336,4829336,Georgetown city, Texas,0,2017,70696,33.00,81.70,28.20,32148,38548,60049,3831,321,108,63,57831,12865
48,30464,4830464,Grand Prairie city, Texas,1,2017,193812,42.10,71.40,8.60,94632,99180,116834,43092,15401,879,144,103200,90612
48,32372,4832372,Harlingen city, Texas,0,2017,65462,37.80,65.50,14.80,33502,31960,59188,540,1656,424,0,13260,52202
48,35000,4835000,Houston city, Texas,1,2017,2313230,45.50,74.60,10.60,1156106,1157124,1371725,530579,150310,6985,1118,1280610,1032620
48,37000,4837000,Irving city, Texas,1,2017,240369,48.10,71.80,7.10,122086,118283,113887,35875,45151,1663,72,135560,104809
48,39148,4839148,Killeen city, Texas,1,2017,145484,51.30,70.60,6.80,70277,75207,63583,54588,7910,1489,2070,104983,40501
48,41464,4841464,Laredo city, Texas,1,2017,261935,43.10,66.70,9.30,127842,134093,251077,581,1562,569,93,12191,249744
48,41980,4841980,League City city, Texas,1,2017,105105,41.90,68.00,9.30,50718,54387,85771,9045,7695,178,0,89164,15941
48,42508,4842508,Lewisville city, Texas,1,2017,106656,50.10,77.00,8.10,52608,54048,66848,18207,12924,757,149,73309,33347
48,43888,4843888,Longview city, Texas,1,2017,83081,42.30,73.80,14.60,40937,42144,59453,19200,1314,21,375,66406,16675
48,45000,4845000,Lubbock city, Texas,1,2017,253887,48.40,77.20,12.10,123407,130480,207562,21585,7070,2135,259,162407,91480
48,45384,4845384,McAllen city, Texas,1,2017,142699,41.00,73.40,13.80,73765,68934,108627,1066,3478,700,372,20938,121761
48,45744,4845744,McKinney city, Texas,1,2017,181330,41.10,69.30,9.90,86229,95101,135273,22531,15911,901,0,149974,31356
48,46452,4846452,Mansfield city, Texas,0,2017,69007,41.70,71.90,10.10,33907,35100,49900,12609,1898,77,0,55930,13077
48,47892,4847892,Mesquite city, Texas,1,2017,143822,39.40,68.70,9.90,70341,73481,96586,32704,4165,418,0,81117,62705
48,48072,4848072,Midland city, Texas,1,2017,136090,43.90,72.70,11.30,69972,66118,112372,11290,3339,419,0,76593,59497
48,48768,4848768,Mission city, Texas,1,2017,84428,39.40,70.90,15.40,39804,44624,-998,-998,-998,-998,-998,9906,74522
48,48804,4848804,Missouri City city, Texas,1,2017,72519,35.40,74.40,15.60,35054,37465,21966,26821,19363,0,0,59791,12728
48,50820,4850820,New Braunfels city, Texas,0,2017,82306,40.50,71.90,14.90,40618,41688,76133,1059,1077,438,0,55593,26713
48,52356,4852356,North Richland Hills city, Texas,0,2017,70446,35.90,78.20,17.00,34462,35984,58051,3588,3385,1430,77,57832,12614
48,53388,4853388,Odessa city, Texas,1,2017,117105,46.10,71.20,9.90,56690,60415,85447,6580,2163,432,277,50596,66509
48,56000,4856000,Pasadena city, Texas,1,2017,153533,42.50,68.70,9.10,80017,73516,136392,5541,2801,364,45,44043,109490
48,56348,4856348,Pearland city, Texas,1,2017,125198,42.30,71.90,10.40,61341,63857,79573,23842,14143,1025,0,94821,30377
48,57200,4857200,Pharr city, Texas,1,2017,79491,41.60,67.10,12.50,40961,38530,-998,-998,-998,-998,-998,4002,75489
48,58016,4858016,Plano city, Texas,1,2017,285312,41.20,78.10,13.10,141927,143385,188118,26049,56201,1173,277,243470,41842
48,61796,4861796,Richardson city, Texas,1,2017,116783,42.70,76.40,16.40,56838,59945,79246,12610,17220,208,236,95062,21721
48,63500,4863500,Round Rock city, Texas,1,2017,123560,46.30,73.20,8.20,61648,61912,88008,15202,9943,164,0,87676,35884
48,64472,4864472,San Angelo city, Texas,1,2017,94940,43.40,77.80,15.80,45984,48956,73296,5202,1308,389,108,52754,42186
48,65000,4865000,San Antonio city, Texas,1,2017,1511913,44.30,75.20,12.20,745850,766063,1206751,105602,39920,6373,1619,542848,969065
48,70808,4870808,Sugar Land city, Texas,1,2017,88488,38.80,78.90,13.80,43556,44932,44629,2781,38239,169,0,77135,11353
48,72176,4872176,Temple city, Texas,0,2017,74494,39.50,73.50,15.00,34689,39805,60080,10471,770,210,0,54725,19769
48,72656,4872656,The Woodlands CDP, Texas,0,2017,115097,34.40,74.30,11.60,57807,57290,94997,4943,9770,244,223,99495,15602
48,74144,4874144,Tyler city, Texas,1,2017,104998,41.60,75.60,16.60,49296,55702,71821,27141,2052,254,0,81992,23006
48,75428,4875428,Victoria city, Texas,0,2017,67102,40.50,74.50,15.60,32170,34932,57456,5467,386,519,0,31402,35700
48,76000,4876000,Waco city, Texas,1,2017,136437,48.60,75.30,12.10,65256,71181,93572,28535,3527,1349,0,91119,45318
48,79000,4879000,Wichita Falls city, Texas,1,2017,104745,46.50,78.10,14.00,54105,50640,74665,13096,2130,1306,88,81836,22909
49,43660,4943660,Layton city, Utah,1,2017,76694,44.20,70.00,10.60,38705,37989,67966,925,2061,642,832,67856,8838
49,55980,4955980,Ogden city, Utah,1,2017,87037,45.10,72.50,10.90,44474,42563,69580,2241,512,1226,193,58286,28751
49,57300,4957300,Orem city, Utah,1,2017,97840,48.50,68.80,9.10,50264,47576,87802,482,2972,786,1905,85035,12805
49,62470,4962470,Provo city, Utah,1,2017,117331,64.10,78.90,6.20,57144,60187,103720,1254,3520,330,530,96987,20344
49,65330,4965330,St. George city, Utah,1,2017,84390,37.40,75.80,23.60,42516,41874,75083,931,2591,87,1237,74898,9492
49,67000,4967000,Salt Lake City city, Utah,1,2017,200538,51.30,78.10,10.50,99185,101353,146460,3419,10910,3342,3906,158831,41707
49,67440,4967440,Sandy city, Utah,1,2017,96146,40.50,74.00,14.10,48038,48108,88188,508,2539,314,282,84517,11629
49,70850,4970850,South Jordan city, Utah,0,2017,70953,38.40,68.00,11.60,33932,37021,62795,322,3180,201,1142,66159,4794
49,82950,4982950,West Jordan city, Utah,1,2017,113921,48.90,69.10,6.90,56801,57120,83353,1483,3783,748,445,85945,27976
49,83470,4983470,West Valley City city, Utah,1,2017,136166,46.00,69.50,9.60,72303,63863,75672,4128,6997,955,3721,86486,49680
51,01000,5101000,Alexandria city, Virginia,1,2017,160035,49.60,82.00,11.20,76850,83185,98509,37374,9296,595,60,133405,26630
51,03000,5103000,Arlington CDP, Virginia,0,2017,234965,51.50,82.10,10.20,116424,118541,166594,22603,24948,648,0,198228,36737
51,14440,5114440,Centreville CDP, Virginia,0,2017,78355,41.90,75.30,7.60,39362,38993,37288,8720,25068,247,58,65661,12694
51,16000,5116000,Chesapeake city, Virginia,1,2017,240397,40.10,75.70,12.80,117602,122795,146245,73562,7690,580,71,225576,14821
51,21088,5121088,Dale City CDP, Virginia,0,2017,70223,41.50,75.30,9.80,35995,34228,32753,18163,5259,184,118,48274,21949
51,35000,5135000,Hampton city, Virginia,1,2017,134669,42.90,79.10,15.00,65262,69407,54485,66723,3334,436,159,126956,7713
51,47672,5147672,Lynchburg city, Virginia,1,2017,80995,51.80,80.60,14.30,37085,43910,52171,22349,2168,555,31,77742,3253
51,56000,5156000,Newport News city, Virginia,1,2017,179388,44.20,76.80,12.70,86834,92554,87810,72769,5799,928,159,163100,16288
51,57000,5157000,Norfolk city, Virginia,1,2017,244703,51.30,80.20,10.90,127975,116728,113412,101382,8664,1095,137,225100,19603
51,64000,5164000,Portsmouth city, Virginia,1,2017,94572,41.50,77.00,14.60,45149,49423,37326,50430,1294,494,70,90371,4201
51,67000,5167000,Richmond city, Virginia,1,2017,227032,48.70,82.20,12.70,107065,119967,103616,107022,4645,90,0,211731,15301
51,68000,5168000,Roanoke city, Virginia,1,2017,99837,38.50,78.30,16.90,47869,51968,61187,28160,3141,337,0,93471,6366
51,76432,5176432,Suffolk city, Virginia,1,2017,90237,37.90,75.60,14.20,43664,46573,46675,37496,2023,323,0,86232,4005
51,82000,5182000,Virginia Beach city, Virginia,1,2017,450435,42.70,77.70,13.70,221666,228769,294819,85486,30751,1123,365,413712,36723
53,03180,5303180,Auburn city, Washington,1,2017,79619,43.80,75.00,8.90,40175,39444,55067,3120,8951,915,2918,70333,9286
53,05210,5305210,Bellevue city, Washington,1,2017,144459,42.70,80.30,14.10,75054,69405,81117,3846,49669,364,1097,133830,10629
53,05280,5305280,Bellingham city, Washington,1,2017,89044,51.40,87.00,17.30,44318,44726,75006,1276,4802,1285,0,81881,7163
53,22640,5322640,Everett city, Washington,1,2017,110086,46.10,80.30,11.10,57254,52832,80644,6554,9083,286,355,92997,17089
53,23515,5323515,Federal Way city, Washington,1,2017,96691,42.40,78.10,14.20,48140,48551,49919,12084,13734,643,1060,76724,19967
53,35275,5335275,Kennewick city, Washington,1,2017,81601,40.70,72.60,16.00,41094,40507,64682,1678,2569,1639,0,55288,26313
53,35415,5335415,Kent city, Washington,1,2017,128463,44.40,76.30,11.80,66228,62235,65623,12087,27681,956,761,109148,19315
53,35940,5335940,Kirkland city, Washington,0,2017,88630,44.50,78.80,11.40,43243,45387,66007,1724,12674,84,0,83761,4869
53,43955,5343955,Marysville city, Washington,0,2017,68859,37.30,74.10,13.60,34820,34039,55564,929,4720,764,599,62412,6447
53,53545,5353545,Pasco city, Washington,0,2017,67205,44.00,68.10,10.30,33767,33438,45093,927,2192,2220,677,30667,36538
53,57745,5357745,Renton city, Washington,1,2017,101372,45.60,78.70,11.10,48994,52378,54250,8561,19192,299,930,83638,17734
53,63000,5363000,Seattle city, Washington,1,2017,724764,50.10,84.20,12.60,360255,364509,487046,49980,114680,2883,2128,676555,48209
53,67000,5367000,Spokane city, Washington,1,2017,217096,42.40,78.50,15.40,107378,109718,184360,4687,5978,3375,2508,203808,13288
53,67167,5367167,Spokane Valley city, Washington,1,2017,97858,39.70,79.20,17.10,49001,48857,87699,1148,1393,1690,399,91386,6472
53,70000,5370000,Tacoma city, Washington,1,2017,213426,44.30,78.60,12.90,108065,105361,140604,22671,17336,3420,2683,188072,25354
53,74060,5374060,Vancouver city, Washington,1,2017,175661,40.30,76.90,15.60,87136,88525,141782,3885,10393,660,2828,150677,24984
53,80010,5380010,Yakima city, Washington,1,2017,93669,42.00,72.60,14.40,46717,46952,69452,915,926,619,16,50095,43574
55,02375,5502375,Appleton city, Wisconsin,1,2017,73984,40.80,76.80,13.00,35468,38516,61593,2524,6603,786,50,70138,3846
55,22300,5522300,Eau Claire city, Wisconsin,0,2017,69835,50.10,80.10,12.40,34528,35307,62644,767,2601,462,2068,67944,1891
55,31000,5531000,Green Bay city, Wisconsin,1,2017,105114,42.50,77.70,14.50,51524,53590,80661,5111,3443,3539,0,89644,15470
55,39225,5539225,Kenosha city, Wisconsin,1,2017,99875,42.40,75.00,13.20,48119,51756,76966,11558,1660,578,0,81735,18140
55,48000,5548000,Madison city, Wisconsin,1,2017,255239,55.80,84.00,12.50,127414,127825,202314,14410,24495,1099,371,234498,20741
55,53000,5553000,Milwaukee city, Wisconsin,1,2017,595365,45.30,74.20,10.70,285279,310086,261951,232375,25793,3062,92,481553,113812
55,60500,5560500,Oshkosh city, Wisconsin,0,2017,66668,49.50,84.40,14.00,33044,33624,60797,2626,1620,218,0,64740,1928
55,66000,5566000,Racine city, Wisconsin,1,2017,77555,41.60,72.30,13.00,38025,39530,51059,16902,746,340,0,59395,18160
55,84250,5584250,Waukesha city, Wisconsin,1,2017,72483,43.50,82.40,17.60,34647,37836,65290,1756,2246,316,0,64203,8280
72,10334,7210334,Caguas zona urbana, Puerto Rico,0,2017,73819,38.90,79.40,20.20,32880,40939,56718,5078,104,0,0,1388,72431
72,14290,7214290,Carolina zona urbana, Puerto Rico,0,2017,135781,38.90,80.90,20.90,61768,74013,70323,35330,695,3272,0,2324,133457
72,32522,7232522,Guaynabo zona urbana, Puerto Rico,0,2017,71420,41.20,82.00,21.80,33452,37968,-998,-998,-998,-998,-998,2356,69064
72,63820,7263820,Ponce zona urbana, Puerto Rico,0,2017,114335,37.10,79.40,21.90,52945,61390,85388,5858,0,130,0,240,114095
01,07000,0107000,Birmingham city, Alabama,1,2017,212744,43.30,80.60,14.90,101498,111246,52427,151314,2474,380,271,204664,8080
01,21184,0121184,Dothan city, Alabama,0,2017,67526,37.80,74.90,16.40,31708,35818,43454,21741,674,71,0,64527,2999
01,35896,0135896,Hoover city, Alabama,1,2017,84937,37.40,78.00,17.70,40322,44615,63947,12888,5581,109,0,82259,2678
01,37000,0137000,Huntsville city, Alabama,1,2017,195369,40.90,78.80,15.90,92699,102670,119757,61312,5429,421,0,183781,11588
01,50000,0150000,Mobile city, Alabama,1,2017,190273,42.00,79.70,15.40,91603,98670,81651,99489,3073,313,0,184310,5963
01,51000,0151000,Montgomery city, Alabama,1,2017,199525,42.00,76.00,14.30,93275,106250,67441,120350,5906,311,51,192107,7418
01,77256,0177256,Tuscaloosa city, Alabama,1,2017,100296,55.30,82.00,10.70,47818,52478,49185,46562,1861,755,115,97980,2316
02,03000,0203000,Anchorage municipality, Alaska,1,2017,294356,44.90,75.50,10.50,149386,144970,182307,14810,31646,22906,7791,267408,26948
04,04720,0404720,Avondale city, Arizona,1,2017,84034,47.30,71.80,9.20,39677,44357,62317,7312,1480,1827,577,34565,49469
04,07940,0407940,Buckeye city, Arizona,0,2017,68431,44.50,74.00,11.50,37366,31065,44922,3115,3620,1216,286,39194,29237
04,10670,0410670,Casas Adobes CDP, Arizona,0,2017,73668,38.70,79.40,20.20,34658,39010,61536,2214,3515,878,49,56224,17444
04,12000,0412000,Chandler city, Arizona,1,2017,253448,41.20,74.70,11.80,125874,127574,196427,15065,25208,1914,507,208537,44911
04,23620,0423620,Flagstaff city, Arizona,0,2017,71975,57.30,80.90,9.50,36659,35316,61793,1083,1978,2739,318,57868,14107
04,27400,0427400,Gilbert town, Arizona,1,2017,242362,43.50,70.70,9.10,118931,123431,205175,6401,12125,1662,62,199875,42487
04,27820,0427820,Glendale city, Arizona,1,2017,246708,42.10,73.20,11.00,120816,125892,184004,19568,11402,5090,1682,154421,92287
04,28380,0428380,Goodyear city, Arizona,0,2017,79850,39.90,76.20,14.60,37464,42386,57322,6981,4449,2066,28,56223,23627
04,46000,0446000,Mesa city, Arizona,1,2017,496395,40.20,74.50,15.80,242301,254094,397828,18938,10121,10060,1798,355710,140685
04,54050,0454050,Peoria city, Arizona,1,2017,168174,36.90,78.60,16.60,79855,88319,140642,4747,7522,1012,670,142765,25409
04,55000,0455000,Phoenix city, Arizona,1,2017,1626085,43.40,73.80,10.70,811245,814840,1192925,117767,65216,32710,3595,928339,697746
04,64210,0464210,San Tan Valley CDP, Arizona,0,2017,92851,43.60,68.00,11.50,44761,48090,79989,2960,2466,435,150,72714,20137
04,65000,0465000,Scottsdale city, Arizona,1,2017,249947,34.50,82.40,22.40,126044,123903,222396,6400,11946,1705,0,223661,26286
04,71510,0471510,Surprise city, Arizona,1,2017,134079,35.90,81.10,25.30,65014,69065,117253,4734,2941,670,0,108294,25785
04,73000,0473000,Tempe city, Arizona,1,2017,185025,58.20,84.40,9.90,98600,86425,124167,12084,14652,5579,408,141069,43956
04,77000,0477000,Tucson city, Arizona,1,2017,535676,44.70,78.70,14.60,267387,268289,384608,25645,16624,22287,1059,295314,240362
04,85540,0485540,Yuma city, Arizona,1,2017,95494,43.10,73.50,15.50,45733,49761,72401,3450,2479,1988,49,38133,57361
05,15190,0515190,Conway city, Arkansas,0,2017,65790,51.40,78.50,10.20,31392,34398,48700,11499,1718,0,0,63128,2662
05,23290,0523290,Fayetteville city, Arkansas,1,2017,85258,57.80,80.40,9.50,42397,42861,66523,7168,3808,564,116,78060,7198
05,24550,0524550,Fort Smith city, Arkansas,1,2017,88028,40.80,76.70,13.70,42258,45770,55749,7696,4727,894,0,70630,17398
05,35710,0535710,Jonesboro city, Arkansas,1,2017,75867,46.80,76.10,13.30,37259,38608,54217,13312,1293,91,37,71181,4686
05,41000,0541000,Little Rock city, Arkansas,1,2017,198594,40.80,74.90,13.50,96529,102065,98811,83208,6819,643,208,185394,13200
05,50450,0550450,North Little Rock city, Arkansas,0,2017,65920,43.30,78.70,16.30,31011,34909,28265,35057,598,78,0,62769,3151
05,60410,0560410,Rogers city, Arkansas,0,2017,66432,44.20,71.20,8.60,31572,34860,58015,1727,2252,591,648,43693,22739
05,66080,0566080,Springdale city, Arkansas,1,2017,82397,41.50,68.30,11.10,42023,40374,49554,881,1203,595,4498,52154,30243
06,00562,0600562,Alameda city, California,1,2017,79188,41.20,77.90,16.60,35603,43585,39284,6644,21911,806,153,68363,10825
06,00884,0600884,Alhambra city, California,1,2017,85391,41.80,85.40,20.50,41097,44294,17762,865,49306,298,1080,57903,27488
06,02000,0602000,Anaheim city, California,1,2017,352456,44.70,76.20,10.70,177625,174831,216356,9839,58649,1425,949,158445,194011
06,02252,0602252,Antioch city, California,1,2017,111683,40.40,73.90,11.10,54940,56743,45547,21708,14582,391,883,73690,37993
06,02364,0602364,Apple Valley town, California,1,2017,73071,39.00,72.80,15.80,34861,38210,60108,5977,2047,417,0,45799,27272
06,02553,0602553,Arden-Arcade CDP, California,0,2017,100573,39.30,74.10,15.00,48931,51642,62910,9676,6852,343,385,79939,20634
06,03526,0603526,Bakersfield city, California,1,2017,380887,42.30,70.20,10.80,185324,195563,261398,28892,27391,2100,1005,186960,193927
06,03666,0603666,Baldwin Park city, California,1,2017,76392,45.70,77.30,12.90,37878,38514,28529,1968,12779,1803,1566,18541,57851
06,04982,0604982,Bellflower city, California,1,2017,77772,42.60,77.10,11.50,38552,39220,25783,11024,9004,324,826,38233,39539
06,06000,0606000,Berkeley city, California,1,2017,122334,57.30,86.10,13.00,60181,62153,70633,11277,23736,681,859,106119,16215
06,08786,0608786,Buena Park city, California,1,2017,83026,43.60,77.80,13.70,41547,41479,39156,3900,22018,1845,273,48667,34359
06,08954,0608954,Burbank city, California,1,2017,104823,42.40,81.40,14.90,49966,54857,78485,4692,11319,426,0,83985,20838
06,10046,0610046,Camarillo city, California,0,2017,67849,34.90,80.30,20.10,34375,33474,50762,1043,9342,736,529,51581,16268
06,11194,0611194,Carlsbad city, California,1,2017,115326,31.40,77.30,18.70,56675,58651,97240,1239,9781,249,317,98755,16571
06,11390,0611390,Carmichael CDP, California,0,2017,65959,39.50,81.00,18.20,30233,35726,51028,2261,5244,265,0,58086,7873
06,11530,0611530,Carson city, California,1,2017,92736,38.90,78.80,18.00,44562,48174,31449,19033,23926,601,391,55976,36760
06,11964,0611964,Castro Valley CDP, California,0,2017,62103,38.70,79.60,17.20,30919,31184,36970,6056,11831,850,254,49766,12337
06,13014,0613014,Chico city, California,1,2017,93297,50.60,81.40,14.30,44746,48551,76299,2499,5603,658,37,75145,18152
06,13210,0613210,Chino city, California,1,2017,89798,44.50,78.40,12.10,52815,36983,44957,5569,11883,518,1093,43239,46559
06,13214,0613214,Chino Hills city, California,1,2017,80400,41.60,76.60,11.40,37348,43052,41622,2157,27344,346,0,58094,22306
06,13392,0613392,Chula Vista city, California,1,2017,270450,43.40,74.50,11.90,130380,140070,176339,18102,37656,2083,2113,108907,161543
06,13588,0613588,Citrus Heights city, California,1,2017,87924,42.10,78.70,16.40,43509,44415,70644,3976,2556,444,100,71893,16031
06,14218,0614218,Clovis city, California,1,2017,109700,38.70,72.90,14.70,53637,56063,80735,2310,11095,670,939,77777,31923
06,15044,0615044,Compton city, California,1,2017,97626,43.60,70.10,7.60,48576,49050,26264,29429,215,489,36,30628,66998
06,16000,0616000,Concord city, California,1,2017,129778,37.90,78.30,17.20,64057,65721,81463,4141,18456,520,0,93895,35883
06,16350,0616350,Corona city, California,1,2017,167843,43.20,73.40,9.80,84079,83764,94255,13462,15363,471,616,95638,72205
06,16532,0616532,Costa Mesa city, California,1,2017,113821,47.50,79.60,11.60,56779,57042,88167,1947,8762,253,1594,73793,40028
06,17918,0617918,Daly City city, California,1,2017,107091,45.20,81.60,16.10,51980,55111,19476,3727,61641,578,263,78351,28740
06,18100,0618100,Davis city, California,0,2017,68985,58.60,84.40,10.70,31307,37678,44617,1702,13918,416,120,59195,9790
06,19766,0619766,Downey city, California,1,2017,113089,41.70,75.60,12.20,55154,57935,63809,3376,6764,187,488,25567,87522
06,20802,0620802,East Los Angeles CDP, California,0,2017,125542,44.60,71.90,10.50,63229,62313,60719,433,1848,1950,86,4288,121254
06,21712,0621712,El Cajon city, California,1,2017,103906,43.70,73.80,12.10,50509,53397,76897,6852,4629,324,342,74971,28935
06,22020,0622020,Elk Grove city, California,1,2017,171831,39.60,75.70,13.70,83309,88522,82224,17204,47526,754,4009,136061,35770
06,22230,0622230,El Monte city, California,1,2017,116110,43.80,76.70,12.20,59838,56272,33074,418,33636,285,1446,39465,76645
06,22804,0622804,Escondido city, California,1,2017,151979,43.70,75.80,11.30,76455,75524,98442,2727,7580,742,203,71477,80502
06,23182,0623182,Fairfield city, California,1,2017,116280,43.10,74.00,12.00,58181,58099,52035,19051,21796,761,2020,87211,29069
06,24477,0624477,Florence-Graham CDP, California,0,2017,68095,46.50,67.10,5.70,34878,33217,-998,-998,-998,-998,-998,5325,62770
06,24638,0624638,Folsom city, California,1,2017,78038,36.60,75.50,14.00,39657,38381,53706,2124,14335,204,278,68277,9761
06,24680,0624680,Fontana city, California,1,2017,211820,48.00,70.20,6.10,108425,103395,80867,19848,10043,1860,155,67444,144376
06,26000,0626000,Fremont city, California,1,2017,234954,42.10,76.20,12.40,115002,119952,52702,4687,144089,1063,859,203901,31053
06,27000,0627000,Fresno city, California,1,2017,527422,43.80,71.80,11.40,258635,268787,318521,40511,74388,5852,378,269136,258286
06,28000,0628000,Fullerton city, California,1,2017,140402,42.70,77.80,13.70,73008,67394,76933,3773,34268,214,514,84219,56183
06,29000,0629000,Garden Grove city, California,1,2017,174228,42.10,80.10,14.40,85042,89186,68564,1675,77498,493,257,116171,58057
06,30000,0630000,Glendale city, California,1,2017,203066,37.00,83.50,18.10,94393,108673,156970,4640,26417,411,248,168918,34148
06,32548,0632548,Hawthorne city, California,1,2017,87863,44.80,74.00,9.20,44326,43537,22725,23290,9894,220,330,43496,44367
06,33000,0633000,Hayward city, California,1,2017,160485,45.00,77.80,11.00,78998,81487,48180,14771,42564,1022,2870,94767,65718
06,33182,0633182,Hemet city, California,1,2017,85153,34.60,74.20,21.30,40880,44273,60697,7500,2755,1236,18,44498,40655
06,33434,0633434,Hesperia city, California,1,2017,94867,40.80,66.80,10.00,47724,47143,79894,3881,2780,206,0,41078,53789
06,36000,0636000,Huntington Beach city, California,1,2017,201882,36.60,80.10,18.50,100078,101804,148792,2786,24391,1207,357,164218,37664
06,36448,0636448,Indio city, California,1,2017,89784,38.00,84.20,18.70,41784,48000,56831,1843,1797,220,5,30550,59234
06,36546,0636546,Inglewood city, California,1,2017,110611,41.40,75.90,13.80,53773,56838,29996,44973,2236,2076,2292,53612,56999
06,36770,0636770,Irvine city, California,1,2017,277436,48.00,76.60,9.20,134239,143197,128892,5095,115202,519,838,247993,29443
06,37692,0637692,Jurupa Valley city, California,0,2017,106032,44.10,71.10,9.60,51800,54232,47876,5673,3361,836,218,30550,75482
06,39248,0639248,Laguna Niguel city, California,0,2017,66346,28.60,79.90,21.30,33015,33331,48362,410,9148,0,118,59810,6536
06,39486,0639486,Lake Elsinore city, California,0,2017,66412,46.40,66.60,6.00,31300,35112,24543,4369,6395,193,0,29282,37130
06,39496,0639496,Lake Forest city, California,1,2017,84308,40.80,80.40,13.40,40904,43404,53423,1378,18601,2417,0,65108,19200
06,39892,0639892,Lakewood city, California,1,2017,80971,40.80,78.30,14.80,38030,42941,41190,7167,14937,610,275,54461,26510
06,40130,0640130,Lancaster city, California,1,2017,160323,42.60,71.90,9.20,83485,76838,106113,25151,8771,1483,273,89971,70352
06,41992,0641992,Livermore city, California,1,2017,90290,38.40,77.10,13.70,45335,44955,70091,1463,11672,300,567,73263,17027
06,42202,0642202,Lodi city, California,0,2017,65891,41.70,70.00,13.10,30889,35002,39984,2108,5901,574,230,43436,22455
06,43000,0643000,Long Beach city, California,1,2017,469459,44.50,77.90,11.60,227282,242177,238911,59564,63147,3116,3307,266698,202761
06,44000,0644000,Los Angeles city, California,1,2017,3999742,45.90,79.40,12.40,1983239,2016503,2033975,362079,461936,24208,6170,2042764,1956978
06,44574,0644574,Lynwood city, California,1,2017,71115,48.70,70.50,6.90,33501,37614,30033,3951,989,564,0,6468,64647
06,45022,0645022,Madera city, California,0,2017,65506,44.80,65.50,8.90,32094,33412,36986,3772,1125,951,0,15953,49553
06,45484,0645484,Manteca city, California,1,2017,79275,39.10,75.00,13.80,38922,40353,54173,3174,8739,522,234,45463,33812
06,46842,0646842,Menifee city, California,1,2017,90599,38.90,78.00,17.90,44721,45878,55172,5124,5851,660,346,57194,33405
06,46898,0646898,Merced city, California,1,2017,83100,44.40,70.00,10.00,39552,43548,55398,3894,13136,976,180,36340,46760
06,47766,0647766,Milpitas city, California,1,2017,78108,44.90,74.70,10.30,41252,36856,13303,4659,48321,279,535,66262,11846
06,48256,0648256,Mission Viejo city, California,1,2017,96009,33.60,79.60,16.80,47351,48658,74049,1204,11182,912,65,81465,14544
06,48354,0648354,Modesto city, California,1,2017,214220,40.40,75.90,15.20,105212,109008,162820,10793,14679,1960,3436,129726,84494
06,49270,0649270,Moreno Valley city, California,1,2017,207211,46.90,71.70,8.50,102328,104883,63448,33951,12551,1562,1309,78299,128912
06,49670,0649670,Mountain View city, California,1,2017,81443,51.60,81.80,11.50,43086,38357,40671,727,30286,59,95,66347,15096
06,50076,0650076,Murrieta city, California,1,2017,113316,37.50,69.80,13.40,53385,59931,71478,5587,10028,898,248,81450,31866
06,50258,0650258,Napa city, California,1,2017,79782,39.20,77.40,16.40,39215,40567,66162,281,2199,392,89,48712,31070
06,51182,0651182,Newport Beach city, California,1,2017,86151,30.10,82.00,23.40,42031,44120,76827,740,5446,50,140,80029,6122
06,52526,0652526,Norwalk city, California,1,2017,106086,43.70,77.70,13.40,53275,52811,34159,3163,14663,194,505,30129,75957
06,53000,0653000,Oakland city, California,1,2017,425204,45.40,80.30,13.20,209049,216155,145499,99476,66084,3160,2696,304434,120770
06,53322,0653322,Oceanside city, California,1,2017,176208,39.40,79.50,17.40,89753,86455,123081,8764,13959,2542,780,112479,63729
06,53896,0653896,Ontario city, California,1,2017,175850,45.70,74.70,10.60,87140,88710,87432,8992,12443,3680,167,56411,119439
06,53980,0653980,Orange city, California,1,2017,140557,47.40,81.00,12.10,69868,70689,102233,1622,15686,643,155,83691,56866
06,54652,0654652,Oxnard city, California,1,2017,210038,44.30,72.90,9.90,105062,104976,159828,6028,14600,4205,332,51330,158708
06,55156,0655156,Palmdale city, California,1,2017,157507,41.30,70.50,9.20,78937,78570,63013,20850,6503,2421,962,64981,92526
06,55282,0655282,Palo Alto city, California,0,2017,67170,37.50,75.50,18.40,32892,34278,39822,1523,22124,308,0,63223,3947
06,56000,0656000,Pasadena city, California,1,2017,142632,45.40,81.50,14.00,69276,73356,73484,11871,24827,285,140,92543,50089
06,56700,0656700,Perris city, California,1,2017,77895,47.80,66.50,6.20,40100,37795,22714,4340,1760,0,50,12213,65682
06,57456,0657456,Pittsburg city, California,0,2017,72157,45.00,77.60,13.70,35355,36802,22539,11469,10808,1379,938,41512,30645
06,57792,0657792,Pleasanton city, California,1,2017,83007,36.10,79.00,13.90,42101,40906,47515,2310,25903,436,508,76632,6375
06,58072,0658072,Pomona city, California,1,2017,152946,45.00,75.20,11.10,76593,76353,64665,9026,19266,5203,21,44233,108713
06,59444,0659444,Rancho Cordova city, California,0,2017,73554,44.70,76.70,12.10,37335,36219,44847,7369,6900,311,756,57483,16071
06,59451,0659451,Rancho Cucamonga city, California,1,2017,177446,41.70,74.80,10.80,86231,91215,103013,15006,28111,1378,122,109807,67639
06,59920,0659920,Redding city, California,1,2017,91788,38.40,78.50,17.60,44184,47604,78930,1247,4440,2958,36,80853,10935
06,59962,0659962,Redlands city, California,1,2017,71562,40.30,80.20,16.90,35654,35908,45420,7518,8278,499,0,49881,21681
06,60018,0660018,Redondo Beach city, California,1,2017,67908,39.20,80.40,12.60,35337,32571,46860,2084,8835,186,126,57344,10564
06,60102,0660102,Redwood City city, California,1,2017,86683,44.30,81.50,12.10,45508,41175,51897,2666,12529,301,334,60324,26359
06,60466,0660466,Rialto city, California,1,2017,103555,46.30,72.80,8.30,49259,54296,60269,14523,2918,1052,0,26996,76559
06,60620,0660620,Richmond city, California,1,2017,110037,44.90,77.80,12.20,54397,55640,54084,20340,14423,619,394,57612,52425
06,62000,0662000,Riverside city, California,1,2017,327722,48.30,76.10,9.70,163201,164521,157604,21930,27379,2603,399,148304,179418
06,62938,0662938,Roseville city, California,1,2017,135325,37.80,77.10,16.70,66617,68708,106343,3064,13869,1179,1484,114605,20720
06,64000,0664000,Sacramento city, California,1,2017,501890,43.30,76.70,12.70,245487,256403,207994,70339,94903,5008,10238,360138,141752
06,64224,0664224,Salinas city, California,1,2017,157594,44.80,69.40,9.10,81048,76546,49310,2119,8140,346,111,33476,124118
06,65000,0665000,San Bernardino city, California,1,2017,216983,45.20,72.10,10.20,105294,111689,128647,28292,7598,1136,169,76501,140482
06,65042,0665042,San Buenaventura (Ventura) city, California,1,2017,110784,39.70,78.50,17.10,55207,55577,95897,2765,3192,396,0,70292,40492
06,65084,0665084,San Clemente city, California,0,2017,65269,30.40,81.20,21.40,32084,33185,54593,214,2638,153,40,53958,11311
06,66000,0666000,San Diego city, California,1,2017,1419488,47.80,80.10,12.50,720638,698850,916430,87393,243458,8562,6322,990314,429174
06,67000,0667000,San Francisco city, California,1,2017,884363,48.20,86.60,15.40,450429,433934,402967,45815,306459,3078,3639,749658,134705
06,68000,0668000,San Jose city, California,1,2017,1035353,43.10,77.90,12.80,522618,512735,404330,29587,368311,7629,4733,702750,332603
06,68084,0668084,San Leandro city, California,1,2017,90555,36.90,82.20,19.90,41923,48632,34188,8223,33444,925,1297,70849,19706
06,68196,0668196,San Marcos city, California,1,2017,96188,43.30,73.90,13.30,47574,48614,75554,1484,8332,895,61,52905,43283
06,68252,0668252,San Mateo city, California,1,2017,104733,41.00,77.40,16.00,51826,52907,55238,1506,24734,516,3662,77956,26777
06,68378,0668378,San Ramon city, California,1,2017,75922,39.20,70.10,9.60,37016,38906,27953,2639,37802,415,385,71687,4235
06,69000,0669000,Santa Ana city, California,1,2017,334135,45.80,73.60,8.30,170471,163664,117032,2941,40138,1034,1325,78671,255464
06,69070,0669070,Santa Barbara city, California,1,2017,92099,45.30,85.90,18.70,47048,45051,70084,2055,3388,175,0,62677,29422
06,69084,0669084,Santa Clara city, California,1,2017,127131,50.20,80.90,12.90,66383,60748,46236,5371,57272,163,209,107036,20095
06,69088,0669088,Santa Clarita city, California,1,2017,210886,39.00,74.90,11.90,103781,107105,146368,8669,25851,3012,178,144028,66858
06,69112,0669112,Santa Cruz city, California,0,2017,65028,54.90,88.60,12.40,31793,33235,47951,928,7182,361,135,51629,13399
06,69196,0669196,Santa Maria city, California,1,2017,107018,42.50,69.80,9.50,50818,56200,86766,1209,6187,766,0,25955,81063
06,70000,0670000,Santa Monica city, California,1,2017,92298,43.70,84.70,20.30,43939,48359,66344,3901,9734,42,204,78749,13549
06,70098,0670098,Santa Rosa city, California,1,2017,175269,40.40,78.90,17.50,82595,92674,110856,5482,9507,2992,1674,118316,56953
06,72016,0672016,Simi Valley city, California,1,2017,126875,38.60,77.40,15.00,62835,64040,100179,1960,14097,260,41,94073,32802
06,73080,0673080,South Gate city, California,1,2017,95422,45.80,72.70,10.30,46479,48943,56213,668,851,1210,0,4771,90651
06,73262,0673262,South San Francisco city, California,0,2017,67430,38.50,79.40,16.60,32224,35206,17540,1566,31033,296,693,46385,21045
06,75000,0675000,Stockton city, California,1,2017,310476,43.20,72.90,11.70,147877,162599,123347,38074,65267,1477,2042,176742,133734
06,77000,0677000,Sunnyvale city, California,1,2017,153656,46.70,80.20,12.00,79775,73881,58210,2617,72824,650,271,129711,23945
06,78120,0678120,Temecula city, California,1,2017,114318,39.80,71.80,11.70,56793,57525,75762,5282,8152,542,217,78663,35655
06,78582,0678582,Thousand Oaks city, California,1,2017,128972,33.40,77.60,19.50,61103,67869,104797,1651,13264,469,68,106828,22144
06,80000,0680000,Torrance city, California,1,2017,146745,35.80,79.60,18.30,71314,75431,65609,4005,57265,497,702,119435,27310
06,80238,0680238,Tracy city, California,1,2017,90886,42.10,71.60,9.20,46557,44329,51081,4056,16604,147,1805,56191,34695
06,80812,0680812,Turlock city, California,1,2017,73562,43.90,75.30,13.70,36124,37438,53363,1015,5300,450,70,44675,28887
06,80854,0680854,Tustin city, California,1,2017,80502,41.40,75.10,11.00,38591,41911,37692,4376,20709,225,0,51536,28966
06,81204,0681204,Union City city, California,1,2017,75344,43.00,83.90,14.60,38713,36631,15649,3990,42816,598,1143,61520,13824
06,81344,0681344,Upland city, California,1,2017,76985,37.90,78.10,14.50,37208,39777,52750,2703,6696,452,0,37145,39840
06,81554,0681554,Vacaville city, California,1,2017,100023,39.50,80.60,15.00,50108,49915,68360,9904,6489,247,869,71067,28956
06,81666,0681666,Vallejo city, California,1,2017,122086,40.60,77.60,14.90,58389,63697,40919,23854,28037,437,1136,87947,34139
06,82590,0682590,Victorville city, California,1,2017,122465,41.60,71.20,10.50,60586,61879,79084,12637,5983,545,190,50722,71743
06,82954,0682954,Visalia city, California,1,2017,133009,43.70,70.30,10.80,62011,70998,92946,3170,6728,1247,0,61630,71379
06,82996,0682996,Vista city, California,1,2017,101557,44.70,74.70,10.50,52303,49254,87494,2963,3590,221,94,48342,53215
06,83346,0683346,Walnut Creek city, California,0,2017,69792,31.00,81.40,27.90,32860,36932,47144,2136,13445,302,161,62468,7324
06,84200,0684200,West Covina city, California,1,2017,107623,41.50,78.80,15.50,53517,54106,34334,4719,35971,694,182,51441,56182
06,84550,0684550,Westminster city, California,1,2017,91548,38.70,80.60,16.50,42978,48570,34597,874,46642,953,237,69401,22147
06,85292,0685292,Whittier city, California,1,2017,86841,40.90,75.00,13.90,41878,44963,41768,1030,4302,483,13,28958,57883
06,86832,0686832,Yorba Linda city, California,0,2017,68234,33.90,78.20,17.90,33329,34905,50526,747,14127,27,130,58377,9857
06,86972,0686972,Yuba City city, California,0,2017,66872,40.10,74.30,14.50,34008,32864,41889,2153,13897,1107,583,46636,20236
08,03455,0803455,Arvada city, Colorado,1,2017,118300,38.50,79.00,16.10,58265,60035,108552,1141,2789,679,0,99777,18523
08,04000,0804000,Aurora city, Colorado,1,2017,367250,44.40,74.80,11.00,181607,185643,228065,58459,28722,3015,1049,266047,101203
08,07850,0807850,Boulder city, Colorado,1,2017,107128,60.80,85.80,10.20,54966,52162,93877,1379,5503,126,7,96294,10834
08,09280,0809280,Broomfield city, Colorado,0,2017,68341,41.60,76.50,12.90,34183,34158,58633,1028,4591,330,0,59865,8476
08,12815,0812815,Centennial city, Colorado,1,2017,110277,36.10,76.50,15.10,55525,54752,96566,3851,4008,41,44,100476,9801
08,16000,0816000,Colorado Springs city, Colorado,1,2017,464470,43.30,76.30,13.90,233923,230547,365865,26209,11075,5133,2375,383143,81327
08,20000,0820000,Denver city, Colorado,1,2017,704621,49.70,80.10,11.60,352865,351756,531343,64231,27131,7422,1165,493800,210821
08,27425,0827425,Fort Collins city, Colorado,1,2017,165089,54.00,79.20,9.80,82978,82111,147787,3192,5214,1853,164,140951,24138
08,32155,0832155,Greeley city, Colorado,1,2017,105457,45.20,77.00,12.40,52194,53263,92366,2061,1245,856,0,65576,39881
08,36410,0836410,Highlands Ranch CDP, Colorado,0,2017,107216,37.20,73.00,12.30,53301,53915,93488,1453,6893,519,0,99107,8109
08,43000,0843000,Lakewood city, Colorado,1,2017,154952,42.80,80.20,15.90,76284,78668,136697,1564,5217,2380,0,115564,39388
08,45970,0845970,Longmont city, Colorado,1,2017,94145,40.90,74.70,12.60,46004,48141,82029,890,3243,749,0,71386,22759
08,46465,0846465,Loveland city, Colorado,1,2017,76702,38.70,83.70,20.40,36630,40072,72986,143,825,707,0,69095,7607
08,62000,0862000,Pueblo city, Colorado,1,2017,111121,39.30,78.30,17.00,53854,57267,83058,2652,1229,5538,99,55243,55878
08,77290,0877290,Thornton city, Colorado,1,2017,136992,40.30,72.20,10.20,70041,66951,119386,3327,6542,814,0,88559,48433
08,83835,0883835,Westminster city, Colorado,1,2017,112814,44.20,79.10,14.40,55955,56859,95774,1402,7128,983,134,88923,23891
09,08000,0908000,Bridgeport city, Connecticut,1,2017,146582,44.80,77.20,11.30,72997,73585,60706,52238,5253,916,0,87963,58619
09,18430,0918430,Danbury city, Connecticut,1,2017,85243,42.50,81.00,15.30,43231,42012,48940,9630,5377,62,0,61102,24141
09,37000,0937000,Hartford city, Connecticut,1,2017,123420,47.40,74.80,10.60,58573,64847,34203,44676,4629,156,0,67771,55649
09,50370,0950370,New Britain city, Connecticut,1,2017,72718,43.50,78.40,14.60,33259,39459,53936,9531,2381,0,0,42048,30670
09,52000,0952000,New Haven city, Connecticut,1,2017,131005,52.70,77.70,9.80,65965,65040,56692,46115,6400,72,0,92646,38359
09,55990,0955990,Norwalk city, Connecticut,1,2017,89000,40.10,79.10,13.30,42017,46983,65239,12457,3668,464,58,57996,31004
09,73000,0973000,Stamford city, Connecticut,1,2017,130835,43.70,80.40,15.70,63537,67298,88082,10602,11484,1060,161,94557,36278
09,80000,0980000,Waterbury city, Connecticut,1,2017,108642,38.90,74.10,14.90,50889,57753,66360,20073,2551,208,0,64097,44545
10,77580,1077580,Wilmington city, Delaware,1,2017,71104,41.90,77.00,14.40,34323,36781,26324,42911,560,64,0,65123,5981
11,50000,1150000,Washington city, District of Columbia,1,2017,693972,51.20,82.00,12.10,329078,364894,284536,318220,28499,1690,302,617446,76526
12,00410,1200410,Alafaya CDP, Florida,0,2017,88496,48.60,80.40,11.40,42131,46365,60229,9343,6232,191,0,52838,35658
12,07300,1207300,Boca Raton city, Florida,1,2017,98153,30.80,82.10,24.90,46711,51442,85721,4812,3088,0,0,83956,14197
12,07875,1207875,Boynton Beach city, Florida,1,2017,77704,39.70,81.40,19.20,38609,39095,44961,29359,1891,84,0,66922,10782
12,08150,1208150,Brandon CDP, Florida,0,2017,121190,43.90,78.00,13.30,57470,63720,81500,23599,6828,391,0,86607,34583
12,10275,1210275,Cape Coral city, Florida,1,2017,183356,32.10,82.30,24.60,91070,92286,167835,6610,3598,793,33,143533,39823
12,12875,1212875,Clearwater city, Florida,1,2017,115501,36.60,79.10,19.40,51382,64119,87730,14777,2478,1531,31,87802,27699
12,14400,1214400,Coral Springs city, Florida,1,2017,133058,41.20,74.20,11.60,61711,71347,86855,27453,9323,281,0,97170,35888
12,16475,1216475,Davie town, Florida,1,2017,105146,39.90,76.50,13.60,48791,56355,73530,15394,4499,51,434,67113,38033
12,16525,1216525,Daytona Beach city, Florida,0,2017,68055,40.50,80.50,18.90,34906,33149,39313,23172,2124,352,83,62622,5433
12,16725,1216725,Deerfield Beach city, Florida,1,2017,80572,40.30,80.90,20.90,38982,41590,50274,23990,2945,87,0,63511,17061
12,17100,1217100,Delray Beach city, Florida,0,2017,68749,32.50,82.00,24.80,32402,36347,43064,22319,1941,0,0,62632,6117
12,17200,1217200,Deltona city, Florida,1,2017,90743,39.10,74.80,15.10,45223,45520,67034,10523,1151,394,0,57346,33397
12,24000,1224000,Fort Lauderdale city, Florida,1,2017,180071,38.30,81.60,16.60,92412,87659,108703,59911,1795,64,32,141164,38907
12,24125,1224125,Fort Myers city, Florida,0,2017,79941,38.20,80.40,20.20,39215,40726,49867,17224,3900,48,77,61000,18941
12,25175,1225175,Gainesville city, Florida,1,2017,132253,61.80,87.10,10.50,61571,70682,87784,27229,8438,272,194,116257,15996
12,30000,1230000,Hialeah city, Florida,1,2017,239682,33.30,83.60,21.20,115531,124151,223904,4939,2108,0,0,9197,230485
12,32000,1232000,Hollywood city, Florida,1,2017,153625,39.30,78.20,16.40,76885,76740,103684,28054,4804,545,0,91197,62428
12,32275,1232275,Homestead city, Florida,0,2017,69909,48.20,72.20,10.10,35628,34281,53691,11323,759,853,0,22310,47599
12,35000,1235000,Jacksonville city, Florida,1,2017,892064,42.00,77.10,13.50,432039,460025,516074,281757,47503,1709,101,804192,87872
12,36100,1236100,Kendall CDP, Florida,0,2017,73805,37.60,82.30,21.90,34342,39463,62083,3712,1641,0,0,21472,52333
12,36950,1236950,Kissimmee city, Florida,0,2017,71103,47.10,75.30,9.50,38752,32351,45673,7408,3598,308,43,22238,48865
12,38250,1238250,Lakeland city, Florida,1,2017,108051,40.10,81.20,19.80,50197,57854,78858,22501,2953,273,184,91230,16821
12,39425,1239425,Largo city, Florida,1,2017,84768,34.40,84.80,26.00,41606,43162,73210,5782,2220,169,146,74144,10624
12,39550,1239550,Lauderhill city, Florida,1,2017,71976,40.10,70.60,11.10,33705,38271,9650,58858,438,406,0,65931,6045
12,39925,1239925,Lehigh Acres CDP, Florida,0,2017,132618,39.10,70.50,12.80,63743,68875,92966,26204,1789,0,137,83487,49131
12,43975,1243975,Melbourne city, Florida,1,2017,82003,32.40,80.30,24.30,39842,42161,63105,7984,5545,213,0,74605,7398
12,45000,1245000,Miami city, Florida,1,2017,463354,42.50,82.30,16.20,228354,235000,343909,83411,6411,2232,79,131140,332214
12,45025,1245025,Miami Beach city, Florida,1,2017,92319,39.70,82.80,17.60,47582,44737,68408,4312,536,439,0,41826,50493
12,45060,1245060,Miami Gardens city, Florida,1,2017,113743,43.60,75.10,12.80,53602,60141,29850,77908,1701,152,0,82190,31553
12,45975,1245975,Miramar city, Florida,1,2017,140323,42.50,75.50,10.50,69194,71129,64174,62207,4524,375,0,84732,55591
12,49675,1249675,North Port city, Florida,0,2017,66293,34.70,81.60,23.50,30345,35948,-998,-998,-998,-998,-998,56646,9647
12,53000,1253000,Orlando city, Florida,1,2017,280258,49.70,77.80,10.50,136571,143687,158310,77172,11963,310,78,193953,86305
12,54000,1254000,Palm Bay city, Florida,1,2017,111660,40.10,79.00,14.20,58480,53180,84902,17211,1992,1072,0,93042,18618
12,54200,1254200,Palm Coast city, Florida,1,2017,88394,31.40,81.80,28.10,41508,46886,70157,11663,3064,291,0,78350,10044
12,55775,1255775,Pembroke Pines city, Florida,1,2017,170703,39.80,79.20,15.40,81421,89282,105038,39865,10827,810,190,99017,71686
12,56825,1256825,Pine Hills CDP, Florida,0,2017,76847,45.30,72.40,10.40,37258,39589,11543,53759,3649,265,0,64458,12389
12,57425,1257425,Plantation city, Florida,1,2017,93922,38.10,79.90,18.60,44396,49526,65799,16070,3963,152,0,66209,27713
12,57900,1257900,Poinciana CDP, Florida,0,2017,71694,36.10,75.40,19.40,34627,37067,41340,18007,1798,1485,508,34274,37420
12,58050,1258050,Pompano Beach city, Florida,1,2017,110464,35.40,83.70,18.60,58432,52032,67285,37644,711,83,0,89680,20784
12,58350,1258350,Port Charlotte CDP, Florida,0,2017,65972,29.50,85.50,30.70,32274,33698,-998,-998,-998,-998,-998,60517,5455
12,58715,1258715,Port St. Lucie city, Florida,1,2017,189331,34.70,79.20,21.40,93407,95924,142385,34890,4875,466,0,154650,34681
12,60950,1260950,Riverview CDP, Florida,0,2017,90538,42.70,73.30,9.10,44382,46156,63997,16176,4354,157,0,68025,22513
12,63000,1263000,St. Petersburg city, Florida,1,2017,263252,36.50,83.80,20.30,126815,136437,184415,56947,9879,591,0,247322,15930
12,68350,1268350,Spring Hill CDP, Florida,0,2017,113508,33.30,77.20,22.10,56017,57491,99136,6346,2099,1099,0,95167,18341
12,69700,1269700,Sunrise city, Florida,1,2017,94313,41.80,78.10,16.90,42995,51318,52088,31494,4668,446,45,64770,29543
12,70600,1270600,Tallahassee city, Florida,1,2017,191039,58.60,84.20,10.10,89596,101443,109980,64649,7811,229,0,177495,13544
12,70675,1270675,Tamarac city, Florida,0,2017,65683,30.80,82.80,29.00,30255,35428,38318,21585,3483,49,0,48939,16744
12,71000,1271000,Tampa city, Florida,1,2017,385423,43.90,79.10,12.80,189874,195549,256273,91940,16438,886,84,283653,101770
12,71569,1271569,The Hammocks CDP, Florida,0,2017,68457,44.60,83.10,11.60,31922,36535,58386,3083,3387,0,0,11602,56855
12,71625,1271625,The Villages CDP, Florida,0,2017,-998,-999999999.00,-999999999.00,-999999999.00,-998,-998,-998,-998,-998,-998,-998,78754,866
12,72145,1272145,Town 'n' Country CDP, Florida,0,2017,89143,41.40,77.90,12.80,41206,47937,67323,10977,3843,76,0,49402,39741
12,76582,1276582,Weston city, Florida,0,2017,70927,32.50,72.60,12.70,34677,36250,55928,5016,4355,0,126,36836,34091
12,76600,1276600,West Palm Beach city, Florida,1,2017,110219,40.70,79.60,19.40,52934,57285,64388,38133,2536,37,0,80252,29967
13,01052,1301052,Albany city, Georgia,1,2017,71593,43.10,76.80,15.10,33225,38368,-998,-998,-998,-998,-998,69969,1624
13,01696,1301696,Alpharetta city, Georgia,0,2017,65774,37.70,74.80,10.00,31513,34261,38578,7822,13480,28,0,59176,6598
13,03440,1303440,Athens-Clarke County unified government (balance), Georgia,1,2017,125929,57.30,82.70,10.50,60245,65684,78877,34634,4979,0,0,112121,13808
13,04000,1304000,Atlanta city, Georgia,1,2017,486299,50.90,81.10,11.20,238210,248089,190415,256888,19551,704,0,465421,20878
13,04204,1304204,Augusta-Richmond County consolidated government (balance), Georgia,1,2017,195678,42.70,76.80,13.50,93839,101839,70088,112673,3910,336,103,185569,10109
13,19000,1319000,Columbus city, Georgia,1,2017,194058,42.30,75.10,12.90,94497,99561,84356,90141,4864,261,164,179357,14701
13,42425,1342425,Johns Creek city, Georgia,1,2017,84359,34.60,72.50,8.80,41631,42728,-998,-998,-998,-998,-998,79127,5232
13,49008,1349008,Macon-Bibb County, Georgia,0,2017,152646,39.00,75.30,15.00,71387,81259,61664,83882,3191,396,63,147627,5019
13,67284,1367284,Roswell city, Georgia,1,2017,94792,39.10,74.40,14.30,45321,49471,70004,14550,2882,207,0,79498,15294
13,68516,1368516,Sandy Springs city, Georgia,1,2017,106742,44.80,81.00,13.80,50109,56633,78719,15691,8743,800,0,90881,15861
13,69000,1369000,Savannah city, Georgia,1,2017,146449,45.70,80.50,12.90,68096,78353,53571,81766,2539,132,1341,140138,6311
13,80508,1380508,Warner Robins city, Georgia,1,2017,75675,41.10,73.70,12.90,34775,40900,38782,28625,2572,81,0,67791,7884
72,76770,7276770,San Juan zona urbana, Puerto Rico,0,2017,321613,37.60,81.60,22.00,145917,175696,202970,49524,389,582,0,4198,317415
72,06593,7206593,Bayamón zona urbana, Puerto Rico,0,2017,164319,38.10,81.30,21.30,77323,86996,122871,13814,278,393,0,855,163464
06,14218,0614218,Clovis city, California,1,2018,112019,42.00,71.90,13.80,54549,57470,73710,5555,11376,1737,0,77501,34518
06,29000,0629000,Garden Grove city, California,1,2018,172652,41.70,78.60,12.60,87021,85631,66269,1762,68867,880,3903,107045,65607
06,53896,0653896,Ontario city, California,1,2018,181119,48.20,75.40,9.20,90402,90717,82457,9507,11341,1658,68,48500,132619
06,78582,0678582,Thousand Oaks city, California,1,2018,127720,33.00,78.90,18.40,60955,66765,104856,1962,13489,790,180,103063,24657
48,24000,4824000,El Paso city, Texas,1,2018,682686,42.90,73.60,12.90,334759,347927,526550,21759,9954,2746,1030,122925,559761
55,48000,5548000,Madison city, Wisconsin,1,2018,258034,55.10,83.50,12.50,127328,130706,201826,20865,23594,1411,0,239167,18867
06,86832,0686832,Yorba Linda city, California,0,2018,67804,33.10,76.10,20.90,33270,34534,48986,1417,12206,190,80,56782,11022
18,31000,1831000,Hammond city, Indiana,1,2018,75806,43.20,74.20,13.70,38229,37577,37786,13734,335,267,0,43266,32540
29,64550,2964550,St. Joseph city, Missouri,1,2018,75437,37.80,76.90,17.20,38154,37283,64641,4592,756,219,0,69532,5905
48,10768,4810768,Brownsville city, Texas,1,2018,183389,42.30,70.00,11.60,88298,95091,-998,-998,-998,-998,-998,9973,173416
04,23620,0423620,Flagstaff city, Arizona,0,2018,73955,59.90,82.90,9.00,37736,36219,57397,1494,2324,6717,0,61444,12511
25,07000,2507000,Boston city, Massachusetts,1,2018,695926,54.40,84.10,11.80,333815,362111,365340,170804,66261,2306,165,556739,139187
49,83470,4983470,West Valley City city, Utah,1,2018,136420,47.10,72.20,9.10,69169,67251,73685,3274,7365,1520,5323,82661,53759
72,63820,7263820,Ponce zona urbana, Puerto Rico,0,2018,107947,37.60,81.70,22.90,50397,57550,89255,7640,90,407,0,778,107169
44,19180,4419180,Cranston city, Rhode Island,1,2018,81282,42.00,81.30,15.10,39912,41370,64774,3744,5301,893,160,68824,12458
53,35415,5335415,Kent city, Washington,1,2018,129613,40.70,73.80,12.60,64390,65223,62079,17988,21172,458,3651,108317,21296
06,81554,0681554,Vacaville city, California,1,2018,100147,42.40,76.00,14.80,51704,48443,65087,11112,6990,542,3237,79684,20463
12,75812,1275812,Wellington village, Florida,0,2018,65190,35.20,70.40,14.10,31273,33917,56081,4895,2636,255,0,49894,15296
48,52356,4852356,North Richland Hills city, Texas,0,2018,70839,39.50,76.60,15.70,34163,36676,54173,3176,3520,797,0,58318,12521
06,02000,0602000,Anaheim city, California,1,2018,352018,43.30,75.10,11.80,170041,181977,233389,10405,53606,2002,552,156115,195903
06,53322,0653322,Oceanside city, California,1,2018,176090,40.50,79.30,17.10,85652,90438,129981,7146,14747,1087,1692,115444,60646
15,71550,1571550,Urban Honolulu CDP, Hawaii,0,2018,347403,39.90,82.20,20.30,176513,170890,58248,6836,181174,324,27090,319617,27786
29,38000,2938000,Kansas City city, Missouri,1,2018,491809,43.60,77.20,13.20,240320,251489,300253,139598,12333,2191,400,439171,52638
48,17000,4817000,Corpus Christi city, Texas,1,2018,326566,42.60,75.40,14.40,160229,166337,294085,13614,7863,1243,359,117613,208953
06,62364,0662364,Rocklin city, California,0,2018,67231,42.90,73.80,11.50,31848,35383,51836,967,6443,565,77,55924,11307
12,70675,1270675,Tamarac city, Florida,0,2018,66043,33.70,82.90,26.40,29531,36512,44580,16247,1344,70,0,40465,25578
20,52575,2052575,Olathe city, Kansas,1,2018,139588,41.40,70.70,10.00,69837,69751,119391,8491,5461,296,108,121661,17927
21,08902,2108902,Bowling Green city, Kentucky,0,2018,68393,52.80,79.20,12.00,32240,36153,51701,6492,3668,149,1217,62036,6357
22,40735,2240735,Lafayette city, Louisiana,1,2018,126149,43.60,79.00,14.10,62362,63787,80665,38164,2684,467,0,119503,6646
24,31175,2431175,Gaithersburg city, Maryland,0,2018,68294,41.10,76.70,13.10,34786,33508,30190,13001,14370,517,0,52416,15878
45,30850,4530850,Greenville city, South Carolina,0,2018,68543,45.80,79.60,14.30,32372,36171,46232,18157,1620,0,681,65496,3047
06,33000,0633000,Hayward city, California,1,2018,159618,43.90,77.60,13.00,79264,80354,44214,14445,45727,1700,2813,99210,60408
06,66000,0666000,San Diego city, California,1,2018,1425999,46.20,80.00,13.30,719960,706039,926159,96339,240609,5795,5422,996101,429898
08,27425,0827425,Fort Collins city, Colorado,1,2018,167823,55.10,82.00,10.70,84376,83447,148431,2146,6614,1185,214,148746,19077
25,37000,2537000,Lowell city, Massachusetts,1,2018,111666,49.10,77.90,10.00,53850,57816,67227,11576,24181,1303,0,91057,20609
48,04000,4804000,Arlington city, Texas,1,2018,398122,44.50,74.40,10.90,196792,201330,226690,92364,27658,2633,0,285641,112481
48,19972,4819972,Denton city, Texas,1,2018,138553,55.70,81.90,11.10,66840,71713,106453,15169,6751,1423,0,108939,29614
04,28380,0428380,Goodyear city, Arizona,0,2018,82837,40.50,79.50,17.90,38978,43859,63357,3297,3444,1593,874,54829,28008
06,13214,0613214,Chino Hills city, California,1,2018,83438,42.10,74.70,9.40,41094,42344,36626,4422,34081,994,0,60734,22704
06,39486,0639486,Lake Elsinore city, California,0,2018,68187,41.30,70.80,11.10,32544,35643,35690,5920,4573,690,143,33821,34366
13,42425,1342425,Johns Creek city, Georgia,1,2018,84292,37.20,73.40,11.20,42379,41913,44974,11168,23100,1077,69,78828,5464
04,71510,0471510,Surprise city, Arizona,1,2018,138144,35.00,75.00,22.30,66922,71222,117869,9137,3910,201,72,112993,25151
18,71000,1871000,South Bend city, Indiana,1,2018,103869,41.00,71.00,13.10,49150,54719,63862,27568,1870,398,38,87670,16199
33,50260,3350260,Nashua city, New Hampshire,1,2018,89257,35.60,81.30,17.30,44309,44948,73309,3737,7204,47,0,77863,11394
72,06593,7206593,Bayamón zona urbana, Puerto Rico,0,2018,155832,38.10,82.10,22.00,72849,82983,110054,16637,155,50,0,1552,154280
17,14000,1714000,Chicago city, Illinois,1,2018,2705988,46.70,79.70,12.90,1319875,1386113,1389965,797489,181679,7237,501,1929327,776661
55,53000,5553000,Milwaukee city, Wisconsin,1,2018,592002,45.80,74.30,10.90,287293,304709,255565,225047,25525,2859,268,472126,119876
12,16525,1216525,Daytona Beach city, Florida,0,2018,68862,41.80,84.50,21.20,34393,34469,39297,22448,2086,0,120,62263,6599
12,45000,1245000,Miami city, Florida,1,2018,470911,40.70,82.30,17.60,233853,237058,358137,71830,6753,103,0,121910,349001
28,29700,2829700,Gulfport city, Mississippi,1,2018,71865,41.60,76.10,12.10,34410,37455,37649,29951,1259,212,0,68360,3505
49,67440,4967440,Sandy city, Utah,1,2018,96901,40.80,78.00,16.00,50243,46658,86213,329,3372,242,1740,87811,9090
45,50875,4550875,North Charleston city, South Carolina,1,2018,119214,47.00,74.60,10.40,58464,60750,55792,52220,2820,597,0,106437,12777
48,74144,4874144,Tyler city, Texas,1,2018,105727,42.90,75.30,14.20,50083,55644,72877,23385,3546,705,162,82227,23500
06,55282,0655282,Palo Alto city, California,0,2018,66655,37.30,79.20,19.70,31854,34801,37760,1287,23271,46,8,63465,3190
12,25175,1225175,Gainesville city, Florida,1,2018,133851,64.00,85.10,10.10,65863,67988,84163,32560,9217,558,172,116343,17508
17,06613,1706613,Bloomington city, Illinois,1,2018,77955,42.60,76.40,13.50,39285,38670,60525,7246,6601,218,0,72036,5919
17,23074,1723074,Elgin city, Illinois,1,2018,110893,41.20,75.50,12.60,54429,56464,73607,7351,6243,50,0,63348,47545
18,27000,1827000,Gary city, Indiana,1,2018,69602,34.20,75.40,20.30,31071,38531,10393,53235,146,71,0,61603,7999
19,12000,1912000,Cedar Rapids city, Iowa,1,2018,133169,42.20,78.60,15.00,65741,67428,108489,13243,4973,305,586,128723,4446
51,14440,5114440,Centreville CDP, Virginia,0,2018,78356,41.10,77.10,10.50,38234,40122,43485,5479,22034,246,189,66871,11485
55,22300,5522300,Eau Claire city, Wisconsin,0,2018,68256,50.30,81.20,15.20,33447,34809,61354,596,4894,0,0,66023,2233
06,55156,0655156,Palmdale city, California,1,2018,156661,40.60,70.70,11.10,76835,79826,65899,19902,7535,1070,729,65195,91466
06,69196,0669196,Santa Maria city, California,1,2018,107424,44.50,67.60,8.90,53753,53671,89061,1468,4556,994,0,21271,86153
41,34100,4134100,Hillsboro city, Oregon,1,2018,108382,45.90,76.00,11.50,54483,53899,74964,3505,12990,693,361,88801,19581
24,04000,2404000,Baltimore city, Maryland,1,2018,602495,44.30,79.60,14.00,282677,319818,183276,371664,15490,1600,61,569434,33061
12,32000,1232000,Hollywood city, Florida,1,2018,154813,40.00,80.20,16.30,78329,76484,100042,31982,4908,760,0,92383,62430
12,58350,1258350,Port Charlotte CDP, Florida,0,2018,64815,26.80,85.60,31.60,30241,34574,54629,5528,867,77,215,56918,7897
12,60950,1260950,Riverview CDP, Florida,0,2018,89982,43.40,77.50,11.70,42930,47052,63807,17998,2525,377,0,67921,22061
37,75000,3775000,Winston-Salem city, North Carolina,1,2018,246334,42.10,76.30,13.80,117797,128537,137579,85690,6721,256,1307,207208,39126
06,46842,0646842,Menifee city, California,1,2018,92602,37.10,74.60,18.30,46509,46093,61008,5099,2617,1302,178,56293,36309
06,62000,0662000,Riverside city, California,1,2018,330080,48.70,76.40,10.50,160110,169970,209083,19591,27672,2736,660,144752,185328
25,67000,2567000,Springfield city, Massachusetts,1,2018,155029,43.60,75.90,13.30,75821,79208,97277,34369,3681,713,0,80031,74998
51,21088,5121088,Dale City CDP, Virginia,0,2018,68805,41.70,72.90,10.70,35840,32965,34949,17559,6719,794,0,46928,21877
06,73080,0673080,South Gate city, California,1,2018,94439,46.00,71.20,9.40,47917,46522,60943,611,864,757,653,3503,90936
25,34550,2534550,Lawrence city, Massachusetts,1,2018,80370,44.60,70.70,8.70,38578,41792,26489,3586,2109,173,0,14733,65637
34,13690,3413690,Clifton city, New Jersey,1,2018,85272,41.20,81.10,16.10,41941,43331,62880,3316,7425,98,82,51916,33356
39,61000,3961000,Parma city, Ohio,1,2018,78746,42.00,81.90,17.70,39251,39495,70046,3146,1720,18,0,74318,4428
20,38900,2038900,Lawrence city, Kansas,1,2018,97293,57.10,84.10,12.20,48090,49203,75876,5125,6828,4046,123,89954,7339
39,16000,3916000,Cleveland city, Ohio,1,2018,383781,41.80,78.50,14.30,188481,195300,158228,181840,11503,1987,249,336637,47144
39,21000,3921000,Dayton city, Ohio,1,2018,140638,45.80,81.30,13.80,69798,70840,74832,55336,1691,892,0,133839,6799
06,72016,0672016,Simi Valley city, California,1,2018,125844,37.40,79.50,17.20,60482,65362,99506,802,15091,446,226,94499,31345
12,14400,1214400,Coral Springs city, Florida,1,2018,133493,39.90,74.40,12.30,66655,66838,89008,30399,7359,10,154,94690,38803
13,68516,1368516,Sandy Springs city, Georgia,1,2018,108798,45.00,79.90,14.10,54298,54500,76021,18558,9227,189,267,95882,12916
17,18823,1718823,Decatur city, Illinois,1,2018,71860,36.50,79.10,20.70,33564,38296,50693,17344,484,149,0,69822,2038
17,72000,1772000,Springfield city, Illinois,1,2018,114512,39.10,78.00,17.30,55283,59229,82517,23521,3911,553,0,111600,2912
26,80700,2680700,Troy city, Michigan,1,2018,84259,38.20,78.80,16.50,41232,43027,55116,4744,21346,20,44,82149,2110
37,34200,3734200,Jacksonville city, North Carolina,1,2018,72895,64.70,78.40,5.70,43603,29292,49568,13977,2327,388,0,60280,12615
06,23182,0623182,Fairfield city, California,1,2018,116885,42.10,75.00,13.00,58945,57940,64471,16745,20227,921,424,84012,32873
06,24638,0624638,Folsom city, California,1,2018,79015,37.70,73.30,12.10,41354,37661,53243,2180,14740,289,260,67678,11337
06,54652,0654652,Oxnard city, California,1,2018,209886,45.10,74.00,9.70,110397,99489,164395,4601,13131,951,542,58253,151633
08,77290,0877290,Thornton city, Colorado,1,2018,139430,46.10,70.20,9.20,68281,71149,114139,2554,6454,1515,101,88332,51098
09,08000,0908000,Bridgeport city, Connecticut,1,2018,144898,45.20,76.50,11.20,69293,75605,49468,55260,5603,657,0,84971,59927
17,38570,1738570,Joliet city, Illinois,1,2018,149356,42.80,72.80,9.20,75343,74013,99248,27096,2648,856,127,97088,52268
48,48072,4848072,Midland city, Texas,1,2018,142339,44.40,72.50,10.00,72117,70222,114272,12640,3150,3069,182,82218,60121
06,36448,0636448,Indio city, California,1,2018,91235,38.30,85.10,21.30,43452,47783,49161,1245,1394,57,0,32308,58927
12,30000,1230000,Hialeah city, Florida,1,2018,238950,36.70,83.70,19.10,117193,121757,219812,4524,1662,52,0,10915,228035
25,11000,2511000,Cambridge city, Massachusetts,1,2018,118967,63.50,88.40,10.30,58344,60623,79472,10551,21603,178,471,105368,13599
25,82000,2582000,Worcester city, Massachusetts,1,2018,185883,47.80,81.80,13.30,92336,93547,127395,23956,16130,72,107,142887,42996
48,64472,4864472,San Angelo city, Texas,1,2018,101824,44.40,76.00,14.90,51356,50468,89438,4536,1917,534,7,58413,43411
04,27820,0427820,Glendale city, Arizona,1,2018,250705,41.40,74.60,13.10,124205,126500,185137,16663,10614,4165,327,153045,97660
04,65000,0465000,Scottsdale city, Arizona,1,2018,255315,35.60,84.40,22.90,126458,128857,225776,6093,13109,1407,283,226882,28433
06,03526,0603526,Bakersfield city, California,1,2018,383601,43.80,70.50,10.60,192252,191349,263237,32383,24531,2737,1119,186473,197128
06,22804,0622804,Escondido city, California,1,2018,152232,42.60,77.20,14.10,74713,77519,115538,3781,11072,1976,284,73058,79174
30,06550,3006550,Billings city, Montana,1,2018,109544,39.00,78.00,17.50,52882,56662,96367,528,1019,6409,67,102307,7237
37,19000,3719000,Durham city, North Carolina,1,2018,274497,47.10,79.10,12.20,129912,144585,136725,104079,14899,1101,0,235149,39348
13,01052,1301052,Albany city, Georgia,1,2018,71646,45.50,77.20,14.00,33095,38551,14341,53941,372,494,128,70530,1116
08,20000,0820000,Denver city, Colorado,1,2018,716492,50.10,80.50,11.70,358836,357656,544519,64199,26827,6686,1213,503930,212562
51,35000,5135000,Hampton city, Virginia,1,2018,134313,42.30,79.50,15.40,64444,69869,55091,67768,2668,317,237,126227,8086
13,72122,1372122,South Fulton city, Georgia,0,2018,97266,44.10,82.10,12.70,43003,54263,-998,-998,-998,-998,-998,96142,1124
22,08920,2208920,Bossier City city, Louisiana,0,2018,68222,45.20,76.50,15.00,32663,35559,43410,20571,942,79,0,61436,6786
24,26000,2426000,Ellicott City CDP, Maryland,0,2018,72689,36.90,74.00,13.70,33505,39184,41501,7148,20817,23,42,69354,3335
25,55745,2555745,Quincy city, Massachusetts,1,2018,94590,45.80,84.40,15.40,45315,49275,55548,6330,30173,124,0,91508,3082
06,77000,0677000,Sunnyvale city, California,1,2018,153175,46.50,80.10,12.00,80638,72537,58616,2548,77599,449,47,131417,21758
53,70000,5370000,Tacoma city, Washington,1,2018,216271,44.60,78.50,13.70,108542,107729,142454,20374,20435,3920,2902,192106,24165
38,07200,3807200,Bismarck city, North Dakota,0,2018,71843,41.50,78.80,17.20,35491,36352,64111,2208,567,2971,0,69808,2035
13,49008,1349008,Macon-Bibb County, Georgia,0,2018,153095,39.60,75.40,15.70,72997,80098,61370,81723,3249,188,144,147879,5216
06,45022,0645022,Madera city, California,0,2018,65711,43.70,67.40,10.00,32809,32902,29361,2899,905,128,0,14999,50712
12,35875,1235875,Jupiter town, Florida,0,2018,65544,34.80,83.00,20.20,30945,34599,56665,1578,1501,0,149,56584,8960
06,70098,0670098,Santa Rosa city, California,1,2018,177587,40.20,78.80,17.50,85668,91919,113551,2447,9432,2532,93,113617,63970
08,04000,0804000,Aurora city, Colorado,1,2018,373487,44.50,76.10,11.80,184950,188537,226683,65757,23272,4230,1399,264333,109154
32,68400,3268400,Sparks city, Nevada,1,2018,104254,38.50,74.90,17.20,51778,52476,75775,2659,6702,1784,955,73223,31031
36,73000,3673000,Syracuse city, New York,1,2018,142740,48.30,78.00,11.40,68926,73814,75751,46638,8482,2336,34,128815,13925
01,50000,0150000,Mobile city, Alabama,1,2018,189570,40.60,79.30,17.50,89005,100565,79694,102401,2758,579,85,184814,4756
48,63500,4863500,Round Rock city, Texas,1,2018,128490,46.00,73.50,9.60,65056,63434,98036,13551,8076,377,0,96660,31830
06,68378,0668378,San Ramon city, California,1,2018,75832,37.20,72.40,11.00,37827,38005,30525,1186,35787,0,1275,69350,6482
12,36100,1236100,Kendall CDP, Florida,0,2018,75979,35.20,81.00,21.10,34555,41424,67045,998,3219,0,0,22814,53165
13,01696,1301696,Alpharetta city, Georgia,0,2018,66263,35.60,72.30,9.80,32888,33375,-998,-998,-998,-998,-998,61272,4991
42,69000,4269000,Scranton city, Pennsylvania,1,2018,77186,40.40,78.80,16.60,38097,39089,62332,4053,4250,0,42,64255,12931
04,85540,0485540,Yuma city, Arizona,1,2018,97917,43.10,74.50,15.80,49808,48109,81988,3018,3077,850,0,39364,58553
06,82954,0682954,Visalia city, California,1,2018,133783,40.20,67.60,11.90,67405,66378,85269,4181,6897,795,34,65150,68633
31,37000,3137000,Omaha city, Nebraska,1,2018,468267,42.00,75.50,13.60,232016,236251,360742,56874,17430,4147,51,399520,68747
53,43955,5343955,Marysville city, Washington,0,2018,69765,42.50,78.10,13.00,34384,35381,55733,1223,5979,752,998,60658,9107
13,69000,1369000,Savannah city, Georgia,1,2018,145852,46.70,78.00,14.10,71764,74088,60547,73788,4070,355,742,136720,9132
22,39475,2239475,Kenner city, Louisiana,1,2018,66656,39.20,77.90,18.10,31185,35471,44922,13454,2599,796,0,50265,16391
51,57000,5157000,Norfolk city, Virginia,1,2018,244076,51.10,80.40,11.20,127098,116978,113964,98688,9250,614,211,223669,20407
09,55990,0955990,Norwalk city, Connecticut,1,2018,89049,38.30,79.80,17.90,43229,45820,65383,11758,3721,408,247,64624,24425
25,45000,2545000,New Bedford city, Massachusetts,1,2018,95323,45.10,77.60,13.50,48566,46757,56588,5919,1286,99,0,71076,24247
53,57745,5357745,Renton city, Washington,1,2018,102152,46.90,80.40,12.40,49738,52414,48248,9496,26987,582,1763,85972,16180
06,16532,0616532,Costa Mesa city, California,1,2018,113610,45.90,78.10,11.50,57046,56564,78549,2242,11628,396,0,73095,40515
12,55775,1255775,Pembroke Pines city, Florida,1,2018,172387,38.20,79.10,18.80,81969,90418,106193,39495,9891,1551,249,96523,75864
26,22000,2622000,Detroit city, Michigan,1,2018,672681,41.30,75.50,14.00,316529,356152,103779,522070,10597,1770,184,619963,52718
26,46000,2646000,Lansing city, Michigan,1,2018,117388,44.80,76.30,12.90,54222,63166,73069,26793,4039,519,0,101103,16285
48,37000,4837000,Irving city, Texas,1,2018,242228,48.40,73.00,6.40,121658,120570,106844,35443,47988,1057,100,134575,107653
06,13014,0613014,Chico city, California,1,2018,94787,50.70,80.90,13.30,45856,48931,76007,2300,3986,799,280,77464,17323
06,10046,0610046,Camarillo city, California,0,2018,69112,40.20,77.30,20.80,33539,35573,55881,1493,4832,136,136,50212,18900
12,32275,1232275,Homestead city, Florida,0,2018,70469,43.80,65.20,8.90,33750,36719,44953,12644,686,0,195,21394,49075
20,64500,2064500,Shawnee city, Kansas,0,2018,65844,38.40,73.80,12.70,31167,34677,58153,2617,966,0,0,60480,5364
04,54050,0454050,Peoria city, Arizona,1,2018,172272,35.50,76.70,18.10,84667,87605,141243,5653,9248,2497,607,141157,31115
06,82590,0682590,Victorville city, California,1,2018,122305,41.40,66.70,8.00,58474,63831,70153,28692,5855,2139,447,65607,56698
36,11000,3611000,Buffalo city, New York,1,2018,256322,45.30,76.60,12.50,123429,132893,118102,90050,16712,1050,22,223263,33059
48,79000,4879000,Wichita Falls city, Texas,1,2018,104568,46.70,77.50,13.30,54310,50258,78185,13870,3181,1227,0,82876,21692
06,47766,0647766,Milpitas city, California,1,2018,80424,43.70,77.30,11.50,42990,37434,11645,3811,54117,327,0,69900,10524
13,03440,1303440,Athens-Clarke County unified government (balance), Georgia,1,2018,126000,57.10,83.20,11.70,60481,65519,79583,35138,4947,311,166,112360,13640
26,76460,2676460,Sterling Heights city, Michigan,1,2018,132967,37.90,77.80,16.80,66262,66705,112657,6242,10309,557,0,131345,1622
25,24960,2524960,Framingham city, Massachusetts,0,2018,73123,42.90,82.80,17.40,37788,35335,49120,5634,6347,0,0,58802,14321
34,51000,3451000,Newark city, New Jersey,1,2018,282102,44.80,75.20,9.90,136968,145134,74843,139245,6047,237,0,171473,110629
49,44320,4944320,Lehi city, Utah,0,2018,66029,44.40,60.90,7.90,32432,33597,60758,43,1654,37,148,62154,3875
40,09050,4009050,Broken Arrow city, Oklahoma,1,2018,110123,40.40,73.80,15.00,52998,57125,84636,4114,4981,5016,0,100351,9772
06,13392,0613392,Chula Vista city, California,1,2018,271653,42.70,73.80,11.50,135432,136221,177460,9984,46536,449,1227,105229,166424
06,57792,0657792,Pleasanton city, California,1,2018,82377,35.40,74.50,15.10,41117,41260,46355,1403,28451,376,0,72919,9458
53,23515,5323515,Federal Way city, Washington,1,2018,97037,40.80,74.20,12.60,49468,47569,45835,16075,12370,1644,2459,76515,20522
01,07000,0107000,Birmingham city, Alabama,1,2018,209294,42.30,79.20,15.50,96634,112660,56509,141377,2946,361,206,199220,10074
06,17918,0617918,Daly City city, California,1,2018,107016,44.00,85.30,17.00,51137,55879,22549,2538,62960,161,880,81916,25100
06,60620,0660620,Richmond city, California,1,2018,110175,44.30,78.40,13.70,55031,55144,35479,18232,21967,265,1107,66390,43785
06,78120,0678120,Temecula city, California,1,2018,114749,39.00,69.30,10.20,55532,59217,81226,6106,8283,239,2246,77660,37089
06,83346,0683346,Walnut Creek city, California,0,2018,69814,33.20,86.60,31.80,32496,37318,49528,1428,11175,167,153,63375,6439
08,07850,0807850,Boulder city, Colorado,1,2018,107355,57.50,86.90,11.50,53767,53588,92242,938,6202,193,51,94573,12782
09,50370,0950370,New Britain city, Connecticut,1,2018,72440,45.40,76.90,12.00,35368,37072,52573,8764,2557,48,0,39612,32828
12,10275,1210275,Cape Coral city, Florida,1,2018,189342,29.80,83.60,25.40,94381,94961,170640,10826,3854,0,23,155033,34309
12,36950,1236950,Kissimmee city, Florida,0,2018,73596,50.60,79.90,12.10,37786,35810,51874,9956,2339,0,4,19965,53631
25,09000,2509000,Brockton city, Massachusetts,1,2018,95781,42.70,75.10,13.90,47020,48761,33789,46027,1985,91,0,85388,10393
47,15160,4715160,Clarksville city, Tennessee,1,2018,156800,49.90,74.10,8.10,79914,76886,98694,40681,4825,1503,483,140097,16703
05,15190,0515190,Conway city, Arkansas,0,2018,66421,53.50,80.50,12.20,30182,36239,47377,12191,1570,360,0,62671,3750
26,86000,2686000,Westland city, Michigan,1,2018,81714,38.20,79.20,16.80,36466,45248,59001,16122,3625,205,0,78470,3244
05,50450,0550450,North Little Rock city, Arkansas,0,2018,66126,40.30,75.20,16.80,31283,34843,36551,25815,435,208,0,62449,3677
45,13330,4513330,Charleston city, South Carolina,1,2018,141088,47.30,82.80,14.40,65108,75980,107995,27218,3005,0,0,135733,5355
48,56348,4856348,Pearland city, Texas,1,2018,124321,41.00,73.20,13.60,62347,61974,74586,25162,18760,217,0,95913,28408
48,72656,4872656,The Woodlands CDP, Texas,0,2018,107305,29.30,72.70,14.60,52944,54361,91218,4568,5820,111,128,91207,16098
06,00884,0600884,Alhambra city, California,1,2018,84650,43.10,83.60,17.60,40753,43897,19460,1843,39097,312,38,51610,33040
06,62938,0662938,Roseville city, California,1,2018,139110,38.80,76.30,16.90,69014,70096,111786,2169,13304,257,339,119333,19777
06,70000,0670000,Santa Monica city, California,1,2018,91417,44.00,83.70,17.20,46087,45330,69355,4011,9227,351,120,78060,13357
26,88940,2688940,Wyoming city, Michigan,1,2018,75812,43.30,77.60,12.40,35742,40070,54997,4258,5464,867,132,58679,17133
06,69084,0669084,Santa Clara city, California,1,2018,129489,49.00,80.10,12.70,69045,60444,58332,2525,54638,145,389,105856,23633
12,16475,1216475,Davie town, Florida,1,2018,106565,44.00,79.60,12.60,52859,53706,80700,6403,4840,143,0,59246,47319
47,27740,4727740,Franklin city, Tennessee,0,2018,80920,40.00,74.90,12.10,38340,42580,66834,6078,5015,32,0,76909,4011
06,48354,0648354,Modesto city, California,1,2018,215032,41.50,72.60,12.60,103806,111226,164276,9144,12790,2669,3419,124745,90287
06,52526,0652526,Norwalk city, California,1,2018,105125,42.10,76.10,13.80,52101,53024,35801,3881,17869,487,819,32971,72154
39,18000,3918000,Columbus city, Ohio,1,2018,895877,48.70,77.80,10.70,437213,458664,515828,262044,55627,3079,68,841942,53935
08,45970,0845970,Longmont city, Colorado,1,2018,95986,40.20,77.90,16.50,48068,47918,84493,1360,3439,830,66,75010,20976
27,06616,2706616,Bloomington city, Minnesota,1,2018,85574,36.40,80.70,20.70,40884,44690,63677,7023,6595,151,4,80608,4966
34,74630,3474630,Union City city, New Jersey,1,2018,68521,47.00,74.30,10.50,32945,35576,45069,5441,1535,0,0,15669,52852
49,65330,4965330,St. George city, Utah,1,2018,87178,36.80,76.10,24.10,43185,43993,78465,622,615,1648,851,75822,11356
06,45484,0645484,Manteca city, California,1,2018,81593,39.10,76.60,13.90,40765,40828,56803,2107,7942,770,878,47479,34114
06,82996,0682996,Vista city, California,1,2018,101227,44.40,75.90,9.80,52543,48684,81390,4035,5081,590,283,54321,46906
06,85292,0685292,Whittier city, California,1,2018,86060,43.10,79.40,14.80,42530,43530,43187,1033,4786,1570,0,28267,57793
13,04204,1304204,Augusta-Richmond County consolidated government (balance), Georgia,1,2018,196138,43.80,77.50,14.10,93254,102884,70382,112032,4377,595,118,186241,9897
48,53388,4853388,Odessa city, Texas,1,2018,122440,44.70,71.00,9.50,60903,61537,95567,8127,2001,925,109,52083,70357
53,67000,5367000,Spokane city, Washington,1,2018,219197,43.10,79.90,15.70,107750,111447,185895,5231,4604,2886,2159,204140,15057
47,40000,4740000,Knoxville city, Tennessee,1,2018,187514,48.10,81.90,12.90,90322,97192,142844,31844,2689,615,0,177567,9947
06,60102,0660102,Redwood City city, California,1,2018,86186,44.40,79.50,14.50,42032,44154,50664,1718,11578,855,635,52472,33714
12,45975,1245975,Miramar city, Florida,1,2018,140827,40.70,75.50,10.10,68622,72205,52305,69664,11601,314,47,94223,46604
17,65000,1765000,Rockford city, Illinois,1,2018,147676,38.20,75.50,18.00,70449,77227,101802,31980,5570,216,0,122631,25045
25,37490,2537490,Lynn city, Massachusetts,1,2018,94655,44.40,76.30,12.20,47556,47099,50017,15418,4800,61,0,48074,46581
53,61115,5361115,Sammamish city, Washington,0,2018,65726,35.80,70.20,7.10,32706,33020,-998,-998,-998,-998,-998,63836,1890
06,37692,0637692,Jurupa Valley city, California,0,2018,108400,44.30,73.50,11.80,55789,52611,57260,3976,4927,462,363,32383,76017
49,67000,4967000,Salt Lake City city, Utah,1,2018,200576,52.80,80.20,10.40,102709,97867,148780,4734,9523,3252,1774,157445,43131
51,64000,5164000,Portsmouth city, Virginia,1,2018,94632,41.30,76.90,14.70,46138,48494,37625,47317,1429,1554,0,90223,4409
06,39892,0639892,Lakewood city, California,1,2018,80132,43.20,80.90,12.00,39538,40594,36809,6878,15808,439,1030,53382,26750
06,56700,0656700,Perris city, California,1,2018,79139,45.80,66.20,5.80,41065,38074,27697,7217,3583,208,290,19362,59777
12,16725,1216725,Deerfield Beach city, Florida,1,2018,80854,34.90,85.30,24.00,39809,41045,54902,19574,677,97,0,61536,19318
12,17200,1217200,Deltona city, Florida,1,2018,91946,38.40,76.00,16.00,45602,46344,67261,11629,2634,0,0,58755,33191
12,57425,1257425,Plantation city, Florida,1,2018,94291,39.80,77.40,16.30,45673,48618,58946,22908,4163,218,0,70192,24099
12,76600,1276600,West Palm Beach city, Florida,1,2018,111389,39.10,82.80,19.70,52855,58534,66194,36960,2027,0,0,81339,30050
40,75000,4075000,Tulsa city, Oklahoma,1,2018,401112,41.10,75.60,14.70,194240,206872,263783,63841,12120,18141,186,334140,66972
06,11530,0611530,Carson city, California,1,2018,91899,42.10,77.10,15.00,42382,49517,26557,22829,17430,486,4238,51276,40623
06,64000,0664000,Sacramento city, California,1,2018,508517,45.10,76.60,13.30,247463,261054,225098,67826,99214,2764,10191,360174,148343
06,86972,0686972,Yuba City city, California,0,2018,66988,39.50,74.20,16.40,31787,35201,44198,1463,11194,589,1251,46698,20290
12,63000,1263000,St. Petersburg city, Florida,1,2018,265100,39.50,82.20,17.70,128379,136721,178420,58822,13183,1012,580,240688,24412
34,36000,3436000,Jersey City city, New Jersey,1,2018,265560,50.00,78.40,10.70,132817,132743,90986,60556,70962,2383,0,189638,75922
36,08026,3608026,Brentwood CDP, New York,0,2018,64855,44.40,71.90,8.10,31642,33213,39083,8646,1986,934,84,18019,46836
08,36410,0836410,Highlands Ranch CDP, Colorado,0,2018,108257,38.60,73.60,11.00,53531,54726,98361,1219,5213,203,0,97660,10597
12,17100,1217100,Delray Beach city, Florida,0,2018,69356,35.00,85.10,25.20,32048,37308,45110,19189,1526,116,41,61031,8325
34,57000,3457000,Paterson city, New Jersey,1,2018,145626,40.60,72.10,11.00,72398,73228,38944,38204,6561,135,219,57811,87815
48,50820,4850820,New Braunfels city, Texas,0,2018,85566,41.00,74.80,14.60,43417,42149,79623,1242,611,407,0,53111,32455
49,70850,4970850,South Jordan city, Utah,0,2018,74155,45.00,67.40,8.90,35788,38367,63833,807,2924,99,30,68084,6071
48,05000,4805000,Austin city, Texas,1,2018,964243,51.40,80.30,9.40,486285,477958,682357,82148,73960,8555,439,649294,314949
06,22230,0622230,El Monte city, California,1,2018,115602,42.50,76.00,13.30,56533,59069,53017,842,30897,1973,347,36036,79566
01,03076,0103076,Auburn city, Alabama,0,2018,65737,60.00,82.00,8.00,31482,34255,48691,9784,5671,0,0,63656,2081
06,24477,0624477,Florence-Graham CDP, California,0,2018,63621,46.20,68.00,8.00,32442,31179,-998,-998,-998,-998,-998,4540,59081
06,44574,0644574,Lynwood city, California,1,2018,70492,46.30,72.60,8.20,34445,36047,38803,5682,674,468,130,9406,61086
10,77580,1077580,Wilmington city, Delaware,1,2018,70653,43.10,78.20,11.80,34605,36048,26621,40965,760,206,83,63471,7182
12,39425,1239425,Largo city, Florida,1,2018,85008,31.90,84.90,27.60,38063,46945,74801,5256,1513,120,21,74537,10471
04,04720,0404720,Avondale city, Arizona,1,2018,85828,46.40,71.70,8.90,42328,43500,58546,10346,3117,814,123,41678,44150
06,06000,0606000,Berkeley city, California,1,2018,121654,57.10,88.60,13.70,61022,60632,64094,9894,29839,687,758,106703,14951
27,58000,2758000,St. Paul city, Minnesota,1,2018,307701,46.50,75.80,10.80,151617,156084,173556,45362,59746,3217,86,281620,26081
37,55000,3755000,Raleigh city, North Carolina,1,2018,470509,48.60,79.60,11.30,228779,241730,271068,132356,22926,888,0,420235,50274
06,03666,0603666,Baldwin Park city, California,1,2018,75806,45.20,78.50,10.50,37397,38409,33502,589,15349,1046,0,19724,56082
18,05860,1805860,Bloomington city, Indiana,1,2018,86522,68.70,88.60,9.60,44262,42260,69643,3370,9464,654,0,83164,3358
02,03000,0203000,Anchorage municipality, Alaska,1,2018,291538,43.60,75.50,11.30,148668,142870,181491,16679,28273,22022,6105,264431,27107
42,60000,4260000,Philadelphia city, Pennsylvania,1,2018,1584138,44.80,78.30,13.60,750017,834121,623482,657756,116907,4326,582,1343869,240269
17,14351,1714351,Cicero town, Illinois,1,2018,81602,44.50,72.30,8.10,39115,42487,28614,3058,64,147,34,11133,70469
24,30325,2430325,Frederick city, Maryland,0,2018,72152,42.30,76.50,13.40,35359,36793,54106,11101,3854,0,0,57262,14890
25,23000,2523000,Fall River city, Massachusetts,1,2018,89662,37.80,77.80,16.70,42429,47233,74561,5658,2475,59,0,82145,7517
25,62535,2562535,Somerville city, Massachusetts,1,2018,81568,63.90,87.80,7.70,40572,40996,60477,5083,7492,204,0,72240,9328
48,13024,4813024,Carrollton city, Texas,1,2018,136869,41.90,77.30,12.50,64303,72566,94309,16413,19661,149,396,93045,43824
06,44000,0644000,Los Angeles city, California,1,2018,3990469,46.10,79.80,12.80,1995286,1995183,2072924,345892,481963,30566,7017,2038613,1951856
06,08954,0608954,Burbank city, California,1,2018,103687,41.30,82.50,15.00,51615,52072,77672,2307,12766,894,0,81369,22318
37,28080,3728080,Greenville city, North Carolina,1,2018,93136,59.60,80.80,9.30,43005,50131,50812,35016,2810,660,0,88533,4603
06,60018,0660018,Redondo Beach city, California,1,2018,67396,37.10,76.80,13.40,33336,34060,46842,3957,9008,341,89,54701,12695
19,38595,1938595,Iowa City city, Iowa,1,2018,76291,58.60,85.20,10.80,40165,36126,57333,6640,6546,134,250,72264,4027
37,14100,3714100,Concord city, North Carolina,1,2018,94134,39.90,75.40,13.80,46368,47766,59999,22433,5278,0,74,82686,11448
48,45384,4845384,McAllen city, Texas,1,2018,143429,43.70,69.90,11.80,68066,75363,113985,773,4947,106,0,18427,125002
17,03012,1703012,Aurora city, Illinois,1,2018,206389,42.90,70.90,9.00,102657,103732,133728,19436,17960,1665,126,113672,92717
20,36000,2036000,Kansas City city, Kansas,1,2018,154361,41.20,72.00,12.10,76933,77428,86325,34052,7768,618,1379,107553,46808
32,31900,3231900,Henderson city, Nevada,1,2018,310374,36.70,78.10,18.90,151415,158959,228182,18097,26810,1765,2334,256474,53900
48,30464,4830464,Grand Prairie city, Texas,1,2018,194600,44.20,72.70,9.50,93287,101313,117963,36313,11677,676,175,98351,96249
05,23290,0523290,Fayetteville city, Arkansas,1,2018,86765,59.70,82.70,7.60,43372,43393,68149,5433,2687,659,1078,79394,7371
48,56000,4856000,Pasadena city, Texas,1,2018,153212,44.80,71.40,9.20,76591,76621,137365,4196,2290,2481,35,44416,108796
06,73430,0673430,South Whittier CDP, California,0,2018,65577,42.30,75.40,11.80,32411,33166,24978,225,4921,256,705,15772,49805
12,24125,1224125,Fort Myers city, Florida,0,2018,82260,34.70,80.00,24.20,39940,42320,50588,18790,2159,0,185,63648,18612
12,58715,1258715,Port St. Lucie city, Florida,1,2018,195251,35.90,78.30,21.10,95575,99676,144022,37720,3977,0,230,158547,36704
48,29336,4829336,Georgetown city, Texas,0,2018,74176,31.90,78.90,28.50,34774,39402,66749,4113,826,135,91,55844,18332
48,76000,4876000,Waco city, Texas,1,2018,138180,50.10,75.30,11.10,66618,71562,100206,29326,2646,249,28,91175,47005
05,24550,0524550,Fort Smith city, Arkansas,1,2018,87851,40.50,75.60,14.10,43567,44284,55900,8662,4910,1048,57,70523,17328
06,13588,0613588,Citrus Heights city, California,1,2018,87916,41.90,79.10,16.50,42182,45734,71654,2362,3726,633,302,68716,19200
06,24680,0624680,Fontana city, California,1,2018,213736,46.10,72.40,7.90,106494,107242,77981,16967,13046,877,334,63678,150058
32,51800,3251800,North Las Vegas city, Nevada,1,2018,245949,42.70,71.80,10.60,120011,125938,129926,49211,12521,1559,3750,139304,106645
06,00562,0600562,Alameda city, California,1,2018,78322,38.80,79.00,17.30,38198,40124,37702,5863,21905,97,421,68220,10102
22,41155,2241155,Lake Charles city, Louisiana,1,2018,77999,42.10,76.90,14.60,38777,39222,-998,-998,-998,-998,-998,75611,2388
27,51730,2751730,Plymouth city, Minnesota,1,2018,79437,39.00,78.20,14.10,40265,39172,60194,5451,9381,139,111,75633,3804
04,55000,0455000,Phoenix city, Arizona,1,2018,1660272,44.20,74.20,10.80,824568,835704,1278742,121943,57194,40653,2989,945954,714318
21,46027,2146027,Lexington-Fayette urban county, Kentucky,1,2018,323780,45.60,79.20,13.30,158158,165622,240762,47626,12495,356,0,299752,24028
06,11390,0611390,Carmichael CDP, California,0,2018,65328,37.30,78.30,20.00,31376,33952,51486,2655,3945,320,45,54557,10771
18,54180,1854180,Noblesville city, Indiana,0,2018,66358,45.30,72.60,10.50,33273,33085,-998,-998,-998,-998,-998,65051,1307
27,07966,2707966,Brooklyn Park city, Minnesota,1,2018,80614,39.00,72.10,12.30,38689,41925,33961,27166,13912,0,50,75021,5593
39,15000,3915000,Cincinnati city, Ohio,1,2018,302615,46.50,78.60,12.50,146754,155861,155452,123267,7028,244,55,291842,10773
39,88000,3988000,Youngstown city, Ohio,1,2018,64958,40.30,78.90,17.80,32300,32658,31954,25113,417,217,0,56806,8152
47,38320,4738320,Johnson City city, Tennessee,0,2018,68245,41.90,83.70,16.20,33183,35062,58063,4656,2244,291,0,64456,3789
48,13552,4813552,Cedar Park city, Texas,0,2018,75553,42.90,72.30,8.40,37207,38346,60595,2481,6512,167,0,58551,17002
48,57200,4857200,Pharr city, Texas,1,2018,79704,43.70,67.10,10.60,36682,43022,-998,-998,-998,-998,-998,5486,74218
06,53980,0653980,Orange city, California,1,2018,139502,45.30,79.60,11.90,70020,69482,101663,2417,17803,283,183,86269,53233
48,27684,4827684,Frisco city, Texas,1,2018,188153,40.80,69.20,8.70,93624,94529,121347,18325,39223,919,0,167387,20766
48,42508,4842508,Lewisville city, Texas,1,2018,106205,47.50,76.00,8.80,52430,53775,73535,12675,10480,416,93,72525,33680
55,39225,5539225,Kenosha city, Wisconsin,1,2018,100151,40.90,76.00,12.60,50319,49832,78421,11042,2674,414,83,82757,17394
22,50115,2250115,Metairie CDP, Louisiana,0,2018,141114,37.00,81.10,19.90,70454,70660,112695,15003,6866,380,67,120524,20590
06,50076,0650076,Murrieta city, California,1,2018,114982,39.00,70.50,11.90,58574,56408,82876,4617,10227,43,226,75789,39193
23,60545,2360545,Portland city, Maine,1,2018,66420,46.30,84.70,12.90,32586,33834,58143,5102,1310,27,109,65290,1130
27,54880,2754880,Rochester city, Minnesota,1,2018,116957,40.70,77.00,15.40,57492,59465,92665,9964,8710,200,64,109824,7133
06,36770,0636770,Irvine city, California,1,2018,282584,48.00,77.90,10.50,138076,144508,137841,2936,120706,1198,402,247353,35231
06,41992,0641992,Livermore city, California,1,2018,90258,37.00,77.10,13.60,45064,45194,65759,2753,10895,225,788,72387,17871
48,47892,4847892,Mesquite city, Texas,1,2018,142874,39.90,68.30,9.60,70739,72135,91312,34843,3629,1357,40,74409,68465
53,03180,5303180,Auburn city, Washington,1,2018,82782,39.10,75.70,13.90,40948,41834,49411,6087,10683,1168,1238,67989,14793
06,32548,0632548,Hawthorne city, California,1,2018,86970,42.80,76.20,9.90,39957,47013,35610,24695,7573,1182,366,43288,43682
12,75875,1275875,Wesley Chapel CDP, Florida,0,2018,65249,40.50,74.10,11.00,32094,33155,47105,6455,5335,424,38,51994,13255
20,53775,2053775,Overland Park city, Kansas,1,2018,192525,40.20,77.80,16.10,95915,96610,157046,9319,17779,603,128,178615,13910
29,70000,2970000,Springfield city, Missouri,1,2018,168113,45.80,82.80,17.60,82007,86106,151016,6551,2844,982,36,161561,6552
06,02364,0602364,Apple Valley town, California,1,2018,73508,34.10,70.90,15.60,35771,37737,55980,6657,1247,254,2,47117,26391
06,04982,0604982,Bellflower city, California,1,2018,77132,44.00,75.70,10.20,37337,39795,24296,9733,10031,258,1263,34616,42516
06,08786,0608786,Buena Park city, California,1,2018,82435,43.40,78.80,12.10,40112,42323,42395,2605,28735,444,250,52628,29807
18,22000,1822000,Evansville city, Indiana,1,2018,117967,41.70,78.80,15.50,58319,59648,92986,17983,1382,156,0,113734,4233
04,46000,0446000,Mesa city, Arizona,1,2018,508979,40.20,75.90,16.40,250913,258066,412281,25378,8360,13246,2400,366448,142531
06,13210,0613210,Chino city, California,1,2018,91589,44.80,78.00,13.20,46721,44868,50505,5588,15651,487,226,46820,44769
08,83835,0883835,Westminster city, Colorado,1,2018,113473,42.70,80.00,13.50,58634,54839,99666,2961,3481,1288,52,85250,28223
37,12000,3712000,Charlotte city, North Carolina,1,2018,872506,45.80,77.00,10.90,421513,450993,412362,311637,61615,4507,269,745742,126764
48,39148,4839148,Killeen city, Texas,1,2018,149102,47.90,69.00,6.40,73090,76012,65326,64870,4563,1694,1207,108242,40860
49,55980,4955980,Ogden city, Utah,1,2018,87305,48.00,73.60,10.70,43909,43396,75256,1624,1023,912,803,61098,26207
13,19000,1319000,Columbus city, Georgia,1,2018,194160,42.50,75.20,13.40,94670,99490,83257,91077,4211,107,224,179273,14887
51,47672,5147672,Lynchburg city, Virginia,1,2018,82126,49.20,80.50,14.50,38123,44003,52897,23311,1889,277,0,78509,3617
51,67000,5167000,Richmond city, Virginia,1,2018,228783,49.10,82.60,13.20,107729,121054,108092,106543,5502,236,0,212607,16176
06,69070,0669070,Santa Barbara city, California,1,2018,91330,42.50,82.30,18.20,45623,45707,72303,960,4098,817,0,51719,39611
12,54000,1254000,Palm Bay city, Florida,1,2018,114190,33.90,80.00,23.10,54497,59693,83716,17650,2684,256,0,94430,19760
17,12385,1712385,Champaign city, Illinois,1,2018,88033,55.80,81.60,11.20,43833,44200,53772,17104,14080,9,0,82792,5241
53,57535,5357535,Redmond city, Washington,0,2018,67680,49.50,73.80,8.00,35073,32607,38497,1413,23119,412,0,59310,8370
06,68196,0668196,San Marcos city, California,1,2018,96834,44.70,76.00,12.00,49201,47633,73554,1775,8314,365,0,51611,45223
08,62000,0862000,Pueblo city, Colorado,1,2018,111751,39.80,78.10,18.80,55273,56478,85916,3399,1053,4194,79,58375,53376
37,28000,3728000,Greensboro city, North Carolina,1,2018,294726,43.10,78.30,13.90,138206,156520,141028,119500,14874,1369,5,269082,25644
42,02000,4202000,Allentown city, Pennsylvania,1,2018,121429,45.50,75.80,12.40,59802,61627,71941,18651,5137,1318,0,55998,65431
06,39248,0639248,Laguna Niguel city, California,0,2018,66265,37.50,82.60,17.00,33355,32910,49118,1799,6940,0,94,55279,10986
06,65084,0665084,San Clemente city, California,0,2018,64850,33.90,78.50,18.10,32337,32513,53327,792,2927,91,0,51899,12951
17,02154,1702154,Arlington Heights village, Illinois,1,2018,77259,36.30,80.70,20.60,37748,39511,62939,893,10323,38,115,71672,5587
53,05210,5305210,Bellevue city, Washington,1,2018,147595,43.50,79.30,14.40,75209,72386,78543,4224,55089,145,0,138314,9281
55,84250,5584250,Waukesha city, Wisconsin,1,2018,72549,44.60,80.10,14.60,35607,36942,65395,2539,3158,186,0,64349,8200
27,43000,2743000,Minneapolis city, Minnesota,1,2018,425395,52.40,79.80,10.80,214813,210582,270795,82552,26877,7745,0,384483,40912
40,52500,4052500,Norman city, Oklahoma,1,2018,123469,53.50,79.80,11.60,60581,62888,91114,6588,6971,6597,47,112590,10879
04,12000,0412000,Chandler city, Arizona,1,2018,257153,41.60,75.50,11.80,126583,130570,187013,13379,31287,3531,581,205321,51832
12,71000,1271000,Tampa city, Florida,1,2018,392905,45.80,77.60,12.50,192670,200235,246391,94786,15046,1295,0,286949,105956
21,48006,2148006,Louisville/Jefferson County metro government (balance), Kentucky,1,2018,620149,40.10,77.50,15.40,302893,317256,426337,149053,17961,1829,0,585170,34979
48,29000,4829000,Garland city, Texas,1,2018,242402,42.80,74.10,12.40,118496,123906,148644,35681,29998,2558,0,137716,104686
48,45744,4845744,McKinney city, Texas,1,2018,191666,41.50,72.00,11.20,92013,99653,145554,22319,13257,728,0,158297,33369
19,19000,1919000,Davenport city, Iowa,1,2018,102080,41.10,77.60,15.00,50743,51337,82594,10356,2837,471,175,94314,7766
48,72176,4872176,Temple city, Texas,0,2018,76251,39.10,74.80,17.30,36475,39776,57986,11152,1106,420,0,56318,19933
06,59962,0659962,Redlands city, California,1,2018,71595,42.10,79.00,16.40,32314,39281,54642,3351,4480,52,306,46473,25122
12,72145,1272145,Town 'n' Country CDP, Florida,0,2018,82577,41.80,79.60,14.90,40805,41772,61582,6181,4147,236,0,39512,43065
16,52120,1652120,Meridian city, Idaho,1,2018,106794,41.50,71.00,9.70,52903,53891,95137,227,4297,350,460,98454,8340
28,36000,2836000,Jackson city, Mississippi,1,2018,164720,44.70,76.10,13.30,75656,89064,25874,136279,824,146,27,162785,1935
47,37640,4737640,Jackson city, Tennessee,0,2018,66900,41.30,75.80,14.60,31566,35334,30588,32058,1033,80,0,63439,3461
12,07875,1207875,Boynton Beach city, Florida,1,2018,78038,38.60,82.70,22.90,36897,41141,41802,28311,2666,156,0,67396,10642
12,68350,1268350,Spring Hill CDP, Florida,0,2018,117519,34.80,79.50,23.40,56881,60638,99768,8343,1893,598,0,94457,23062
26,49000,2649000,Livonia city, Michigan,1,2018,93970,37.40,79.70,16.90,46458,47512,82735,4277,3707,473,0,91491,2479
48,07000,4807000,Beaumont city, Texas,1,2018,118425,40.70,75.00,15.00,56416,62009,53687,55408,4948,126,0,97689,20736
06,75000,0675000,Stockton city, California,1,2018,311189,43.10,71.70,12.30,151561,159628,145895,37348,69347,1579,2003,179998,131191
36,84000,3684000,Yonkers city, New York,1,2018,199646,39.10,81.00,17.10,95456,104190,103825,40916,9398,1344,0,120774,78872
17,59000,1759000,Peoria city, Illinois,1,2018,115720,40.60,75.10,15.30,55443,60277,70808,29876,7476,511,0,108827,6893
26,27440,2627440,Farmington Hills city, Michigan,1,2018,81103,36.40,82.90,20.80,39123,41980,49645,16377,12304,595,171,78430,2673
29,15670,2915670,Columbia city, Missouri,1,2018,123182,54.80,81.50,10.90,59551,63631,97048,11041,7653,553,0,118020,5162
37,31400,3731400,High Point city, North Carolina,1,2018,114322,40.90,76.10,14.60,53691,60631,55898,37200,9727,1269,46,102336,11986
36,15000,3615000,Cheektowaga CDP, New York,0,2018,74223,43.40,83.40,19.30,34792,39431,58007,10618,1990,224,0,72384,1839
05,35710,0535710,Jonesboro city, Arkansas,1,2018,76990,44.40,73.10,11.40,36818,40172,56699,16246,634,326,0,72298,4692
06,73262,0673262,South San Francisco city, California,0,2018,67736,40.30,82.00,18.50,32860,34876,22128,1120,29427,171,370,46683,21053
12,58050,1258050,Pompano Beach city, Florida,1,2018,111930,36.10,83.00,20.10,58674,53256,64154,41216,1511,203,36,90040,21890
29,35000,2935000,Independence city, Missouri,1,2018,116939,37.80,78.20,16.80,54315,62624,96479,11088,990,316,2055,110105,6834
37,74440,3774440,Wilmington city, North Carolina,1,2018,122610,45.30,82.90,17.10,57238,65372,91104,26057,1823,258,0,115396,7214
48,01924,4801924,Allen city, Texas,1,2018,103378,37.00,75.00,10.20,53478,49900,71117,10517,19157,691,0,92277,11101
48,70808,4870808,Sugar Land city, Texas,1,2018,118614,36.50,78.90,17.40,57942,60672,64922,6721,41506,699,43,101920,16694
06,27000,0627000,Fresno city, California,1,2018,530073,43.80,72.10,11.40,261641,268432,317715,35127,75516,7929,775,267735,262338
06,53000,0653000,Oakland city, California,1,2018,429114,46.60,80.90,13.50,204202,224912,150454,99449,65748,3743,3324,315476,113638
31,28000,3128000,Lincoln city, Nebraska,1,2018,287399,46.70,77.80,13.20,144380,143019,242363,12423,12494,2057,123,265060,22339
04,64210,0464210,San Tan Valley CDP, Arizona,0,2018,105922,41.20,68.60,11.10,51620,54302,90617,2811,3060,943,69,78646,27276
19,73335,1973335,Sioux City city, Iowa,1,2018,82762,39.80,73.10,14.00,41312,41450,70635,4374,2499,1873,137,67149,15613
27,40166,2740166,Maple Grove city, Minnesota,0,2018,71812,35.80,77.00,15.50,35348,36464,59177,4019,4262,805,0,69289,2523
51,56000,5156000,Newport News city, Virginia,1,2018,178626,44.10,76.90,13.10,87141,91485,85037,75446,6400,126,381,162225,16401
06,68252,0668252,San Mateo city, California,1,2018,105016,41.10,79.90,16.90,51736,53280,54868,2274,27655,457,2683,85666,19350
22,05000,2205000,Baton Rouge city, Louisiana,1,2018,221606,46.30,78.80,15.30,106292,115314,84217,122315,6966,246,0,212566,9040
72,32522,7232522,Guaynabo zona urbana, Puerto Rico,0,2018,67294,37.20,85.50,23.10,32724,34570,50632,5085,121,36,0,966,66328
09,80000,0980000,Waterbury city, Connecticut,1,2018,108086,43.10,76.10,12.40,50468,57618,65751,23701,2261,586,0,69804,38282
48,01000,4801000,Abilene city, Texas,1,2018,125456,48.60,76.10,12.50,64161,61295,88513,13299,3726,470,27,91321,34135
51,76432,5176432,Suffolk city, Virginia,1,2018,91185,37.70,75.80,14.40,44445,46740,46485,37311,1952,174,0,86926,4259
01,35896,0135896,Hoover city, Alabama,1,2018,85115,36.70,72.90,17.80,39998,45117,60576,14801,4687,198,43,78670,6445
06,39496,0639496,Lake Forest city, California,1,2018,85619,40.00,77.80,15.10,41395,44224,54985,3286,17223,148,344,70147,15472
12,71569,1271569,The Hammocks CDP, Florida,0,2018,64910,38.60,78.80,17.70,31000,33910,51441,2341,1359,0,0,13899,51011
24,32025,2432025,Germantown CDP, Maryland,0,2018,81399,40.10,74.20,12.10,37946,43453,41120,14699,14343,138,0,62369,19030
48,15976,4815976,College Station city, Texas,1,2018,116218,66.10,84.10,7.80,59676,56542,91533,6765,12060,107,0,93480,22738
42,61000,4261000,Pittsburgh city, Pennsylvania,1,2018,301038,51.10,86.00,15.60,143718,157320,202511,68867,16813,690,157,290858,10180
34,56550,3456550,Passaic city, New Jersey,1,2018,69945,44.10,70.20,9.80,35704,34241,40141,4991,1832,478,0,15487,54458
24,81175,2481175,Waldorf CDP, Maryland,0,2018,78591,42.80,74.80,9.40,36316,42275,18644,51929,2109,481,0,72081,6510
34,10000,3410000,Camden city, New Jersey,1,2018,73968,41.30,70.10,9.80,33272,40696,10844,29375,1288,227,0,34522,39446
48,48768,4848768,Mission city, Texas,1,2018,84829,37.00,64.30,13.60,40715,44114,-998,-998,-998,-998,-998,7154,77675
06,69000,0669000,Santa Ana city, California,1,2018,332727,46.40,74.50,9.70,173527,159200,143656,5420,38202,1529,393,77765,254962
06,81204,0681204,Union City city, California,1,2018,74568,44.40,82.20,15.70,37854,36714,13936,3252,38022,290,567,55782,18786
39,77000,3977000,Toledo city, Ohio,1,2018,274973,42.60,76.80,14.00,133721,141252,168318,75931,2873,1093,390,250348,24625
41,59000,4159000,Portland city, Oregon,1,2018,652573,47.10,82.20,13.40,322810,329763,503158,40763,58246,6184,4657,591813,60760
48,35000,4835000,Houston city, Texas,1,2018,2326090,46.40,75.10,10.60,1154069,1172021,1252435,522419,169263,8662,1259,1281160,1044930
53,80010,5380010,Yakima city, Washington,1,2018,93874,40.70,73.50,17.00,46778,47096,70046,930,823,2038,114,52939,40935
06,67000,0667000,San Francisco city, California,1,2018,883305,48.30,86.60,15.60,450985,432320,400727,45886,302795,2308,2126,748641,134664
22,55000,2255000,New Orleans city, Louisiana,1,2018,391006,43.20,80.00,14.70,185255,205751,133177,231314,10870,706,0,369044,21962
06,18100,0618100,Davis city, California,0,2018,69288,59.50,85.20,10.80,34035,35253,45445,920,16367,0,0,60471,8817
12,69700,1269700,Sunrise city, Florida,1,2018,95461,40.00,81.80,20.00,45150,50311,50272,31418,5099,58,268,62001,33460
18,10342,1810342,Carmel city, Indiana,1,2018,95767,36.90,75.30,13.80,47864,47903,78463,3719,9605,0,107,90775,4992
27,56896,2756896,St. Cloud city, Minnesota,0,2018,68928,51.90,81.10,11.60,35849,33079,51770,10622,2854,234,0,67581,1347
34,03580,3403580,Bayonne city, New Jersey,0,2018,65082,40.30,75.20,14.80,32197,32885,38362,7684,6849,0,0,38057,27025
48,04462,4804462,Atascocita CDP, Texas,0,2018,86243,43.90,72.50,8.00,45200,41043,63785,16308,2567,102,0,61937,24306
55,66000,5566000,Racine city, Wisconsin,1,2018,77434,42.70,73.50,11.90,38220,39214,52958,18363,897,169,71,60471,16963
35,02000,3502000,Albuquerque city, New Mexico,1,2018,560234,41.60,78.30,15.80,273480,286754,435061,18280,17866,25410,65,283457,276777
41,47000,4147000,Medford city, Oregon,1,2018,82348,36.90,77.30,18.00,39085,43263,72819,1317,1237,1508,393,67735,14613
41,64900,4164900,Salem city, Oregon,1,2018,173420,40.50,76.30,14.80,89014,84406,136284,2892,5162,3539,1719,135326,38094
27,71428,2771428,Woodbury city, Minnesota,0,2018,71299,37.70,72.30,14.00,35201,36098,57656,1985,8505,247,35,67945,3354
29,65000,2965000,St. Louis city, Missouri,1,2018,302838,45.10,81.00,13.80,146922,155916,142649,137404,10878,685,432,290329,12509
12,45025,1245025,Miami Beach city, Florida,1,2018,91715,44.00,86.50,16.80,45938,45777,72503,4908,1445,75,0,41924,49791
19,01855,1901855,Ames city, Iowa,0,2018,67155,66.60,88.20,9.80,36077,31078,53514,1176,7902,93,0,64177,2978
24,32650,2432650,Glen Burnie CDP, Maryland,0,2018,65987,46.70,81.10,12.80,32874,33113,42992,13625,4036,0,61,61274,4713
27,35180,2735180,Lakeville city, Minnesota,0,2018,65871,38.20,72.10,9.80,32451,33420,-998,-998,-998,-998,-998,61250,4621
44,59000,4459000,Providence city, Rhode Island,1,2018,179335,50.20,77.20,11.70,86616,92719,106728,31432,12738,716,0,104158,75177
53,05280,5305280,Bellingham city, Washington,1,2018,90660,56.40,86.90,14.60,44190,46470,75011,1471,6418,276,92,79708,10952
04,77000,0477000,Tucson city, Arizona,1,2018,545987,45.80,78.90,14.80,268484,277503,380776,31817,17373,24125,1229,307849,238138
06,43000,0643000,Long Beach city, California,1,2018,467353,44.60,79.40,11.30,230683,236670,228023,62817,61105,4082,3029,274135,193218
19,21000,1921000,Des Moines city, Iowa,1,2018,216993,44.30,74.90,11.70,105590,111403,162746,24112,15057,563,0,185287,31706
41,31250,4131250,Gresham city, Oregon,1,2018,110165,42.40,75.90,13.50,55251,54914,91934,3881,4597,858,843,84098,26067
06,11194,0611194,Carlsbad city, California,1,2018,115897,34.30,79.30,19.30,57672,58225,99089,2519,9825,100,0,100146,15751
06,60466,0660466,Rialto city, California,1,2018,103446,43.90,73.00,12.40,50945,52501,65257,13595,2288,166,0,26754,76692
12,38250,1238250,Lakeland city, Florida,1,2018,110494,38.60,79.90,19.50,52991,57503,78754,25220,1894,387,0,90276,20218
26,03000,2603000,Ann Arbor city, Michigan,1,2018,121885,62.40,86.40,10.80,59821,62064,86802,7418,21855,92,0,116461,5424
36,49121,3649121,Mount Vernon city, New York,1,2018,67606,39.80,78.10,14.00,29648,37958,13368,44103,662,52,0,54632,12974
45,61405,4561405,Rock Hill city, South Carolina,1,2018,74308,45.10,75.50,14.00,34005,40303,42152,27349,901,194,0,66942,7366
48,41464,4841464,Laredo city, Texas,1,2018,259512,43.50,67.40,9.50,127654,131858,250434,1532,1591,116,0,12412,247100
48,48804,4848804,Missouri City city, Texas,1,2018,72978,41.90,79.30,14.20,34706,38272,26654,29272,12518,0,0,61691,11287
06,02252,0602252,Antioch city, California,1,2018,111535,41.20,74.70,12.90,54865,56670,46695,22219,14829,978,397,69917,41618
06,16350,0616350,Corona city, California,1,2018,168826,43.00,71.60,9.60,85465,83361,100921,11986,17378,738,1101,85560,83266
12,00410,1200410,Alafaya CDP, Florida,0,2018,92740,47.10,79.10,10.30,43868,48872,70502,5681,7961,641,0,58654,34086
06,48256,0648256,Mission Viejo city, California,1,2018,95196,32.90,82.10,20.30,46160,49036,73855,1307,11648,122,66,76773,18423
06,80854,0680854,Tustin city, California,1,2018,79787,42.10,73.80,9.70,40189,39598,38115,2125,15379,90,50,39491,40296
12,39550,1239550,Lauderhill city, Florida,1,2018,72081,39.10,73.70,13.20,33968,38113,9190,58099,800,182,0,66557,5524
12,43975,1243975,Melbourne city, Florida,1,2018,82823,36.60,80.70,19.50,37991,44832,64212,9805,2875,7,477,71315,11508
34,73110,3473110,Toms River CDP, New Jersey,0,2018,91268,36.70,77.70,19.10,44688,46580,79451,1980,4156,398,0,81270,9998
32,23770,3223770,Enterprise CDP, Nevada,0,2018,187078,46.90,75.00,9.60,95251,91827,94242,23858,41515,1680,387,155334,31744
48,58016,4858016,Plano city, Texas,1,2018,287765,41.30,76.80,13.20,143215,144550,184130,21986,66814,1427,50,245086,42679
04,10670,0410670,Casas Adobes CDP, Arizona,0,2018,75694,38.30,80.00,19.80,39725,35969,61556,1499,3473,351,0,56100,19594
16,56260,1656260,Nampa city, Idaho,1,2018,96245,40.00,73.80,15.40,46828,49417,79917,396,1387,510,408,74397,21848
51,01000,5101000,Alexandria city, Virginia,1,2018,160530,49.00,81.70,12.20,77087,83443,100922,36569,9090,0,82,133643,26887
13,80508,1380508,Warner Robins city, Georgia,1,2018,75413,45.00,77.00,10.70,37548,37865,-998,-998,-998,-998,-998,70196,5217
16,08830,1608830,Boise City city, Idaho,1,2018,228807,43.70,80.60,15.40,114632,114175,201557,6267,8698,1198,421,208576,20231
17,70122,1770122,Skokie village, Illinois,0,2018,63292,33.20,76.50,19.70,31315,31977,32746,5066,18978,0,656,58555,4737
33,45140,3345140,Manchester city, New Hampshire,1,2018,112529,46.90,78.50,12.60,55221,57308,90064,8719,7304,57,42,100495,12034
06,33182,0633182,Hemet city, California,1,2018,85291,34.60,75.50,25.10,40333,44958,65498,5047,2968,966,97,46934,38357
06,59920,0659920,Redding city, California,1,2018,91777,39.40,79.10,18.20,44183,47594,77301,1569,4207,1421,162,82832,8945
12,24000,1224000,Fort Lauderdale city, Florida,1,2018,182611,36.60,84.40,18.20,94013,88598,111851,57816,3279,772,453,147100,35511
20,79000,2079000,Wichita city, Kansas,1,2018,389259,40.40,74.80,14.70,192356,196903,285945,44681,17677,4942,166,318695,70564
48,27000,4827000,Fort Worth city, Texas,1,2018,898919,43.40,72.60,9.70,442049,456870,546141,170498,43267,6617,1497,579873,319046
19,02305,1902305,Ankeny city, Iowa,0,2018,65282,42.30,76.50,12.30,30926,34356,-998,-998,-998,-998,-998,63344,1938
29,41348,2941348,Lee's Summit city, Missouri,1,2018,98919,34.40,74.50,17.30,47729,51190,85213,5844,2452,115,0,93724,5195
47,51560,4751560,Murfreesboro city, Tennessee,1,2018,141336,50.30,77.60,9.90,70278,71058,101154,28270,4762,461,0,132170,9166
08,12815,0812815,Centennial city, Colorado,1,2018,110822,38.90,75.50,14.40,56436,54386,94183,3535,6664,431,87,97674,13148
26,34000,2634000,Grand Rapids city, Michigan,1,2018,200230,48.80,76.80,12.40,96945,103285,134229,37061,4431,1063,204,163761,36469
06,11964,0611964,Castro Valley CDP, California,0,2018,63226,35.40,76.20,17.30,30109,33117,28939,4631,20682,324,101,53185,10041
26,69035,2669035,Rochester Hills city, Michigan,1,2018,74700,36.70,76.30,16.90,34961,39739,60164,2595,10148,128,0,70738,3962
27,06382,2706382,Blaine city, Minnesota,0,2018,65215,41.70,73.60,11.60,32067,33148,49289,5604,5517,294,0,60518,4697
06,51182,0651182,Newport Beach city, California,1,2018,85315,35.50,85.20,23.70,43364,41951,73190,2058,5861,178,249,78321,6994
12,56825,1256825,Pine Hills CDP, Florida,0,2018,90070,39.30,69.40,12.20,43201,46869,13669,65806,2049,1642,0,77250,12820
24,19125,2419125,Columbia CDP, Maryland,0,2018,106772,38.80,78.10,16.60,52247,54525,59665,28067,13003,527,0,96334,10438
06,65042,0665042,San Buenaventura (Ventura) city, California,1,2018,111120,39.40,78.90,17.50,53746,57374,95410,2709,5729,796,0,67048,44072
48,45000,4845000,Lubbock city, Texas,1,2018,255885,48.60,77.00,12.30,125399,130486,205415,20449,7122,2452,531,164321,91564
26,42160,2642160,Kalamazoo city, Michigan,1,2018,76557,58.10,81.90,10.50,37885,38672,50858,16647,1365,122,0,70201,6356
27,17000,2717000,Duluth city, Minnesota,1,2018,85884,45.80,83.50,18.00,42241,43643,76848,1581,1231,1728,36,83532,2352
08,46465,0846465,Loveland city, Colorado,1,2018,77444,41.00,77.70,17.90,37784,39660,72849,702,387,358,0,68521,8923
34,19390,3419390,East Orange city, New Jersey,0,2018,64469,43.30,75.80,13.10,29088,35381,1682,51252,508,282,241,54181,10288
04,07940,0407940,Buckeye city, Arizona,0,2018,74378,38.30,72.10,16.10,38957,35421,52929,3657,2395,1664,113,45373,29005
06,30000,0630000,Glendale city, California,1,2018,201374,39.30,83.00,17.70,91915,109459,157995,2640,27051,952,125,166140,35234
06,69088,0669088,Santa Clarita city, California,1,2018,210085,37.50,74.70,12.70,103814,106271,149099,4777,21404,1113,55,135685,74400
47,52006,4752006,Nashville-Davidson metropolitan government (balance), Tennessee,1,2018,665498,47.20,79.40,12.00,320837,344661,416071,184470,23845,927,852,594339,71159
53,53545,5353545,Pasco city, Washington,0,2018,71727,43.80,66.00,9.70,36591,35136,48344,2448,2415,1747,0,31128,40599
12,07300,1207300,Boca Raton city, Florida,1,2018,99241,31.40,83.10,30.00,48239,51002,86155,5541,2617,0,95,86072,13169
36,50617,3650617,New Rochelle city, New York,1,2018,78747,40.70,77.50,15.70,37597,41150,41927,14853,5514,231,0,53262,25485
06,28000,0628000,Fullerton city, California,1,2018,139629,44.30,78.80,13.10,68028,71601,80375,3219,34155,1250,482,88302,51327
06,59444,0659444,Rancho Cordova city, California,0,2018,74590,38.90,76.70,16.10,37112,37478,44210,5874,11264,1398,171,58180,16410
08,43000,0843000,Lakewood city, Colorado,1,2018,156779,42.60,83.30,17.00,75727,81052,135426,2274,6542,1814,37,120124,36655
09,73000,0973000,Stamford city, Connecticut,1,2018,129770,42.70,80.50,16.30,63579,66191,86198,13150,11995,413,0,95418,34352
22,70000,2270000,Shreveport city, Louisiana,1,2018,189149,40.20,76.10,17.00,88563,100586,72375,106532,3669,1109,140,185005,4144
41,23850,4123850,Eugene city, Oregon,1,2018,171259,48.50,82.40,15.30,81611,89648,139521,1418,8088,1551,981,154338,16921
12,70600,1270600,Tallahassee city, Florida,1,2018,193550,56.60,82.20,9.90,91252,102298,107239,68967,9819,523,97,180094,13456
17,24582,1724582,Evanston city, Illinois,1,2018,74110,41.00,78.50,15.80,34419,39691,49612,12002,7090,0,0,65103,9007
17,51622,1751622,Naperville city, Illinois,1,2018,147823,38.30,74.60,11.60,73587,74236,107198,6571,27826,196,68,137323,10500
18,23278,1823278,Fishers city, Indiana,1,2018,93790,39.60,70.80,10.10,44528,49262,78320,5469,6334,0,175,90137,3653
24,67675,2467675,Rockville city, Maryland,0,2018,68252,43.00,80.10,16.80,32712,35540,34685,6759,15905,106,0,57817,10435
49,43660,4943660,Layton city, Utah,1,2018,77306,43.70,70.10,10.00,39318,37988,67952,2026,1760,285,333,68909,8397
06,36546,0636546,Inglewood city, California,1,2018,109427,41.30,73.90,11.30,52610,56817,29676,42425,3786,1482,746,54035,55392
18,36003,1836003,Indianapolis city (balance), Indiana,1,2018,864131,43.00,75.50,12.50,415501,448630,511051,254710,32312,1966,534,776109,88022
72,76770,7276770,San Juan zona urbana, Puerto Rico,0,2018,309990,37.10,82.50,22.80,141243,168747,197005,42908,1040,1089,183,5599,304391
06,69112,0669112,Santa Cruz city, California,0,2018,64729,57.90,84.80,13.00,30113,34616,43908,2194,7276,129,119,50057,14672
12,54200,1254200,Palm Coast city, Florida,1,2018,87617,30.30,82.00,30.30,42263,45354,70632,8980,2575,0,0,77423,10194
12,71625,1271625,The Villages CDP, Florida,0,2018,-998,-999999999.00,-999999999.00,-999999999.00,-998,-998,-998,-998,-998,-998,-998,79654,922
26,74900,2674900,Southfield city, Michigan,1,2018,73141,34.80,80.90,23.00,30925,42216,17524,51422,1774,43,0,71919,1222
27,17288,2717288,Eagan city, Minnesota,0,2018,66539,42.00,75.00,12.50,31748,34791,53160,6020,4349,33,66,63076,3463
48,43888,4843888,Longview city, Texas,1,2018,81424,41.00,75.10,15.30,38799,42625,57469,20209,1419,191,363,67704,13720
72,10334,7210334,Caguas zona urbana, Puerto Rico,0,2018,72704,39.80,83.00,20.80,32947,39757,-998,-998,-998,-998,-998,1062,71642
06,64224,0664224,Salinas city, California,1,2018,156275,45.20,68.70,9.20,78708,77567,48158,1250,9127,1926,44,29179,127096
06,84200,0684200,West Covina city, California,1,2018,106314,38.30,78.50,16.60,48990,57324,39547,4262,35233,952,1297,55128,51186
35,63460,3563460,Rio Rancho city, New Mexico,1,2018,98016,37.20,75.00,16.90,47039,50977,83864,3260,1719,922,1007,55793,42223
35,70500,3570500,Santa Fe city, New Mexico,1,2018,84605,37.20,81.90,23.90,40125,44480,75308,932,885,1053,102,36763,47842
46,59020,4659020,Sioux Falls city, South Dakota,1,2018,181906,42.40,74.70,11.80,90739,91167,150917,13514,5886,4027,0,172276,9630
48,46452,4846452,Mansfield city, Texas,0,2018,74786,42.50,70.40,8.70,37380,37406,52084,12077,2726,562,0,55293,19493
51,16000,5116000,Chesapeake city, Virginia,1,2018,242634,40.70,76.00,13.20,118384,124250,146670,72849,9053,212,128,226788,15846
51,68000,5168000,Roanoke city, Virginia,1,2018,99920,40.00,77.80,16.90,47479,52441,61938,29378,3048,162,0,93382,6538
09,18430,0918430,Danbury city, Connecticut,1,2018,84731,42.10,77.00,11.90,41747,42984,47412,10766,3554,569,0,55319,29412
37,02140,3702140,Asheville city, North Carolina,1,2018,92460,42.30,83.10,19.60,41478,50982,76036,11816,1234,165,365,84781,7679
48,65000,4865000,San Antonio city, Texas,1,2018,1532212,44.60,75.20,12.40,760783,771429,1251454,101551,51302,11822,722,551467,980745
04,73000,0473000,Tempe city, Arizona,1,2018,192354,58.60,85.20,10.50,101778,90576,132142,12650,17061,6282,1034,151118,41236
05,41000,0541000,Little Rock city, Arkansas,1,2018,197868,42.30,77.80,14.10,93999,103869,97114,84329,6262,1333,145,181581,16287
17,68003,1768003,Schaumburg village, Illinois,1,2018,73970,42.20,74.20,13.50,35441,38529,44204,4283,18053,1841,0,65881,8089
30,50200,3050200,Missoula city, Montana,1,2018,74427,53.10,82.00,12.80,37815,36612,67317,542,980,756,515,71301,3126
06,42202,0642202,Lodi city, California,0,2018,66995,38.40,72.80,15.10,32833,34162,38623,871,9103,172,882,40580,26415
06,49670,0649670,Mountain View city, California,1,2018,83377,48.80,79.40,10.90,43677,39700,43750,1534,27683,383,0,67967,15410
06,84550,0684550,Westminster city, California,1,2018,90931,35.30,78.20,19.40,43400,47531,26624,582,51958,194,139,70827,20104
44,54640,4454640,Pawtucket city, Rhode Island,1,2018,71842,37.80,80.90,14.00,35759,36083,42956,15041,788,87,37,53598,18244
53,35275,5335275,Kennewick city, Washington,1,2018,82950,40.80,73.80,13.70,42393,40557,67077,2102,3492,260,0,62280,20670
04,27400,0427400,Gilbert town, Arizona,1,2018,248269,40.10,69.50,10.30,120840,127429,202179,13494,15120,1156,565,207129,41140
06,80000,0680000,Torrance city, California,1,2018,145181,35.30,79.20,17.90,69026,76155,67929,3488,51799,956,348,116287,28894
13,04000,1304000,Atlanta city, Georgia,1,2018,498073,51.70,81.50,11.10,245352,252721,203515,253770,20019,818,142,475094,22979
37,10740,3710740,Cary town, North Carolina,1,2018,169537,38.20,76.00,13.20,82221,87316,110277,18571,32063,308,283,158220,11317
47,48000,4748000,Memphis city, Tennessee,1,2018,650632,41.50,75.10,13.10,304415,346217,183694,428009,9788,951,74,605793,44839
53,35940,5335940,Kirkland city, Washington,0,2018,89557,46.80,77.70,10.50,44332,45225,68636,579,12458,488,0,82570,6987
19,82425,1982425,Waterloo city, Iowa,1,2018,67797,41.50,78.60,17.70,33990,33807,51040,12473,1088,572,79,62840,4957
06,15044,0615044,Compton city, California,1,2018,96616,43.30,67.70,9.40,45567,51049,24168,28974,611,203,108,31257,65359
39,01000,3901000,Akron city, Ohio,1,2018,198025,41.50,79.10,15.00,96018,102007,120141,56646,9909,318,0,192718,5307
48,41980,4841980,League City city, Texas,1,2018,106188,38.10,71.60,11.20,52201,53987,82426,11532,6445,145,0,85756,20432
06,65000,0665000,San Bernardino city, California,1,2018,215929,44.40,70.00,9.00,106951,108978,143789,25408,9055,1493,2057,72170,143759
17,79293,1779293,Waukegan city, Illinois,1,2018,82934,43.70,72.10,9.20,41017,41917,32526,14242,4832,1211,0,36056,46878
32,68585,3268585,Spring Valley CDP, Nevada,0,2018,214161,43.30,79.50,13.90,108590,105571,103519,30283,36890,491,914,161456,52705
48,19000,4819000,Dallas city, Texas,1,2018,1345076,46.10,75.30,10.70,669867,675209,836340,338036,45979,4163,412,797335,547741
49,62470,4962470,Provo city, Utah,1,2018,116713,66.00,78.40,6.10,56949,59764,99646,1813,2667,1272,2721,97482,19231
48,26232,4826232,Flower Mound town, Texas,0,2018,77038,33.90,72.80,10.10,39409,37629,61230,2670,8326,514,0,66960,10078
05,60410,0560410,Rogers city, Arkansas,0,2018,67615,42.60,73.50,9.70,33165,34450,61114,1272,1173,307,1005,43086,24529
12,76582,1276582,Weston city, Florida,0,2018,71224,34.30,65.90,9.80,35375,35849,55727,2139,3479,0,0,31700,39524
48,06128,4806128,Baytown city, Texas,1,2018,77962,42.30,73.10,12.70,39055,38907,53662,18877,991,24,95,41919,36043
48,22660,4822660,Edinburg city, Texas,1,2018,98671,49.10,70.80,9.00,51419,47252,89296,2592,2151,283,0,12399,86272
08,16000,0816000,Colorado Springs city, Colorado,1,2018,472666,43.70,76.30,13.30,235360,237306,363389,32160,16843,3788,1208,385582,87084
35,39380,3539380,Las Cruces city, New Mexico,1,2018,102929,45.10,79.50,17.20,50717,52212,89314,3198,1238,1667,0,40110,62819
42,24000,4224000,Erie city, Pennsylvania,1,2018,96459,43.00,78.40,16.10,49669,46790,70941,16524,1928,696,63,89508,6951
34,74000,3474000,Trenton city, New Jersey,1,2018,83973,44.20,75.70,11.40,39469,44504,30852,39931,1381,612,0,50378,33595
53,67167,5367167,Spokane Valley city, Washington,1,2018,99703,42.40,75.30,15.10,48907,50796,87570,2112,1431,1840,157,93583,6120
36,51000,3651000,New York city, New York,1,2018,8398748,43.20,79.30,14.80,4003933,4394815,3548402,2039194,1192303,38946,5250,5949297,2449451
12,49675,1249675,North Port city, Florida,0,2018,68637,31.50,83.90,30.30,32282,36355,-998,-998,-998,-998,-998,64890,3747
24,72450,2472450,Silver Spring CDP, Maryland,0,2018,81816,47.10,78.00,13.20,39839,41977,33608,25670,8515,0,0,66489,15327
55,60500,5560500,Oshkosh city, Wisconsin,0,2018,66737,47.90,82.50,13.60,34639,32098,60144,2653,2174,311,0,63556,3181
06,46898,0646898,Merced city, California,1,2018,83311,45.70,72.50,11.90,40153,43158,53730,4327,10565,561,0,37565,45746
12,53000,1253000,Orlando city, Florida,1,2018,285705,49.80,80.10,10.90,132334,153371,167127,74899,10297,377,145,195017,90688
20,71000,2071000,Topeka city, Kansas,1,2018,125908,39.00,77.60,19.20,61231,64677,99263,13465,2518,2051,73,106558,19350
36,65508,3665508,Schenectady city, New York,1,2018,65570,43.80,79.40,14.20,33471,32099,36975,12993,4822,1373,220,58791,6779
49,82950,4982950,West Jordan city, Utah,1,2018,116047,46.30,67.70,7.80,57756,58291,90596,2930,5094,1652,2069,98314,17733
06,68084,0668084,San Leandro city, California,1,2018,89683,39.40,81.50,15.00,44555,45128,35388,9507,30188,282,750,63660,26023
48,10912,4810912,Bryan city, Texas,1,2018,85447,48.10,74.00,9.90,43606,41841,64169,16602,2589,65,0,52121,33326
55,02375,5502375,Appleton city, Wisconsin,1,2018,74345,40.00,75.70,15.00,36008,38337,63806,3222,3947,190,0,71078,3267
01,37000,0137000,Huntsville city, Alabama,1,2018,199808,42.10,78.50,16.70,95202,104606,114924,62225,6221,1300,0,186411,13397
06,36000,0636000,Huntington Beach city, California,1,2018,200658,37.50,80.10,16.50,100382,100276,137202,2645,27359,719,1199,160510,40148
06,58072,0658072,Pomona city, California,1,2018,152348,45.70,73.90,11.10,72447,79901,65570,7598,16306,3112,104,43770,108578
12,08150,1208150,Brandon CDP, Florida,0,2018,119778,43.60,79.10,13.20,58602,61176,82700,19764,8322,398,0,91945,27833
12,45060,1245060,Miami Gardens city, Florida,1,2018,113085,40.90,75.10,14.60,50021,63064,24466,84497,705,0,0,85515,27570
29,54074,2954074,O'Fallon city, Missouri,1,2018,88464,39.50,72.20,10.80,44258,44206,76867,3956,4445,171,0,85388,3076
39,12000,3912000,Canton city, Ohio,1,2018,70469,37.80,73.30,15.40,35741,34728,45439,18211,727,0,0,65915,4554
41,05350,4105350,Beaverton city, Oregon,1,2018,98951,46.50,76.50,10.90,50742,48209,71204,2447,14083,96,518,74758,24193
45,48535,4548535,Mount Pleasant town, South Carolina,1,2018,89340,38.10,78.00,17.60,46120,43220,-998,-998,-998,-998,-998,86122,3218
06,57456,0657456,Pittsburg city, California,0,2018,72443,44.90,74.00,9.70,34819,37624,26872,12634,12049,1203,69,40799,31644
06,81666,0681666,Vallejo city, California,1,2018,121915,39.50,79.70,16.20,59464,62451,40188,24309,31487,540,734,86577,35338
32,60600,3260600,Reno city, Nevada,1,2018,250989,42.80,79.70,15.80,125566,125423,186614,8327,14851,2901,1962,191164,59825
34,21000,3421000,Elizabeth city, New Jersey,1,2018,128882,44.50,72.30,9.90,64901,63981,49482,19331,4069,2502,0,38392,90490
37,22920,3722920,Fayetteville city, North Carolina,1,2018,209465,48.80,76.90,12.20,104484,104981,91410,89964,7061,2502,883,183991,25474
48,61796,4861796,Richardson city, Texas,1,2018,120954,44.80,77.90,13.70,60765,60189,80130,12017,19932,1234,104,98333,22621
01,21184,0121184,Dothan city, Alabama,0,2018,67814,37.10,77.30,19.60,32283,35531,43412,22262,603,53,0,65083,2731
01,77256,0177256,Tuscaloosa city, Alabama,1,2018,101111,52.80,81.80,12.30,47889,53222,54470,42341,2710,300,0,96502,4609
18,40788,1840788,Lafayette city, Indiana,1,2018,72393,45.10,77.90,13.80,36818,35575,60658,6223,1326,263,0,62625,9768
26,21000,2621000,Dearborn city, Michigan,1,2018,94325,42.10,72.60,12.50,48569,45756,85224,2078,2646,530,0,91426,2899
06,59451,0659451,Rancho Cucamonga city, California,1,2018,177742,41.00,76.00,12.60,88615,89127,100511,19284,19569,518,70,105863,71879
06,80238,0680238,Tracy city, California,1,2018,91803,45.00,73.00,9.00,45691,46112,52652,4108,16552,547,344,54973,36830
18,25000,1825000,Fort Wayne city, Indiana,1,2018,264170,41.90,74.60,13.80,127645,136525,185587,41659,13661,574,432,239547,24623
32,40000,3240000,Las Vegas city, Nevada,1,2018,644664,39.50,76.20,15.20,321489,323175,379389,73470,47686,9803,4127,421804,222860
32,71400,3271400,Sunrise Manor CDP, Nevada,0,2018,188515,41.40,71.80,11.60,91456,97059,98399,25697,9229,2930,1111,89999,98516
48,03000,4803000,Amarillo city, Texas,1,2018,200880,40.60,72.50,13.10,97982,102898,166268,14161,9048,1455,443,135248,65632
55,31000,5531000,Green Bay city, Wisconsin,1,2018,104880,40.10,75.40,13.30,53576,51304,82731,4609,4859,3719,213,87635,17245
17,07133,1707133,Bolingbrook village, Illinois,1,2018,74224,42.70,74.50,11.30,36951,37273,38136,10582,6879,404,165,52552,21672
38,25700,3825700,Fargo city, North Dakota,1,2018,125040,51.10,81.00,12.00,63735,61305,104856,9867,5410,1840,0,121032,4008
06,49270,0649270,Moreno Valley city, California,1,2018,209051,46.30,71.40,8.20,98921,110130,73698,36977,13973,303,37,81928,127123
37,25580,3725580,Gastonia city, North Carolina,1,2018,77021,39.30,78.60,15.10,37185,39836,47628,23211,1114,261,95,70682,6339
39,44856,3944856,Lorain city, Ohio,0,2018,64031,38.90,75.60,16.30,30275,33756,47150,10575,0,223,75,45440,18591
06,02553,0602553,Arden-Arcade CDP, California,0,2018,107894,42.70,77.20,14.00,51383,56511,69433,9594,7135,881,404,83755,24139
06,19766,0619766,Downey city, California,1,2018,112262,44.30,78.00,14.00,55320,56942,59139,4694,7592,1764,168,33025,79237
53,22640,5322640,Everett city, Washington,1,2018,111263,44.80,79.60,12.50,57830,53433,79337,6554,12037,562,1464,94180,17083
48,63572,4863572,Rowlett city, Texas,0,2018,66686,40.20,76.00,9.10,31321,35365,45034,12643,4678,573,0,50937,15749
06,20802,0620802,East Los Angeles CDP, California,0,2018,117961,45.70,75.50,11.30,58810,59151,57395,1254,1756,299,95,6046,111915
06,21712,0621712,El Cajon city, California,1,2018,103229,45.40,74.70,12.10,51339,51890,78246,5939,4967,502,437,79372,23857
09,52000,0952000,New Haven city, Connecticut,1,2018,130407,49.90,76.10,9.20,60711,69696,57087,45759,6572,812,0,94983,35424
12,39925,1239925,Lehigh Acres CDP, Florida,0,2018,135272,40.80,72.50,11.90,65752,69520,97207,27830,942,177,71,70367,64905
12,54350,1254350,Palm Harbor CDP, Florida,0,2018,65994,29.20,80.80,26.70,27769,38225,-998,-998,-998,-998,-998,62616,3378
17,57225,1757225,Palatine village, Illinois,1,2018,68017,37.60,74.50,13.80,32293,35724,45144,1976,8513,468,0,52951,15066
26,29000,2629000,Flint city, Michigan,1,2018,95932,41.20,76.00,13.70,45062,50870,37069,51902,157,378,66,92648,3284
42,06088,4206088,Bethlehem city, Pennsylvania,1,2018,75979,44.00,82.30,17.40,36509,39470,59225,4453,2905,0,0,51896,24083
72,14290,7214290,Carolina zona urbana, Puerto Rico,0,2018,133734,37.90,82.40,22.30,60475,73259,74813,19435,505,0,0,1013,132721
06,16000,0616000,Concord city, California,1,2018,129681,41.50,83.00,15.60,62538,67143,80258,4753,14189,1383,156,89941,39740
06,50258,0650258,Napa city, California,1,2018,79261,38.50,77.10,18.40,39869,39392,65866,588,2069,813,0,48425,30836
08,32155,0832155,Greeley city, Colorado,1,2018,107345,45.60,74.20,10.80,51928,55417,94570,3529,1121,652,1030,70982,36363
12,35000,1235000,Jacksonville city, Florida,1,2018,903896,41.70,77.00,13.70,436155,467741,524891,277151,43394,3195,409,809738,94158
36,63000,3663000,Rochester city, New York,1,2018,206290,47.50,77.80,11.40,99175,107115,97371,79508,6416,2080,0,163929,42361
53,74060,5374060,Vancouver city, Washington,1,2018,183017,41.20,78.60,16.50,89428,93589,148545,3844,9832,847,2141,155506,27511
40,23200,4023200,Edmond city, Oklahoma,1,2018,93118,39.00,73.20,15.50,44138,48980,74600,5153,1785,1321,112,87598,5520
48,16432,4816432,Conroe city, Texas,0,2018,87656,46.40,76.10,12.80,45219,42437,68188,7410,4572,1133,0,58422,29234
46,52980,4652980,Rapid City city, South Dakota,1,2018,75448,40.10,76.30,17.80,38313,37135,58778,1133,1134,9638,39,70831,4617
12,12875,1212875,Clearwater city, Florida,1,2018,116484,34.50,81.10,22.70,57933,58551,88067,16964,2815,151,106,98241,18243
13,67284,1367284,Roswell city, Georgia,1,2018,94648,37.90,77.10,13.60,45594,49054,74797,13040,3190,426,0,80716,13932
19,83910,1983910,West Des Moines city, Iowa,0,2018,67127,41.90,76.90,14.70,34276,32851,56848,4691,3636,127,262,62096,5031
42,63624,4263624,Reading city, Pennsylvania,1,2018,88508,44.70,69.40,10.40,42013,46495,48397,11654,1259,149,0,28703,59805
44,74300,4474300,Warwick city, Rhode Island,1,2018,80842,38.30,82.60,20.00,38465,42377,74267,1864,2305,537,0,74973,5869
45,16000,4516000,Columbia city, South Carolina,1,2018,133610,57.40,83.50,9.80,66107,67503,68936,55176,2961,358,294,127055,6555
48,75428,4875428,Victoria city, Texas,0,2018,67020,40.40,75.20,16.60,31904,35116,55922,5379,1285,167,0,30448,36572
49,57300,4957300,Orem city, Utah,1,2018,97512,50.30,71.10,9.50,48219,49293,87548,434,2148,127,817,80130,17382
06,22020,0622020,Elk Grove city, California,1,2018,172891,39.90,75.90,13.70,83600,89291,81436,20348,48180,1968,3844,141532,31359
40,41850,4041850,Lawton city, Oklahoma,1,2018,92860,46.30,77.30,12.50,48673,44187,53723,16675,2123,3129,913,79153,13707
06,56000,0656000,Pasadena city, California,1,2018,141374,42.20,80.40,16.80,66775,74599,63624,12787,27190,372,150,90282,51092
26,84000,2684000,Warren city, Michigan,1,2018,134583,40.10,81.70,16.90,64622,69961,95906,23501,10897,151,59,130814,3769
41,05800,4105800,Bend city, Oregon,1,2018,97590,40.00,75.30,16.80,47229,50361,87959,695,2245,524,0,88815,8775
47,14000,4714000,Chattanooga city, Tennessee,1,2018,180551,42.40,81.40,16.90,84488,96063,112989,56502,3738,297,0,168416,12135
40,55000,4055000,Oklahoma City city, Oklahoma,1,2018,649410,42.50,74.20,12.80,318760,330650,437976,90992,33390,20575,599,521555,127855
06,33434,0633434,Hesperia city, California,1,2018,95267,40.30,71.60,12.50,47162,48105,76781,3688,2440,1164,104,36004,59263
06,81344,0681344,Upland city, California,1,2018,77002,42.50,76.80,15.00,37240,39762,47323,4186,10525,1404,95,47070,29932
53,63000,5363000,Seattle city, Washington,1,2018,744949,52.10,85.00,13.10,380030,364919,498504,50578,115719,4023,1388,690934,54015
11,50000,1150000,Washington city, District of Columbia,1,2018,702455,51.20,81.90,12.20,334208,368247,296747,319777,27538,1932,397,623206,79249
51,03000,5103000,Arlington CDP, Virginia,0,2018,237521,51.80,81.90,10.50,119798,117723,165900,21345,23125,1341,717,200015,37506
01,51000,0151000,Montgomery city, Alabama,1,2018,198218,41.70,76.10,14.10,93079,105139,60070,123862,6702,245,0,190828,7390
18,51876,1851876,Muncie city, Indiana,1,2018,70178,52.50,79.90,14.50,32873,37305,59161,7727,1330,78,0,67797,2381
36,01000,3601000,Albany city, New York,1,2018,97273,49.80,82.50,13.70,46974,50299,52823,31454,5923,0,0,88931,8342
48,32372,4832372,Harlingen city, Texas,0,2018,65434,41.90,72.10,16.40,32581,32853,-998,-998,-998,-998,-998,11181,54253
05,66080,0566080,Springdale city, Arkansas,1,2018,81641,41.90,70.00,10.30,39365,42276,51853,2545,1817,1527,5288,51498,30143
06,68000,0668000,San Jose city, California,1,2018,1030119,43.20,77.90,13.00,515713,514406,411976,30835,369178,5762,5545,696300,333819
51,82000,5182000,Virginia Beach city, Virginia,1,2018,450189,42.60,77.90,14.20,221277,228912,296395,86768,32129,1861,143,412824,37365
06,80812,0680812,Turlock city, California,1,2018,73490,44.50,71.90,13.10,35752,37738,53698,4318,3607,74,521,45384,28106
08,03455,0803455,Arvada city, Colorado,1,2018,120127,39.10,81.20,18.80,59816,60311,110226,1393,2447,569,0,105614,14513
12,57900,1257900,Poinciana CDP, Florida,0,2018,71331,36.60,68.80,15.90,36271,35060,48010,14208,418,0,0,25902,45429
25,45560,2545560,Newton city, Massachusetts,1,2018,88911,37.00,78.30,20.10,41714,47197,68232,3741,12890,83,0,86530,2381
06,26000,0626000,Fremont city, California,1,2018,237815,40.70,77.50,12.80,121872,115943,56593,8492,139437,1236,2302,208468,29347
06,40130,0640130,Lancaster city, California,1,2018,159038,41.10,69.10,10.00,82449,76589,94937,32316,6343,1615,162,89615,69423
09,37000,0937000,Hartford city, Connecticut,1,2018,122591,45.80,75.10,11.50,59277,63314,35129,46635,2868,974,404,66890,55701
32,54600,3254600,Paradise CDP, Nevada,0,2018,242266,44.80,81.80,13.80,124081,118185,116955,30514,25388,2727,1708,156529,85737
29,64082,2964082,St. Charles city, Missouri,0,2018,70770,41.80,83.00,16.70,35137,35633,60952,5211,2065,202,0,67915,2855
08,09280,0809280,Broomfield city, Colorado,0,2018,69267,41.90,77.10,13.90,34710,34557,60869,1103,4951,196,0,60537,8730
