Fips_State,Fips_Place,Fips_State_Place,City_Name,St_Name,NYU_500_Largest,Year,Pop_Total,Per_15to44_years(%),Per_18_years_and_over(%),Per_65_years_and_over(%),Pop_Male,Pop_Female,Pop_White,Pop_Black,Pop_Asian,Pop_AIAN,Pop_NHOPI,Pop_Nonhispanic,Pop_Hispanic
1,7000,107000,Birmingham city, Alabama,1,2010,211670,42.8,78.7,13.1,98760,112910,47657,158193,1528,593,0,204155,7515
1,21184,121184,Dothan city, Alabama,0,2010,66121,38.7,74.8,14.3,31087,35034,41867,21123,916,186,0,64104,2017
1,35896,135896,Hoover city, Alabama,1,2010,80376,39.7,71.3,12.4,38694,41682,57507,11555,5345,235,0,72254,8122
1,37000,137000,Huntsville city, Alabama,1,2010,181126,42.5,78.4,13.5,88132,92994,114796,53460,5734,434,161,170562,10564
1,50000,150000,Mobile city, Alabama,1,2010,195249,40.5,76.7,13.9,91746,103503,89418,98746,2621,474,53,190257,4992
1,51000,151000,Montgomery city, Alabama,1,2010,206655,43.5,75.3,11.8,97605,109050,78817,115853,4368,571,90,198566,8089
1,77256,177256,Tuscaloosa city, Alabama,1,2010,90637,50.7,79.9,11,43997,46640,48895,38870,861,0,0,86642,3995
2,3000,203000,Anchorage municipality, Alaska,1,2010,293227,44.6,74.1,7,148566,144661,195553,17874,23986,21787,6388,270925,22302
4,4720,404720,Avondale city, Arizona,1,2010,76446,45.6,66.5,4.6,39206,37240,59236,6888,1557,1039,189,32456,43990
4,12000,412000,Chandler city, Arizona,1,2010,236775,44,72.3,7.2,116459,120316,181872,12980,24702,1834,384,180028,56747
4,23620,423620,Flagstaff city, Arizona,0,2010,65976,58.1,80,7.6,31783,34193,47043,1248,1731,8413,51,54703,11273
4,27400,427400,Gilbert town, Arizona,1,2010,209007,43.9,70,5.8,103460,105547,173989,11926,10597,2577,205,180642,28365
4,27820,427820,Glendale city, Arizona,1,2010,227358,44.4,71.8,8.6,112794,114564,160175,15327,8313,4836,697,141901,85457
4,28380,428380,Goodyear city, Arizona,0,2010,65445,46.3,72.5,9.9,31194,34251,57568,2244,904,2116,0,43326,22119
4,46000,446000,Mesa city, Arizona,1,2010,440248,40.4,74.5,14.7,214522,225726,369684,13168,10333,11202,1308,324773,115475
4,54050,454050,Peoria city, Arizona,1,2010,154475,40.3,74.6,14.1,73403,81072,133143,5866,6887,1422,56,122187,32288
4,55000,455000,Phoenix city, Arizona,1,2010,1449481,45,72.2,8.7,731869,717612,1128609,100335,42050,24637,2515,877736,571745
4,64210,464210,San Tan Valley CDP, Arizona,0,2010,74977,44.4,60.7,6.1,36003,38974,49889,3298,2977,2077,1237,52826,22151
4,65000,465000,Scottsdale city, Arizona,1,2010,217977,33.5,82.6,19.8,104832,113145,200918,4118,5771,1397,169,202249,15728
4,71510,471510,Surprise city, Arizona,1,2010,117826,37,70.2,18.1,57572,60254,106563,3721,786,795,0,97971,19855
4,73000,473000,Tempe city, Arizona,1,2010,162123,56.8,80.7,9.9,83327,78796,127359,8114,9884,4731,1987,127900,34223
4,77000,477000,Tucson city, Arizona,1,2010,521132,45.6,77.3,12,258275,262857,406502,24883,12609,16563,1026,309756,211376
4,85540,485540,Yuma city, Arizona,1,2010,93409,45.1,70.2,10.5,46307,47102,60535,2827,1616,845,107,40308,53101
5,23290,523290,Fayetteville city, Arkansas,1,2010,73946,57.6,81.3,9.9,35991,37955,63496,4865,1361,1111,0,69737,4209
5,24550,524550,Fort Smith city, Arkansas,1,2010,86338,41.9,74.9,12,42421,43917,68833,8336,4413,452,0,72034,14304
5,35710,535710,Jonesboro city, Arkansas,1,2010,67486,48.7,74.3,10.3,33384,34102,-998,-998,-998,-998,-998,63847,3639
5,41000,541000,Little Rock city, Arkansas,1,2010,193973,41.6,73.5,11.3,91274,102699,102579,83780,5377,745,50,183124,10849
5,66080,566080,Springdale city, Arkansas,1,2010,70751,44.6,66.1,7.7,33760,36991,47566,2264,938,277,3734,47872,22879
6,562,600562,Alameda city, California,1,2010,73981,40.7,75.9,11.6,34930,39051,34074,6738,24442,267,999,64946,9035
6,884,600884,Alhambra city, California,1,2010,83202,45.6,83.5,16.1,38154,45048,21262,972,43049,45,0,53545,29657
6,2000,602000,Anaheim city, California,1,2010,337259,46,73.6,9.4,171859,165400,195457,9062,46131,1122,886,155244,182015
6,2252,602252,Antioch city, California,1,2010,102745,41.7,73,9.8,49453,53292,52584,13027,12011,856,1962,61143,41602
6,2364,602364,Apple Valley town, California,1,2010,69387,36,72,14.9,32930,36457,57326,5677,1642,72,0,48517,20870
6,2553,602553,Arden-Arcade CDP, California,0,2010,87272,42.9,79.9,15.2,40372,46900,62644,7495,5002,1018,432,67522,19750
6,3526,603526,Bakersfield city, California,1,2010,348582,43.4,68.3,8.7,173473,175109,227269,28173,19603,3005,162,186631,161951
6,3666,603666,Baldwin Park city, California,1,2010,75496,43.6,68.4,8.6,35872,39624,26445,1106,11720,800,0,14476,61020
6,4982,604982,Bellflower city, California,1,2010,76717,44.2,73.8,10.4,35921,40796,28663,11667,8193,685,0,38669,38048
6,6000,606000,Berkeley city, California,1,2010,112824,55,86.9,12.1,53328,59496,69208,12520,23378,123,162,100839,11985
6,8786,608786,Buena Park city, California,1,2010,80766,42.5,74.4,10.3,37841,42925,45296,3090,24593,179,1844,50095,30671
6,8954,608954,Burbank city, California,1,2010,103472,42.3,81,14.5,48500,54972,79813,1402,14119,45,0,81873,21599
6,10046,610046,Camarillo city, California,0,2010,65406,31.5,77.1,21.6,29023,36383,47381,1112,8803,486,53,49677,15729
6,11194,611194,Carlsbad city, California,1,2010,105707,39.7,77.7,11.5,53138,52569,91926,1273,6505,71,81,94188,11519
6,11530,611530,Carson city, California,1,2010,91828,41.3,76.8,12.3,45492,46336,27324,18854,26705,685,2783,58656,33172
6,13014,613014,Chico city, California,1,2010,86213,51.5,82.6,10.5,41857,44356,70317,2218,4576,1251,113,72373,13840
6,13210,613210,Chino city, California,1,2010,78237,49,73.3,6.8,40030,38207,46160,4675,8643,554,244,33284,44953
6,13214,613214,Chino Hills city, California,1,2010,75070,41.1,74.4,7.2,35798,39272,38186,2559,21633,186,112,47363,27707
6,13392,613392,Chula Vista city, California,1,2010,244789,43.1,72,10.1,115293,129496,160287,13237,39342,1317,180,109018,135771
6,13588,613588,Citrus Heights city, California,1,2010,83490,42.3,78.1,13.3,40704,42786,69968,1557,1318,739,45,68089,15401
6,14218,614218,Clovis city, California,1,2010,95915,42.5,72.1,12.2,48070,47845,67689,4200,7737,2349,53,70572,25343
6,15044,615044,Compton city, California,1,2010,96558,46.1,68.1,6.6,46880,49678,45389,33840,144,352,0,35549,61009
6,16000,616000,Concord city, California,1,2010,122508,42.1,77.4,11.8,58950,63558,87092,5132,13221,773,1024,90511,31997
6,16350,616350,Corona city, California,1,2010,153335,44.3,70.7,7.6,77726,75609,109403,6207,14952,1160,2736,89151,64184
6,16532,616532,Costa Mesa city, California,1,2010,110253,50.8,78.6,8.5,56717,53536,71905,1223,8931,620,252,66662,43591
6,17918,617918,Daly City city, California,1,2010,101361,43.5,78.3,11.7,49447,51914,27862,2862,57504,237,137,76768,24593
6,18100,618100,Davis city, California,0,2010,65740,54.3,78.6,8.8,32556,33184,43957,1396,13409,57,392,57790,7950
6,19766,619766,Downey city, California,1,2010,111922,44.7,73.7,10.1,56251,55671,48458,3782,7344,522,95,29383,82539
6,20802,620802,East Los Angeles CDP, California,0,2010,127198,49.3,70.3,7.7,66095,61103,65495,592,828,861,121,3190,124008
6,21712,621712,El Cajon city, California,1,2010,99841,44.8,72.1,9.8,49497,50344,73778,6502,4333,1030,184,70350,29491
6,22020,622020,Elk Grove city, California,1,2010,153401,40.4,70.4,8.9,75206,78195,68196,15492,39696,766,4995,124091,29310
6,22230,622230,El Monte city, California,1,2010,113614,45,74.7,11.4,55826,57788,42040,516,30841,1091,309,40612,73002
6,22804,622804,Escondido city, California,1,2010,144402,43.6,74.7,15.2,69294,75108,124845,2746,4041,713,127,78060,66342
6,23182,623182,Fairfield city, California,1,2010,105580,42.1,72.1,9.8,50417,55163,48600,16947,16620,686,926,77836,27744
6,24638,624638,Folsom city, California,1,2010,72348,44,76.7,8.9,40490,31858,49590,6119,10103,819,1189,64218,8130
6,24680,624680,Fontana city, California,1,2010,196778,46.6,69.2,6.4,97566,99212,118496,24506,11995,1058,960,74594,122184
6,26000,626000,Fremont city, California,1,2010,214613,42.1,75.9,10,106745,107868,73507,10342,100448,513,1060,181072,33541
6,27000,627000,Fresno city, California,1,2010,496147,45.1,69.3,9,242478,253669,266945,37239,65354,3676,1113,264057,232090
6,28000,628000,Fullerton city, California,1,2010,135541,45,75.9,11.9,65943,69598,71470,3335,31413,1002,93,85487,50054
6,29000,629000,Garden Grove city, California,1,2010,171386,46.2,75.7,11.4,86320,85066,76555,1659,68161,1044,2816,113134,58252
6,30000,630000,Glendale city, California,1,2010,191954,40.3,78.6,13.7,93963,97991,147731,1589,29723,342,770,159506,32448
6,32548,632548,Hawthorne city, California,1,2010,84382,46.4,71.3,8.5,41338,43044,45462,23286,4362,182,495,39370,45012
6,33000,633000,Hayward city, California,1,2010,144549,44.9,74.3,9.2,71220,73329,52958,16618,31695,2019,2752,84898,59651
6,33182,633182,Hemet city, California,1,2010,79157,35.4,71,20.6,38486,40671,59681,4875,2724,794,0,48268,30889
6,33434,633434,Hesperia city, California,1,2010,90486,42,70.2,10,44418,46068,69120,6690,2876,1848,83,51745,38741
6,36000,636000,Huntington Beach city, California,1,2010,190541,39.2,80.5,15.1,92967,97574,144668,1637,21949,1494,0,156045,34496
6,36448,636448,Indio city, California,1,2010,76512,38.8,68.8,14.4,35697,40815,49162,1446,1546,403,0,23866,52646
6,36546,636546,Inglewood city, California,1,2010,109799,45.6,74.1,9.4,50085,59714,26774,43423,1045,372,957,52398,57401
6,36770,636770,Irvine city, California,1,2010,212982,52.1,79.5,8.5,105706,107276,111516,3603,82165,1161,905,192011,20971
6,39496,639496,Lake Forest city, California,1,2010,77482,39.7,71.6,10.1,38373,39109,61680,1409,8862,476,81,59631,17851
6,39892,639892,Lakewood city, California,1,2010,80154,39.2,75.4,11.9,39559,40595,38530,5776,12403,396,101,50546,29608
6,40130,640130,Lancaster city, California,1,2010,156786,42.7,69.1,8.9,77100,79686,98660,35510,7645,1218,217,101194,55592
6,41992,641992,Livermore city, California,1,2010,81178,40.1,76,9.8,40563,40615,67952,2003,6895,65,0,63926,17252
6,43000,643000,Long Beach city, California,1,2010,462793,47.8,75.8,8.8,232262,230531,262737,55094,57230,2243,4515,266596,196197
6,44000,644000,Los Angeles city, California,1,2010,3797144,47.3,76.7,10.4,1879472,1917672,1980767,362142,430314,15393,6700,1943870,1853274
6,44574,644574,Lynwood city, California,1,2010,69863,52.7,70.8,5.3,33415,36448,-998,-998,-998,-998,-998,10161,59702
6,45484,645484,Manteca city, California,1,2010,67338,39.8,69,9.1,33320,34018,48355,3899,7207,633,161,43396,23942
6,46842,646842,Menifee city, California,1,2010,78018,34.5,73.8,21.8,38486,39532,60885,5397,1768,452,44,53979,24039
6,46898,646898,Merced city, California,1,2010,79254,45.3,68,9.9,39374,39880,53841,4387,8966,1162,0,43118,36136
6,47766,647766,Milpitas city, California,1,2010,67011,47.2,78.8,8.1,34025,32986,13664,1581,40716,222,527,55549,11462
6,48256,648256,Mission Viejo city, California,1,2010,93585,34.7,78.2,15.2,44775,48810,76867,1320,8235,90,300,82447,11138
6,48354,648354,Modesto city, California,1,2010,201520,41.3,71.2,11.6,97625,103895,149850,8471,10688,2873,1007,129341,72179
6,49270,649270,Moreno Valley city, California,1,2010,194592,46.2,66.3,6.2,91437,103155,117462,34793,11337,576,92,92045,102547
6,49670,649670,Mountain View city, California,1,2010,74320,51.5,80.3,11.9,37357,36963,44726,1598,17409,0,0,57028,17292
6,50076,650076,Murrieta city, California,1,2010,104108,42.5,68.3,10,51932,52176,66455,5672,14934,416,0,74951,29157
6,50258,650258,Napa city, California,1,2010,77122,39.7,74.9,13.7,38452,38670,67477,710,2153,283,124,47058,30064
6,51182,651182,Newport Beach city, California,1,2010,85442,40.4,82.5,17.2,42800,42642,74039,338,5718,0,67,78610,6832
6,52526,652526,Norwalk city, California,1,2010,105686,44.7,72.1,10.3,53913,51773,42466,5246,15417,1132,43,36154,69532
6,53000,653000,Oakland city, California,1,2010,391672,45.7,78.3,11.8,193838,197834,154794,103160,67591,2276,2594,294157,97515
6,53322,653322,Oceanside city, California,1,2010,167680,43.3,74.8,12.2,83495,84185,115759,8158,10061,737,2406,104085,63595
6,53896,653896,Ontario city, California,1,2010,164517,48.2,70.9,7.1,85033,79484,105986,13786,5867,2218,62,53638,110879
6,53980,653980,Orange city, California,1,2010,136803,43.9,73.1,10.3,70505,66298,80713,2578,19204,515,62,85329,51474
6,54652,654652,Oxnard city, California,1,2010,198484,45.9,70.6,8.1,101336,97148,146630,6718,15123,2221,84,55913,142571
6,55156,655156,Palmdale city, California,1,2010,152944,43.8,66.1,6.2,73000,79944,59585,24944,6668,1479,593,70819,82125
6,56000,656000,Pasadena city, California,1,2010,137294,46.4,81,12.5,74071,63223,94967,14504,17551,660,88,88106,49188
6,56700,656700,Perris city, California,1,2010,68816,49.1,63.2,3.9,32597,36219,26593,5280,1817,733,0,16047,52769
6,57456,657456,Pittsburg city, California,0,2010,63510,46.7,74,8.8,28998,34512,28015,13409,9411,0,1299,36262,27248
6,57792,657792,Pleasanton city, California,1,2010,70456,38.7,71.1,10.2,33753,36703,46184,2001,17455,431,152,60611,9845
6,58072,658072,Pomona city, California,1,2010,149225,46.5,67.4,7.6,70394,78831,83119,13089,15275,1122,80,44285,104940
6,59451,659451,Rancho Cucamonga city, California,1,2010,165858,44.6,73.1,6.9,81730,84128,107575,14826,19690,1085,207,110005,55853
6,59920,659920,Redding city, California,1,2010,89901,38.1,75.8,15.3,45154,44747,77816,675,2098,2095,72,81514,8387
6,59962,659962,Redlands city, California,1,2010,68994,44.8,76.2,12.7,33513,35481,50850,2237,5704,365,0,47610,21384
6,60018,660018,Redondo Beach city, California,1,2010,66825,44.8,78.9,9.4,32750,34075,48883,2471,7016,335,60,54407,12418
6,60102,660102,Redwood City city, California,1,2010,77013,40.9,74.5,11.3,38386,38627,57330,1239,8888,1294,670,46723,30290
6,60466,660466,Rialto city, California,1,2010,99530,46.9,66.5,6.7,49278,50252,63556,14048,1310,1202,0,28484,71046
6,60620,660620,Richmond city, California,1,2010,104059,42.4,75.8,9.1,50293,53766,45887,29779,16169,185,132,63618,40441
6,62000,662000,Riverside city, California,1,2010,305707,47.4,73.3,8.7,154463,151244,212741,22318,19917,1544,1271,156286,149421
6,62938,662938,Roseville city, California,1,2010,119335,42.5,72.9,12.8,58055,61280,95040,1685,10791,780,356,102644,16691
6,64000,664000,Sacramento city, California,1,2010,467503,45.2,75.1,10.9,224397,243106,241396,63594,85081,5894,4374,343042,124461
6,64224,664224,Salinas city, California,1,2010,151031,45.9,67,6.6,76414,74617,117645,2548,9180,1003,102,37619,113412
6,65000,665000,San Bernardino city, California,1,2010,210670,43,67.6,9.1,105441,105229,96253,28085,8729,2905,1167,79053,131617
6,65042,665042,San Buenaventura (Ventura) city, California,1,2010,106730,41,77.1,13.6,53612,53118,74518,1254,2832,435,260,68901,37829
6,66000,666000,San Diego city, California,1,2010,1311886,48.5,78,10.5,667048,644838,841677,85226,209527,6235,7893,929831,382055
6,67000,667000,San Francisco city, California,1,2010,805463,49.4,86.6,13.7,408065,397398,414524,49349,269050,3985,3465,683273,122190
6,68000,668000,San Jose city, California,1,2010,949197,44,75.4,10.4,477347,471850,440493,32912,307151,6770,3305,630808,318389
6,68084,668084,San Leandro city, California,1,2010,85159,40.2,79.6,13.2,41237,43922,34717,6624,31663,417,304,64103,21056
6,68196,668196,San Marcos city, California,1,2010,84079,45.1,72.3,9.4,39850,44229,69325,1851,6806,264,384,54950,29129
6,68252,668252,San Mateo city, California,1,2010,97461,42.1,81.2,15.2,47173,50288,61282,1447,18839,1053,1742,72466,24995
6,68378,668378,San Ramon city, California,1,2010,72404,39.7,71.9,9.5,35497,36907,37268,1620,28976,194,109,65732,6672
6,69000,669000,Santa Ana city, California,1,2010,325483,49,68.8,6.2,162897,162586,121403,6773,33490,1445,0,71584,253899
6,69070,669070,Santa Barbara city, California,1,2010,88579,45.4,81,15.2,45380,43199,64286,1076,2781,443,0,52586,35993
6,69084,669084,Santa Clara city, California,1,2010,116864,50.1,75.5,8.4,58532,58332,49834,2844,44385,629,96,93754,23110
6,69088,669088,Santa Clarita city, California,1,2010,176535,41.8,73.9,9.7,90299,86236,130917,2785,17497,121,0,128050,48485
6,69196,669196,Santa Maria city, California,1,2010,99747,47.5,70.8,8.2,51031,48716,81715,2621,5319,0,101,29338,70409
6,70000,670000,Santa Monica city, California,1,2010,89861,44.1,85.3,14.9,43509,46352,67067,5722,9040,64,47,79783,10078
6,70098,670098,Santa Rosa city, California,1,2010,168244,41.6,74.9,12.4,82024,86220,137165,5319,8680,2681,1002,120173,48071
6,72016,672016,Simi Valley city, California,1,2010,124596,42.3,76.7,11.1,62389,62207,97871,1294,8957,999,624,94556,30040
6,73080,673080,South Gate city, California,1,2010,94503,47.1,70.9,7.1,46602,47901,26286,832,1744,123,0,5178,89325
6,75000,675000,Stockton city, California,1,2010,292747,43.5,71.2,10.6,143453,149294,142565,30495,61425,4912,1595,179313,113434
6,77000,677000,Sunnyvale city, California,1,2010,140549,45.3,78,10.9,70278,70271,68209,2873,57089,260,1692,117329,23220
6,78120,678120,Temecula city, California,1,2010,100751,44.8,68.1,6.7,49423,51328,69087,3754,9875,2984,0,75046,25705
6,78582,678582,Thousand Oaks city, California,1,2010,127041,37.4,76.2,13.3,62556,64485,101759,1374,13609,187,0,108992,18049
6,80000,680000,Torrance city, California,1,2010,145618,39.2,77.5,16.7,71698,73920,73992,5554,48543,355,289,123247,22371
6,80238,680238,Tracy city, California,1,2010,83223,44.2,68,7.2,41177,42046,47758,4862,13678,251,1045,51532,31691
6,80812,680812,Turlock city, California,1,2010,68663,47.4,77.9,11.4,33599,35064,52529,1949,6573,231,0,47038,21625
6,80854,680854,Tustin city, California,1,2010,75769,46.8,70.8,8.2,37656,38113,45724,1257,15397,150,411,44637,31132
6,81204,681204,Union City city, California,1,2010,69696,41.9,71.9,10.2,33981,35715,14062,5569,35618,110,789,55380,14316
6,81344,681344,Upland city, California,1,2010,73991,43.1,75.3,13.3,33982,40009,45835,4557,6274,323,0,48257,25734
6,81554,681554,Vacaville city, California,1,2010,92623,45.8,78.2,9.6,51452,41171,57777,10209,7438,627,845,69294,23329
6,81666,681666,Vallejo city, California,1,2010,116217,40.7,76.6,13.1,55026,61191,44330,28562,25770,844,1014,89390,26827
6,82590,682590,Victorville city, California,1,2010,116305,45.5,65.7,7.6,55829,60476,79217,13769,5343,252,66,57196,59109
6,82954,682954,Visalia city, California,1,2010,124866,43.6,70.8,11,61861,63005,103377,2327,5961,2590,136,64894,59972
6,82996,682996,Vista city, California,1,2010,94170,44.1,73.9,9.1,46219,47951,73937,2664,2958,514,40,47147,47023
6,84200,684200,West Covina city, California,1,2010,106221,43.1,74.3,13.1,47114,59107,37801,7508,23266,0,0,45700,60521
6,84550,684550,Westminster city, California,1,2010,89971,38,75.9,14.4,45410,44561,32704,881,44676,67,0,70812,19159
6,85292,685292,Whittier city, California,1,2010,85433,43.2,75.8,11.5,41996,43437,47573,1078,1693,502,0,28752,56681
6,86832,686832,Yorba Linda city, California,0,2010,64414,37.5,75.8,12.8,33313,31101,47771,635,13011,173,0,56188,8226
8,3455,803455,Arvada city, Colorado,1,2010,107604,39,76.6,12.3,53683,53921,98026,593,1829,270,0,92994,14610
8,4000,804000,Aurora city, Colorado,1,2010,326719,43.4,71.4,8.6,162428,164291,210602,49679,16677,5894,1042,227038,99681
8,7850,807850,Boulder city, Colorado,1,2010,97585,58.6,85.1,9.6,48995,48590,84662,1234,4676,419,45,87411,10174
8,12815,812815,Centennial city, Colorado,1,2010,100909,35.9,74.8,12.5,49673,51236,92163,814,3984,183,0,93265,7644
8,16000,816000,Colorado Springs city, Colorado,1,2010,419586,42.1,75.1,10.6,203157,216429,335089,27873,10941,3032,631,350432,69154
8,20000,820000,Denver city, Colorado,1,2010,604414,48.7,78.6,10.4,302514,301900,422070,60957,19267,7125,321,411321,193093
8,27425,827425,Fort Collins city, Colorado,1,2010,144453,53.4,79.6,8.7,72680,71773,128138,2420,4841,445,114,130788,13665
8,32155,832155,Greeley city, Colorado,1,2010,93389,46,74.7,8.8,45721,47668,82122,1659,2087,621,43,62148,31241
8,36410,836410,Highlands Ranch CDP, Colorado,0,2010,95503,40.5,68.8,5.9,48177,47326,85662,1103,4793,485,0,88314,7189
8,43000,843000,Lakewood city, Colorado,1,2010,143230,40.7,79.9,16,70848,72382,124503,4048,4535,2455,0,110392,32838
8,45970,845970,Longmont city, Colorado,1,2010,86429,41.1,74.2,9.8,42666,43763,70755,709,2150,464,0,64873,21556
8,46465,846465,Loveland city, Colorado,1,2010,67100,41.8,76.1,11.7,31679,35421,61780,65,389,255,402,57311,9789
8,62000,862000,Pueblo city, Colorado,1,2010,106865,39.1,75.7,15.6,52828,54037,77725,1277,1200,3801,308,54248,52617
8,77290,877290,Thornton city, Colorado,1,2010,119324,45.3,71.5,6.6,56958,62366,97419,3205,5510,674,223,84761,34563
8,83835,883835,Westminster city, Colorado,1,2010,106518,42.8,74.9,9.1,51952,54566,87514,1404,5351,299,0,80400,26118
9,8000,908000,Bridgeport city, Connecticut,1,2010,144521,46.1,73.7,9.9,69799,74722,69435,53211,6435,123,0,91034,53487
9,18430,918430,Danbury city, Connecticut,1,2010,81043,45.2,78.4,11.1,37917,43126,54223,5936,4735,42,0,61420,19623
9,37000,937000,Hartford city, Connecticut,1,2010,124847,47.2,73.4,10.1,58121,66726,37075,47591,3516,601,0,72265,52582
9,50370,950370,New Britain city, Connecticut,1,2010,73247,46.6,76.6,13.2,35908,37339,44464,7862,2159,49,0,48019,25228
9,52000,952000,New Haven city, Connecticut,1,2010,129849,53.4,77.3,7.9,62706,67143,60452,48133,6035,100,171,96141,33708
9,55990,955990,Norwalk city, Connecticut,1,2010,85793,38.2,82.9,15.2,41237,44556,60740,14299,5429,81,172,75867,9926
9,73000,973000,Stamford city, Connecticut,1,2010,122902,44.9,77.5,12.3,61647,61255,73527,16735,8343,256,0,88078,34824
9,80000,980000,Waterbury city, Connecticut,1,2010,110430,42.5,75.4,12.6,53086,57344,61055,21489,2018,126,0,76800,33630
10,77580,1077580,Wilmington city, Delaware,1,2010,70921,43.2,75.7,11.7,33530,37391,28136,38957,396,451,0,63894,7027
11,50000,1150000,Washington city, District of Columbia,1,2010,604453,51.5,83.2,11.5,285729,318724,242905,309221,21552,1927,233,549197,55256
12,410,1200410,Alafaya CDP, Florida,0,2010,84809,53.8,72.3,4.8,40185,44624,68848,6753,3570,0,250,53165,31644
12,7300,1207300,Boca Raton city, Florida,1,2010,84604,35.5,82.6,22.8,43320,41284,77329,3247,1051,197,0,74729,9875
12,7875,1207875,Boynton Beach city, Florida,1,2010,68380,36.3,84.3,24.8,31160,37220,-998,-998,-998,-998,-998,62124,6256
12,8150,1208150,Brandon CDP, Florida,0,2010,102939,45.2,77.7,8.4,50076,52863,76972,16183,4193,68,141,77274,25665
12,10275,1210275,Cape Coral city, Florida,1,2010,154668,35.9,76.7,17,77063,77605,140149,4151,2841,740,0,124029,30639
12,12875,1212875,Clearwater city, Florida,1,2010,107697,36,81.7,19.4,52354,55343,90612,11793,2409,0,0,95638,12059
12,14400,1214400,Coral Springs city, Florida,1,2010,121492,41.1,74.3,8,58402,63090,87194,23362,4295,1418,389,89885,31607
12,16475,1216475,Davie town, Florida,1,2010,92290,41.8,74.4,8.7,44217,48073,70951,9760,4794,213,191,65185,27105
12,16725,1216725,Deerfield Beach city, Florida,1,2010,75245,38.9,85.5,21.1,38228,37017,51143,21538,417,130,0,64516,10729
12,17200,1217200,Deltona city, Florida,1,2010,85183,39.5,75,13.1,40422,44761,60804,10493,792,99,0,61424,23759
12,24000,1224000,Fort Lauderdale city, Florida,1,2010,166039,39.8,82.3,15.8,88625,77414,105115,51859,1459,123,0,142832,23207
12,24125,1224125,Fort Myers city, Florida,0,2010,62429,40.2,74.2,15.2,29849,32580,33047,22202,1251,0,0,49049,13380
12,25175,1225175,Gainesville city, Florida,1,2010,124433,64.6,88.6,8.8,60651,63782,82202,29345,7607,408,0,111590,12843
12,30000,1230000,Hialeah city, Florida,1,2010,225461,40.8,82.4,18.7,106419,119042,212169,5332,236,173,0,7216,218245
12,32000,1232000,Hollywood city, Florida,1,2010,141202,38.4,79.5,15.2,68752,72450,101076,26642,3984,155,263,99811,41391
12,35000,1235000,Jacksonville city, Florida,1,2010,823316,43.1,76.2,10.9,399485,423831,499732,254742,33819,1859,252,759235,64081
12,36100,1236100,Kendall CDP, Florida,0,2010,82561,38.4,80.1,17.2,38981,43580,72791,2514,4276,283,0,31441,51120
12,38250,1238250,Lakeland city, Florida,1,2010,97530,38.5,77.8,20.8,47360,50170,71874,18930,2315,118,0,84014,13516
12,39425,1239425,Largo city, Florida,1,2010,77663,33.6,83.7,25.2,36621,41042,69970,2762,2571,290,201,69086,8577
12,39550,1239550,Lauderhill city, Florida,1,2010,67100,42,72.3,10.8,29849,37251,9012,52634,1761,0,266,62814,4286
12,39925,1239925,Lehigh Acres CDP, Florida,0,2010,88196,38.7,73.2,14.1,42107,46089,62539,17394,758,63,0,62198,25998
12,43975,1243975,Melbourne city, Florida,1,2010,76083,37.9,81.9,19.9,37193,38890,62953,7882,1652,0,55,70009,6074
12,45000,1245000,Miami city, Florida,1,2010,400892,43.5,81.6,15.8,199043,201849,293897,81120,2612,260,0,116799,284093
12,45025,1245025,Miami Beach city, Florida,1,2010,88110,48.2,86.3,16.1,47745,40365,67266,2396,2962,0,0,41262,46848
12,45060,1245060,Miami Gardens city, Florida,1,2010,107559,43,72.7,10.2,48347,59212,-998,-998,-998,-998,-998,84572,22987
12,45975,1245975,Miramar city, Florida,1,2010,122438,44.5,71.9,8,55713,66725,48588,50569,11319,127,0,77338,45100
12,53000,1253000,Orlando city, Florida,1,2010,239037,50.2,78.6,8.8,120731,118306,138146,72230,7870,1231,247,182976,56061
12,54000,1254000,Palm Bay city, Florida,1,2010,103225,38.9,75.5,13.8,48776,54449,76654,16623,1723,672,0,85688,17537
12,54200,1254200,Palm Coast city, Florida,1,2010,77473,32.2,78.7,23.6,35995,41478,60122,9242,2300,283,396,69285,8188
12,55775,1255775,Pembroke Pines city, Florida,1,2010,155252,39.2,76.6,14.2,71253,83999,102819,30887,8721,1689,0,90140,65112
12,57425,1257425,Plantation city, Florida,1,2010,85217,39,80.1,16.1,39133,46084,56526,21147,3387,82,0,69301,15916
12,58050,1258050,Pompano Beach city, Florida,1,2010,100154,37.7,79.8,19,51176,48978,69027,28474,1452,48,0,84537,15617
12,58715,1258715,Port St. Lucie city, Florida,1,2010,165153,38,75.7,15.5,81906,83247,118535,26841,3720,2201,0,137113,28040
12,60950,1260950,Riverview CDP, Florida,0,2010,66415,41,72.4,9.1,32177,34238,48648,10140,2188,402,95,53393,13022
12,63000,1263000,St. Petersburg city, Florida,1,2010,244818,37.9,81,16.5,116565,128253,169184,59098,9485,491,84,226843,17975
12,68350,1268350,Spring Hill CDP, Florida,0,2010,97103,32.9,79.6,24.1,46481,50622,84697,4799,976,210,314,82773,14330
12,69700,1269700,Sunrise city, Florida,1,2010,84717,40.1,78.7,14.8,39353,45364,51295,25337,2575,566,0,63378,21339
12,70600,1270600,Tallahassee city, Florida,1,2010,181734,59.1,82.5,7.3,86503,95231,105356,63000,6512,803,0,171179,10555
12,71000,1271000,Tampa city, Florida,1,2010,336945,45,76.4,10.5,165425,171520,210409,88443,12335,8285,249,262395,74550
12,72145,1272145,Town 'n' Country CDP, Florida,0,2010,81175,44.6,78.6,12.8,40580,40595,64801,8523,1977,1028,0,43903,37272
12,76582,1276582,Weston city, Florida,0,2010,65528,39.4,69.8,8.6,32060,33468,56124,1208,3860,283,0,35272,30256
12,76600,1276600,West Palm Beach city, Florida,1,2010,100175,40.7,79.1,16.4,48532,51643,64289,29591,2192,165,0,78676,21499
13,1052,1301052,Albany city, Georgia,1,2010,78971,42.6,73.1,11.1,36733,42238,18636,57568,821,115,0,76853,2118
13,3440,1303440,Athens-Clarke County unified government (balance), Georgia,1,2010,115465,59.6,82.5,8.6,55248,60217,74986,30148,4595,0,0,103384,12081
13,4000,1304000,Atlanta city, Georgia,1,2010,422338,51.7,80.9,9.8,207850,214488,166001,220448,15251,435,0,396973,25365
13,4204,1304204,Augusta-Richmond County consolidated government (balance), Georgia,1,2010,196386,43,75.3,11.2,94257,102129,77458,107523,3122,830,4,188010,8376
13,19000,1319000,Columbus city, Georgia,1,2010,190417,42.7,74.5,11.7,90947,99470,89801,85792,4564,456,118,178162,12255
13,42425,1342425,Johns Creek city, Georgia,1,2010,77207,37.9,68.2,7.5,37760,39447,50249,8687,14553,216,155,72411,4796
13,49000,1349000,Macon city, Georgia,1,2010,91524,40.5,73.1,11.5,42609,48915,29541,57757,615,0,0,88960,2564
13,67284,1367284,Roswell city, Georgia,1,2010,88908,39.4,77.7,11.3,43379,45529,69336,7849,5101,215,0,76377,12531
13,68516,1368516,Sandy Springs city, Georgia,1,2010,94441,48,80.5,10,44926,49515,61707,20673,6007,232,80,81641,12800
13,69000,1369000,Savannah city, Georgia,1,2010,136651,49.2,79.2,10.9,66395,70256,57811,72566,4044,210,0,130348,6303
13,80508,1380508,Warner Robins city, Georgia,1,2010,66757,43.8,71.2,11.2,32721,34036,36541,23719,442,0,0,61624,5133
15,71550,1571550,Urban Honolulu CDP, Hawaii,0,2010,338909,40.1,83.3,18.7,166876,172033,60569,4765,193098,512,25401,321040,17869
16,8830,1608830,Boise City city, Idaho,1,2010,206286,43.5,78.5,12.5,102968,103318,186771,3610,7254,1295,319,191454,14832
16,52120,1652120,Meridian city, Idaho,1,2010,75324,42.7,66.4,7.6,36019,39305,-998,-998,-998,-998,-998,71302,4022
16,56260,1656260,Nampa city, Idaho,1,2010,81781,41.9,68.9,9.4,40606,41175,71525,490,765,2653,0,62397,19384
17,2154,1702154,Arlington Heights village, Illinois,1,2010,77009,36.4,79.3,18.3,38294,38715,64574,1883,7485,537,0,72395,4614
17,3012,1703012,Aurora city, Illinois,1,2010,193582,48.6,67.3,5.4,98154,95428,107964,21814,12176,268,152,105444,88138
17,6613,1706613,Bloomington city, Illinois,1,2010,76730,46.5,76.4,9.6,38128,38602,59206,8355,5605,57,0,73383,3347
17,7133,1707133,Bolingbrook village, Illinois,1,2010,73027,41.5,69.8,5.7,36288,36739,43905,14008,8232,832,0,57038,15989
17,12385,1712385,Champaign city, Illinois,1,2010,81164,63.3,84.2,7.2,39553,41611,58814,10123,9973,90,0,76150,5014
17,14000,1714000,Chicago city, Illinois,1,2010,2698831,47.9,76.6,10.1,1306010,1392821,1256175,905799,149897,6513,661,1934863,763968
17,14351,1714351,Cicero town, Illinois,1,2010,84002,46.7,67.3,5.2,42737,41265,25526,4138,206,775,328,11604,72398
17,18823,1718823,Decatur city, Illinois,1,2010,76268,37.3,77.1,16.7,34540,41728,53946,18294,708,0,0,74422,1846
17,23074,1723074,Elgin city, Illinois,1,2010,108273,42.2,71.2,9.5,53894,54379,75566,8854,5969,83,0,59331,48942
17,24582,1724582,Evanston city, Illinois,1,2010,74549,47.8,77.6,11.8,34479,40070,52205,10096,7815,0,0,66525,8024
17,38570,1738570,Joliet city, Illinois,1,2010,150856,44.5,69.8,8.1,73712,77144,105971,25783,3155,90,149,112761,38095
17,51622,1751622,Naperville city, Illinois,1,2010,141483,37.6,71.7,9.6,71505,69978,106244,6612,22825,213,609,133979,7504
17,57225,1757225,Palatine village, Illinois,1,2010,68596,42.3,76,9.3,33566,35030,55060,2264,7968,145,0,56683,11913
17,59000,1759000,Peoria city, Illinois,1,2010,114966,43.8,75.2,13.4,55363,59603,75686,30459,4558,65,0,108846,6120
17,65000,1765000,Rockford city, Illinois,1,2010,152220,40.2,73.3,13.7,73293,78927,104852,34253,4465,447,79,125089,27131
17,68003,1768003,Schaumburg village, Illinois,1,2010,73279,47.9,78.7,10.4,35871,37408,55674,1204,12584,24,0,67955,5324
17,70122,1770122,Skokie village, Illinois,0,2010,64861,34.4,79.3,17,31009,33852,41832,4913,15978,0,0,57563,7298
17,72000,1772000,Springfield city, Illinois,1,2010,116188,38.3,77.6,14.6,56063,60125,89535,21229,2458,260,0,114576,1612
17,79293,1779293,Waukegan city, Illinois,1,2010,87729,47.9,69.5,6.8,43830,43899,34329,15384,3150,613,0,41438,46291
18,5860,1805860,Bloomington city, Indiana,1,2010,81096,66.6,89.3,8.9,40961,40135,67643,2845,7408,183,0,77814,3282
18,10342,1810342,Carmel city, Indiana,1,2010,79447,35.2,70.3,9.7,38553,40894,67858,1942,7170,109,0,76280,3167
18,22000,1822000,Evansville city, Indiana,1,2010,115833,40.6,76.4,14.4,55775,60058,96195,14631,468,177,0,112214,3619
18,23278,1823278,Fishers town, Indiana,1,2010,77579,44.3,67.6,6.1,37616,39963,-998,-998,-998,-998,-998,76558,1021
18,25000,1825000,Fort Wayne city, Indiana,1,2010,253696,40.6,72.5,11.9,122815,130881,189969,39416,6945,1158,191,234120,19576
18,27000,1827000,Gary city, Indiana,1,2010,80840,35.3,74.1,14.9,38531,42309,9208,67301,84,217,195,75728,5112
18,31000,1831000,Hammond city, Indiana,1,2010,80812,44.3,73.5,10.2,39618,41194,43149,17952,1122,0,0,51182,29630
18,36003,1836003,Indianapolis city (balance), Indiana,1,2010,824199,43.9,74.9,10.3,397975,426224,523449,228180,17546,2468,0,745732,78467
18,40788,1840788,Lafayette city, Indiana,1,2010,65261,47.6,80.2,11.9,32248,33013,55554,3672,2152,42,0,57842,7419
18,51876,1851876,Muncie city, Indiana,1,2010,68651,51.6,82.9,13.1,32994,35657,57634,6433,1017,303,0,67329,1322
18,71000,1871000,South Bend city, Indiana,1,2010,107072,41.5,73.2,13.6,52483,54589,70036,28539,837,1193,82,94266,12806
19,12000,1912000,Cedar Rapids city, Iowa,1,2010,126498,40.9,77.1,13.5,60328,66170,111335,8851,2039,251,0,122451,4047
19,19000,1919000,Davenport city, Iowa,1,2010,100068,42.2,74,11.2,49385,50683,80942,11770,1816,382,0,92373,7695
19,21000,1921000,Des Moines city, Iowa,1,2010,204196,43.6,75.2,10.7,99020,105176,160303,20188,9190,1431,83,180364,23832
19,38595,1938595,Iowa City city, Iowa,1,2010,68027,61.1,84.7,7.6,33535,34492,56192,4122,4524,150,97,64110,3917
19,73335,1973335,Sioux City city, Iowa,1,2010,82378,40.9,73.5,13,40272,42106,65021,3357,2666,1905,0,68550,13828
19,82425,1982425,Waterloo city, Iowa,1,2010,68472,41.6,73.8,13.6,32488,35984,55078,10275,634,136,0,64930,3542
20,36000,2036000,Kansas City city, Kansas,1,2010,147798,42.3,72,10.3,72884,74914,91880,40232,3896,982,0,106687,41111
20,38900,2038900,Lawrence city, Kansas,1,2010,92718,59.3,81.6,7.6,46576,46142,75514,4054,3869,2879,0,87141,5577
20,52575,2052575,Olathe city, Kansas,1,2010,126256,44,70.5,6.4,63860,62396,107388,6096,8003,220,0,112300,13956
20,53775,2053775,Overland Park city, Kansas,1,2010,173909,39.1,75.6,13.8,82149,91760,147761,7822,10367,852,0,163657,10252
20,71000,2071000,Topeka city, Kansas,1,2010,127727,40.4,75.8,14.3,61083,66644,93763,14463,2176,1707,0,110015,17712
20,79000,2079000,Wichita city, Kansas,1,2010,383142,41.4,73.6,11.2,188182,194960,280244,43114,19522,3678,46,323319,59823
21,46027,2146027,Lexington-Fayette urban county, Kentucky,1,2010,296765,47.6,78.9,10.4,147746,149019,226025,40708,9693,837,240,276164,20601
21,48006,2148006,Louisville/Jefferson County metro government (balance), Kentucky,1,2010,598230,40.8,76.1,12.5,288707,309523,431593,136025,12831,1263,184,570454,27776
22,5000,2205000,Baton Rouge city, Louisiana,1,2010,229859,48.2,78.9,11,109942,119917,90411,124218,7517,281,0,221400,8459
22,39475,2239475,Kenner city, Louisiana,1,2010,66681,41.3,80.6,12.5,34027,32654,47778,11896,1131,961,0,52209,14472
22,40735,2240735,Lafayette city, Louisiana,1,2010,120871,45.7,80.6,13.1,60562,60309,81262,35170,3051,214,0,116953,3918
22,41155,2241155,Lake Charles city, Louisiana,1,2010,72163,41.3,78.2,13.4,34107,38056,35590,33077,1604,690,181,70405,1758
22,50115,2250115,Metairie CDP, Louisiana,0,2010,132938,38.4,81.4,17.7,63635,69303,105695,14784,4984,1296,0,115753,17185
22,55000,2255000,New Orleans city, Louisiana,1,2010,347858,45.3,78.8,11.1,168746,179112,114660,207696,9420,1536,217,329599,18259
22,70000,2270000,Shreveport city, Louisiana,1,2010,198934,42.1,75.6,12.9,93514,105420,82885,106185,2742,646,1248,193671,5263
23,60545,2360545,Portland city, Maine,1,2010,66150,48.1,83.4,11.8,31970,34180,57349,3863,3651,0,0,63509,2641
24,4000,2404000,Baltimore city, Maryland,1,2010,620583,45.2,78.6,11.8,292446,328137,188657,392953,14284,2389,202,594552,26031
24,19125,2419125,Columbia CDP, Maryland,0,2010,102239,43.9,77.6,11.7,51195,51044,56043,28593,11439,170,0,93249,8990
24,26000,2426000,Ellicott City CDP, Maryland,0,2010,67241,38.6,73.2,10.7,31849,35392,-998,-998,-998,-998,-998,64646,2595
24,30325,2430325,Frederick city, Maryland,0,2010,65439,46.6,78.7,10.9,33003,32436,44870,10231,4549,1128,621,55640,9799
24,32025,2432025,Germantown CDP, Maryland,0,2010,83372,47.7,74.2,5.2,42068,41304,40313,20247,15610,644,0,69949,13423
24,72450,2472450,Silver Spring CDP, Maryland,0,2010,76534,51.6,77,8.1,35947,40587,33514,21388,5140,1445,0,54161,22373
24,81175,2481175,Waldorf CDP, Maryland,0,2010,68961,44.2,71.6,6.5,32479,36482,27501,35805,1905,127,0,65806,3155
25,7000,2507000,Boston city, Massachusetts,1,2010,621383,55.4,83.4,10.1,296201,325182,336981,154711,56760,1516,133,516516,104867
25,9000,2509000,Brockton city, Massachusetts,1,2010,93973,43.2,74.8,11.7,44346,49627,45903,36204,1459,520,0,84508,9465
25,11000,2511000,Cambridge city, Massachusetts,1,2010,105337,57.9,87.6,12.3,49895,55442,70927,11420,16128,185,0,97907,7430
25,23000,2523000,Fall River city, Massachusetts,1,2010,88894,43.2,80.3,15.2,41233,47661,81754,1981,1303,236,0,81204,7690
25,24960,2524960,Framingham CDP, Massachusetts,0,2010,68461,45.5,79.1,12.2,32747,35714,51280,7023,4623,121,0,60339,8122
25,34550,2534550,Lawrence city, Massachusetts,1,2010,76526,44.3,70.7,8,36667,39859,23734,2832,2667,631,0,18516,58010
25,37000,2537000,Lowell city, Massachusetts,1,2010,106730,46.6,77,8.8,52085,54645,62246,4802,25035,0,0,88454,18276
25,37490,2537490,Lynn city, Massachusetts,1,2010,90511,46,74.4,10.9,41366,49145,62912,10353,6347,90,0,62679,27832
25,45000,2545000,New Bedford city, Massachusetts,1,2010,95138,40.9,74.7,14.3,43615,51523,73561,6152,1047,339,76,81043,14095
25,45560,2545560,Newton city, Massachusetts,1,2010,85302,38.8,78.4,16.5,40287,45015,68423,1352,12386,0,0,80772,4530
25,55745,2555745,Quincy city, Massachusetts,1,2010,92486,43.8,83.7,16.1,44079,48407,64038,6831,19409,242,0,89458,3028
25,62535,2562535,Somerville city, Massachusetts,1,2010,75900,62.2,83.4,6.1,36772,39128,59215,5545,5104,658,0,69586,6314
25,67000,2567000,Springfield city, Massachusetts,1,2010,153115,44.5,73.3,11,73794,79321,76259,34312,4581,634,0,90955,62160
25,82000,2582000,Worcester city, Massachusetts,1,2010,181264,46.1,78.5,12.2,84008,97256,139498,19451,10610,500,0,145979,35285
26,3000,2603000,Ann Arbor city, Michigan,1,2010,114101,59.2,84.7,10.5,56165,57936,83795,8363,13896,342,0,107705,6396
26,21000,2621000,Dearborn city, Michigan,1,2010,97895,39.2,70.6,11.5,46088,51807,87265,3028,2447,29,63,92015,5880
26,22000,2622000,Detroit city, Michigan,1,2010,711910,41.3,73.4,11.5,338958,372952,77423,589659,6549,2799,34,666330,45580
26,27440,2627440,Farmington Hills city, Michigan,1,2010,79768,36.2,78,14.7,38234,41534,52956,14557,8341,134,63,76922,2846
26,29000,2629000,Flint city, Michigan,1,2010,102231,41,72.5,11.6,48607,53624,42661,53285,368,686,0,98681,3550
26,34000,2634000,Grand Rapids city, Michigan,1,2010,188214,47.1,73.3,10.4,90614,97600,127354,42866,3695,1723,0,157555,30659
26,42160,2642160,Kalamazoo city, Michigan,1,2010,74382,54.1,79.5,9.1,34806,39576,55494,14506,1565,601,0,68962,5420
26,46000,2646000,Lansing city, Michigan,1,2010,114017,46,76,9.3,56147,57870,68437,27106,3978,934,0,98982,15035
26,49000,2649000,Livonia city, Michigan,1,2010,96684,34.9,76.6,16.9,47716,48968,89398,2721,2505,269,0,94346,2338
26,69035,2669035,Rochester Hills city, Michigan,1,2010,71022,38.8,77.1,12.7,32810,38212,58935,4576,6169,186,0,69511,1511
26,74900,2674900,Southfield city, Michigan,1,2010,71785,37.2,80.7,18.2,31473,40312,19799,49339,1199,0,0,71051,734
26,76460,2676460,Sterling Heights city, Michigan,1,2010,129734,39.1,77.4,14.1,62427,67307,114417,4919,6524,39,0,127249,2485
26,80700,2680700,Troy city, Michigan,1,2010,81037,35.3,76.1,13.4,40986,40051,-998,-998,-998,-998,-998,80047,990
26,84000,2684000,Warren city, Michigan,1,2010,134075,38.8,76.3,17,63416,70659,103177,18860,8300,75,0,129854,4221
26,86000,2686000,Westland city, Michigan,1,2010,83860,41.3,78.8,14.5,38609,45251,62054,16392,2930,694,0,82190,1670
26,88940,2688940,Wyoming city, Michigan,1,2010,72209,44.5,75,10.3,35764,36445,59455,3958,3896,345,0,62160,10049
27,6616,2706616,Bloomington city, Minnesota,1,2010,83054,36.6,77.7,17.9,38719,44335,68456,4948,6221,451,0,77764,5290
27,7966,2707966,Brooklyn Park city, Minnesota,1,2010,75936,42.9,66.7,8.1,36593,39343,40055,16310,13145,0,0,68105,7831
27,17000,2717000,Duluth city, Minnesota,1,2010,86230,47.1,81.2,14.6,43061,43169,79251,2559,1044,1381,0,85339,891
27,43000,2743000,Minneapolis city, Minnesota,1,2010,383280,52.2,81.3,8,194796,188484,265661,64583,21484,6447,190,348776,34504
27,51730,2751730,Plymouth city, Minnesota,1,2010,70710,38.5,74.7,12.3,33851,36859,59956,4345,3539,551,40,67484,3226
27,54880,2754880,Rochester city, Minnesota,1,2010,106963,41.3,74.9,13,51922,55041,89095,6127,6633,87,72,101479,5484
27,56896,2756896,St. Cloud city, Minnesota,0,2010,65885,50.2,84.3,10.6,33400,32485,57090,4858,1586,764,0,64067,1818
27,58000,2758000,St. Paul city, Minnesota,1,2010,285439,48.2,75.6,8.8,138770,146669,180332,42639,42225,2209,50,256714,28725
28,29700,2829700,Gulfport city, Mississippi,1,2010,68042,44.1,76.6,12.4,36188,31854,40601,23958,982,474,0,63040,5002
28,36000,2836000,Jackson city, Mississippi,1,2010,173315,43,71.6,10.1,79986,93329,-998,-998,-998,-998,-998,170019,3296
29,15670,2915670,Columbia city, Missouri,1,2010,108872,57.5,81.2,9.2,50721,58151,86064,11492,6034,247,172,105206,3666
29,35000,2935000,Independence city, Missouri,1,2010,117027,38.7,74.9,15.4,56946,60081,97679,9287,1783,574,99,108950,8077
29,38000,2938000,Kansas City city, Missouri,1,2010,460665,42.7,75.1,10.6,219990,240675,269743,139811,10263,1978,1099,410865,49800
29,41348,2941348,Lee's Summit city, Missouri,1,2010,91229,38.5,73.9,12.8,43826,47403,80781,4985,2456,0,519,89580,1649
29,54074,2954074,O'Fallon city, Missouri,1,2010,79565,42.1,69,9.2,38680,40885,-998,-998,-998,-998,-998,77228,2337
29,64082,2964082,St. Charles city, Missouri,0,2010,65993,40.1,81.9,14.9,32625,33368,58635,5011,495,78,0,63260,2733
29,64550,2964550,St. Joseph city, Missouri,1,2010,74853,41.3,76.8,13.9,37141,37712,65251,5559,662,299,0,70164,4689
29,65000,2965000,St. Louis city, Missouri,1,2010,319156,46.6,78.8,11.1,154585,164571,143898,157759,8717,535,0,307949,11207
29,70000,2970000,Springfield city, Missouri,1,2010,159643,46.2,81.8,14.6,77317,82326,141427,5931,3077,1178,0,153332,6311
30,6550,3006550,Billings city, Montana,1,2010,104491,38.9,76,15.2,51422,53069,93662,743,1289,5018,0,98931,5560
30,50200,3050200,Missoula city, Montana,1,2010,66905,51.8,82.1,10.8,34911,31994,62353,357,638,2145,101,64560,2345
31,28000,3128000,Lincoln city, Nebraska,1,2010,259041,46.8,77,10.8,129404,129637,229073,9540,10604,1453,1216,243034,16007
31,37000,3137000,Omaha city, Nebraska,1,2010,410269,43.4,74.9,11,201168,209101,316463,55287,8397,3539,244,356608,53661
32,23770,3223770,Enterprise CDP, Nevada,0,2010,118697,52.5,75,4.8,61408,57289,68582,11988,22043,817,2168,96626,22071
32,31900,3231900,Henderson city, Nevada,1,2010,258138,37.8,76.9,13.5,128839,129299,204576,15542,21362,1180,1836,220606,37532
32,40000,3240000,Las Vegas city, Nevada,1,2010,584641,41.9,75.9,12.6,296812,287829,401776,61508,38210,3075,3680,402718,181923
32,51800,3251800,North Las Vegas city, Nevada,1,2010,217304,46.3,67.2,6.1,107006,110298,112571,49844,16015,1032,775,134220,83084
32,54600,3254600,Paradise CDP, Nevada,0,2010,215586,44.4,77.8,12.5,109520,106066,151348,20915,15726,794,2832,144997,70589
32,60600,3260600,Reno city, Nevada,1,2010,225818,44,77.1,12.2,116337,109481,185581,7039,13313,2709,427,171661,54157
32,68400,3268400,Sparks city, Nevada,1,2010,90504,44.8,72,8.5,43653,46851,71527,2027,6647,997,179,61120,29384
32,68585,3268585,Spring Valley CDP, Nevada,0,2010,179830,45.5,78.1,11.2,88837,90993,120508,13126,28832,725,2151,145290,34540
32,71400,3271400,Sunrise Manor CDP, Nevada,0,2010,185286,42.4,68,9.5,91513,93773,115903,19168,11180,612,448,90486,94800
33,45140,3345140,Manchester city, New Hampshire,1,2010,109655,43.3,79.3,11.5,53801,55854,91985,4887,5473,386,0,99588,10067
33,50260,3350260,Nashua city, New Hampshire,1,2010,86570,41.7,76.1,11.8,43733,42837,76255,1240,5176,93,0,78785,7785
34,10000,3410000,Camden city, New Jersey,1,2010,77331,44.1,69.1,8,36811,40520,10637,35046,962,780,0,40604,36727
34,13690,3413690,Clifton city, New Jersey,1,2010,84249,42.2,77,13.5,40786,43463,56608,3072,7573,0,0,52592,31657
34,19390,3419390,East Orange city, New Jersey,0,2010,64299,44.3,76.9,11,28604,35695,-998,-998,-998,-998,-998,57145,7154
34,21000,3421000,Elizabeth city, New Jersey,1,2010,125222,46.8,72.6,7.4,61676,63546,65810,23378,2775,104,0,49877,75345
34,36000,3436000,Jersey City city, New Jersey,1,2010,248005,50.9,78.1,8.3,123042,124963,82432,64987,58578,606,0,178132,69873
34,51000,3451000,Newark city, New Jersey,1,2010,277232,48.4,73.7,8.4,138580,138652,71202,145187,4440,2141,40,184703,92529
34,56550,3456550,Passaic city, New Jersey,1,2010,69870,45.8,68.8,7.7,37242,32628,26278,3992,851,159,0,17747,52123
34,57000,3457000,Paterson city, New Jersey,1,2010,146377,45.8,72.4,8.6,70803,75574,78946,47809,6969,495,0,69373,77004
34,73110,3473110,Toms River CDP, New Jersey,0,2010,89390,38,77.3,15.1,42529,46861,80875,1752,4150,0,0,81464,7926
34,74000,3474000,Trenton city, New Jersey,1,2010,85015,47.7,73.9,9.2,41154,43861,25851,42990,1054,591,0,55944,29071
34,74630,3474630,Union City city, New Jersey,1,2010,66560,50,75.5,8.5,32196,34364,40014,2260,3289,291,0,15855,50705
35,2000,3502000,Albuquerque city, New Mexico,1,2010,547585,42.7,76,12.1,266622,280963,383124,18601,13884,21924,0,288438,259147
35,39380,3539380,Las Cruces city, New Mexico,1,2010,98239,44.3,77,13.2,47091,51148,88302,1461,1112,1621,0,40988,57251
35,63460,3563460,Rio Rancho city, New Mexico,1,2010,87954,38.8,71.3,11.4,42027,45927,72721,3083,1354,3224,180,55973,31981
35,70500,3570500,Santa Fe city, New Mexico,1,2010,68157,32.9,80.8,18.6,32752,35405,59885,440,910,207,0,35163,32994
36,1000,3601000,Albany city, New York,1,2010,97737,52,81.7,12.7,47554,50183,53959,32791,4340,484,0,89450,8287
36,11000,3611000,Buffalo city, New York,1,2010,261210,45.2,77.2,11.4,123608,137602,135264,99988,9856,1496,104,239525,21685
36,15000,3615000,Cheektowaga CDP, New York,0,2010,75018,35.9,82.1,19.6,36411,38607,66784,5273,497,539,0,73216,1802
36,49121,3649121,Mount Vernon city, New York,1,2010,67397,41.1,74,10.9,31171,36226,19132,42215,699,131,0,57261,10136
36,50617,3650617,New Rochelle city, New York,1,2010,77177,40.8,77.8,15.9,36466,40711,52066,14247,1645,62,0,58244,18933
36,51000,3651000,New York city, New York,1,2010,8184899,45.5,78.4,12.2,3887304,4297595,3649022,2048482,1046126,33179,3883,5838073,2346826
36,63000,3663000,Rochester city, New York,1,2010,210595,47.5,75,8.6,100160,110435,91654,89317,7322,1252,0,176330,34265
36,65508,3665508,Schenectady city, New York,1,2010,66202,43.7,74.3,11.1,32018,34184,41228,15116,3699,534,0,59350,6852
36,73000,3673000,Syracuse city, New York,1,2010,145216,49.4,76.4,9.5,69341,75875,83806,41947,6848,416,49,132202,13014
36,84000,3684000,Yonkers city, New York,1,2010,196277,40.9,76.8,14.1,91694,104583,100977,34687,13724,133,0,128119,68158
37,2140,3702140,Asheville city, North Carolina,1,2010,83570,42.6,82.9,16.9,40715,42855,70885,9521,871,299,35,78816,4754
37,10740,3710740,Cary town, North Carolina,1,2010,135418,43.8,72.7,7.3,65719,69699,97806,8588,16327,326,0,119756,15662
37,12000,3712000,Charlotte city, North Carolina,1,2010,734418,46.8,74.6,8.7,353327,381091,390251,255557,37416,4135,152,638172,96246
37,14100,3714100,Concord city, North Carolina,1,2010,79330,42.3,73.6,10.4,38902,40428,62458,11007,2340,120,54,68208,11122
37,19000,3719000,Durham city, North Carolina,1,2010,229029,49.3,77.2,9.4,107619,121410,98538,90408,10035,178,65,195776,33253
37,22920,3722920,Fayetteville city, North Carolina,1,2010,201077,47,75.9,9.9,100049,101028,94939,81367,4931,1187,402,180431,20646
37,25580,3725580,Gastonia city, North Carolina,1,2010,71782,40.6,75.1,12.3,33625,38157,43977,18545,2220,187,0,62584,9198
37,28000,3728000,Greensboro city, North Carolina,1,2010,270357,45.6,78.3,12.2,127295,143062,142079,102102,10772,626,0,252382,17975
37,28080,3728080,Greenville city, North Carolina,1,2010,84879,58.8,81.9,8.5,38498,46381,49147,30358,2037,0,0,82172,2707
37,31400,3731400,High Point city, North Carolina,1,2010,103672,40.8,71.3,10.5,48902,54770,51098,39885,7075,739,0,94667,9005
37,34200,3734200,Jacksonville city, North Carolina,1,2010,70705,59.7,76.7,6.4,39986,30719,50339,13465,2734,386,224,61777,8928
37,55000,3755000,Raleigh city, North Carolina,1,2010,406609,50.4,77.4,8.3,196072,210537,252036,117594,16276,1600,112,361247,45362
37,74440,3774440,Wilmington city, North Carolina,1,2010,106819,45.3,80.7,13.5,51369,55450,80402,22036,1207,118,0,99356,7463
37,75000,3775000,Winston-Salem city, North Carolina,1,2010,230044,44.1,75,11.8,107510,122534,126631,78481,5347,403,130,195281,34763
38,25700,3825700,Fargo city, North Dakota,1,2010,106600,51.1,79.7,9.7,54408,52192,97724,1890,2809,1182,0,104098,2502
39,1000,3901000,Akron city, Ohio,1,2010,199030,41.1,75.9,12.6,95259,103771,123870,60946,4567,130,0,195040,3990
39,12000,3912000,Canton city, Ohio,1,2010,72958,38.6,72.3,13.3,34824,38134,48310,19757,200,106,0,70968,1990
39,15000,3915000,Cincinnati city, Ohio,1,2010,296907,46.8,78.4,10.5,143338,153569,146964,132993,5938,1348,0,288197,8710
39,16000,3916000,Cleveland city, Ohio,1,2010,396240,41.2,76.4,12.4,187130,209110,158119,211256,5547,1867,49,360173,36067
39,18000,3918000,Columbus city, Ohio,1,2010,789939,49.6,76.3,8.3,382982,406957,495942,219996,35529,1510,304,746663,43276
39,21000,3921000,Dayton city, Ohio,1,2010,141501,44.3,76.8,11.2,69634,71867,74803,61522,1231,230,0,138321,3180
39,44856,3944856,Lorain city, Ohio,0,2010,64128,35.8,71.3,11,30652,33476,38152,15018,974,240,0,48772,15356
39,61000,3961000,Parma city, Ohio,1,2010,81481,36.5,79.8,18.6,40239,41242,76126,1290,882,55,0,77300,4181
39,77000,3977000,Toledo city, Ohio,1,2010,286979,43.2,75.3,11.3,137574,149405,188690,76463,3237,696,441,265633,21346
39,88000,3988000,Youngstown city, Ohio,1,2010,66835,38.7,81.1,18.2,33987,32848,33272,29847,938,49,0,60353,6482
40,9050,4009050,Broken Arrow city, Oklahoma,1,2010,98523,41.7,72.9,10.2,49408,49115,81635,3099,1957,3761,0,91048,7475
40,23200,4023200,Edmond city, Oklahoma,1,2010,81696,43.1,75.8,9.6,39993,41703,65612,6272,4817,1431,0,79390,2306
40,41850,4041850,Lawton city, Oklahoma,1,2010,97832,48.1,75.1,9.8,50803,47029,58023,20720,2839,4863,786,85441,12391
40,52500,4052500,Norman city, Oklahoma,1,2010,111398,50.1,80.6,9.9,55715,55683,90353,3668,3718,4774,79,103937,7461
40,55000,4055000,Oklahoma City city, Oklahoma,1,2010,582278,42.7,74.8,11.6,287763,294515,384072,86539,20415,17743,747,480813,101465
40,75000,4075000,Tulsa city, Oklahoma,1,2010,393577,41.6,75.6,12.8,187877,205700,263536,62671,9757,16702,357,338311,55266
41,5350,4105350,Beaverton city, Oregon,1,2010,90150,44.3,77.3,9.8,44204,45946,68438,1561,11200,242,0,79026,11124
41,5800,4105800,Bend city, Oregon,1,2010,76723,42.2,78.3,14.3,36607,40116,72202,465,1195,298,0,72692,4031
41,23850,4123850,Eugene city, Oregon,1,2010,156299,46.9,82.6,14.4,77734,78565,136241,2286,6483,325,342,144204,12095
41,31250,4131250,Gresham city, Oregon,1,2010,105973,42.9,76.2,10.9,51948,54025,88530,3924,4537,1113,241,89180,16793
41,34100,4134100,Hillsboro city, Oregon,1,2010,91954,47.7,72.5,8.5,44877,47077,60448,1849,5941,2493,167,62169,29785
41,47000,4147000,Medford city, Oregon,1,2010,75007,38.2,79.1,17.5,35356,39651,69148,290,586,869,0,66044,8963
41,59000,4159000,Portland city, Oregon,1,2010,585429,48.3,80.5,10.6,290792,294637,445947,38867,43399,4486,3510,526443,58986
41,64900,4164900,Salem city, Oregon,1,2010,155004,40.2,76.9,12.8,76581,78423,122679,2132,4749,2016,2273,123404,31600
42,2000,4202000,Allentown city, Pennsylvania,1,2010,118240,43.5,73.3,11.8,57786,60454,81330,14313,1800,910,0,68647,49593
42,6088,4206088,Bethlehem city, Pennsylvania,1,2010,75233,45.1,80.5,14.7,35416,39817,58926,5284,2259,273,0,55883,19350
42,24000,4224000,Erie city, Pennsylvania,1,2010,101821,45.3,75.3,12,47241,54580,79269,16855,1405,68,0,95713,6108
42,60000,4260000,Philadelphia city, Pennsylvania,1,2010,1528306,45.7,77.5,12.2,721806,806500,634294,668961,97916,4659,224,1339803,188503
42,61000,4261000,Pittsburgh city, Pennsylvania,1,2010,305759,48.3,82.4,13.8,145942,159817,207892,72516,12342,391,43,298477,7282
42,63624,4263624,Reading city, Pennsylvania,1,2010,88175,45.1,68.9,9.9,43265,44910,47806,10070,947,456,0,37126,51049
42,69000,4269000,Scranton city, Pennsylvania,1,2010,76068,38.8,79.1,17.5,35698,40370,66279,4058,1936,132,190,68433,7635
44,19180,4419180,Cranston city, Rhode Island,1,2010,80424,37.6,79.4,14.4,39395,41029,69996,4390,2789,153,0,73724,6700
44,54640,4454640,Pawtucket city, Rhode Island,1,2010,71204,41.8,79.4,13.8,33723,37481,43175,15314,820,0,0,58228,12976
44,59000,4459000,Providence city, Rhode Island,1,2010,178162,54.7,77.2,8.6,86777,91385,86887,23338,11663,747,488,101517,76645
44,74300,4474300,Warwick city, Rhode Island,1,2010,82643,35.2,82.5,19.2,39418,43225,76413,981,2967,170,0,79877,2766
45,13330,4513330,Charleston city, South Carolina,1,2010,119834,49.7,82.5,13.5,56303,63531,85657,30599,1259,0,238,117289,2545
45,16000,4516000,Columbia city, South Carolina,1,2010,129139,56.6,84,8.9,66454,62685,68035,53725,3265,134,498,125188,3951
45,48535,4548535,Mount Pleasant town, South Carolina,1,2010,68112,39.9,76.2,10.8,32790,35322,-998,-998,-998,-998,-998,66919,1193
45,50875,4550875,North Charleston city, South Carolina,1,2010,95548,47.9,72.9,8.5,47096,48452,42831,43624,884,126,0,82238,13310
45,61405,4561405,Rock Hill city, South Carolina,1,2010,66395,48.5,77.1,10.7,31264,35131,-998,-998,-998,-998,-998,64417,1978
46,52980,4652980,Rapid City city, South Dakota,1,2010,68221,39,77.8,15.7,33731,34490,57534,828,243,6770,0,65527,2694
46,59020,4659020,Sioux Falls city, South Dakota,1,2010,153959,43.9,75.9,11.5,76757,77202,134156,6776,3507,4199,0,146813,7146
47,14000,4714000,Chattanooga city, Tennessee,1,2010,168075,42.1,78.7,14.7,79875,88200,99043,57097,4165,773,0,158019,10056
47,15160,4715160,Clarksville city, Tennessee,1,2010,133669,48.8,70.9,7.6,64762,68907,90168,30823,3348,1290,96,121647,12022
47,37640,4737640,Jackson city, Tennessee,0,2010,65279,42.3,74.4,12.9,30652,34627,30541,32456,510,37,290,62198,3081
47,40000,4740000,Knoxville city, Tennessee,1,2010,179226,46.2,80.8,14.2,85012,94214,136322,33164,2780,294,0,171322,7904
47,48000,4748000,Memphis city, Tennessee,1,2010,647870,43.3,74.6,10.4,308906,338964,192392,413002,9532,2047,44,607274,40596
47,51560,4751560,Murfreesboro city, Tennessee,1,2010,109220,52.9,77.7,8.9,52935,56285,82878,18068,4065,1174,0,104127,5093
47,52006,4752006,Nashville-Davidson metropolitan government (balance), Tennessee,1,2010,602618,47.2,78.4,10.3,291520,311098,370668,171881,17104,1196,0,541406,61212
48,1000,4801000,Abilene city, Texas,1,2010,119688,45.9,78.1,12.3,60757,58931,96443,11710,1270,475,37,89501,30187
48,1924,4801924,Allen city, Texas,1,2010,84888,42.8,69,5.6,39891,44997,63437,8714,9184,782,0,77700,7188
48,3000,4803000,Amarillo city, Texas,1,2010,194161,41.8,73.3,11.4,97566,96595,162264,13717,5589,941,406,138545,55616
48,4000,4804000,Arlington city, Texas,1,2010,367185,45.7,72.1,8,183376,183809,238985,70154,24122,941,152,259026,108159
48,4462,4804462,Atascocita CDP, Texas,0,2010,71245,48.9,70.4,5.4,36874,34371,49722,14875,2168,262,0,51320,19925
48,5000,4805000,Austin city, Texas,1,2010,795518,52.9,77.5,7.1,402614,392904,567292,63504,46891,4010,268,507388,288130
48,6128,4806128,Baytown city, Texas,1,2010,72418,44,73.3,8.2,36103,36315,46964,12100,862,931,0,41037,31381
48,7000,4807000,Beaumont city, Texas,1,2010,118355,44.5,75.3,12.2,58544,59811,49101,53747,3600,235,63,98914,19441
48,10768,4810768,Brownsville city, Texas,1,2010,175831,41.1,62.8,9.6,81698,94133,163125,344,1409,263,0,12627,163204
48,10912,4810912,Bryan city, Texas,1,2010,76541,50.5,74.9,8.7,38344,38197,52888,14675,430,359,0,49849,26692
48,13024,4813024,Carrollton city, Texas,1,2010,119759,41.3,74.1,9.3,58180,61579,85106,11045,14774,1329,184,82867,36892
48,15976,4815976,College Station city, Texas,1,2010,94246,71.4,86.4,5,49592,44654,73355,6093,8823,307,112,80360,13886
48,17000,4817000,Corpus Christi city, Texas,1,2010,305442,41,74,11.7,150686,154756,264705,13415,5287,625,375,124463,180979
48,19000,4819000,Dallas city, Texas,1,2010,1202797,46.8,73.7,9.1,605261,597536,641183,296743,34216,4567,397,690820,511977
48,19972,4819972,Denton city, Texas,1,2010,114100,59,82.7,7.8,56276,57824,86670,13055,5681,322,0,90625,23475
48,22660,4822660,Edinburg city, Texas,1,2010,77613,47.6,70.1,7.6,38300,39313,69024,1649,1520,408,0,9433,68180
48,24000,4824000,El Paso city, Texas,1,2010,652113,42.3,71.5,11.3,312507,339606,520798,22264,7400,4054,137,129022,523091
48,26232,4826232,Flower Mound town, Texas,0,2010,66238,37.4,65.4,4.4,30962,35276,-998,-998,-998,-998,-998,59109,7129
48,27000,4827000,Fort Worth city, Texas,1,2010,744114,45.1,71,8.1,367308,376806,466299,143169,26996,4386,137,494042,250072
48,27684,4827684,Frisco city, Texas,1,2010,117839,45.5,62.7,4.5,59651,58188,87340,10593,10281,323,116,99014,18825
48,29000,4829000,Garland city, Texas,1,2010,227604,42.5,71.2,8.3,111016,116588,106681,33003,18857,591,307,138713,88891
48,30464,4830464,Grand Prairie city, Texas,1,2010,176090,43.7,68.3,7.3,86389,89701,111491,27946,15281,887,0,101524,74566
48,32372,4832372,Harlingen city, Texas,0,2010,65124,39.6,74.1,14.1,31653,33471,59349,1003,1340,0,0,13546,51578
48,35000,4835000,Houston city, Texas,1,2010,2107208,46.4,74.3,9.2,1061518,1045690,1193414,500359,131075,10314,740,1189215,917993
48,37000,4837000,Irving city, Texas,1,2010,217139,50.3,70.9,6.1,106476,110663,142813,24989,28266,906,118,121179,95960
48,39148,4839148,Killeen city, Texas,1,2010,129070,50.8,69.5,5,62544,66526,67667,41429,5353,273,912,96394,32676
48,41464,4841464,Laredo city, Texas,1,2010,237244,45,64.9,7.6,114913,122331,221509,321,2123,610,0,10186,227058
48,41980,4841980,League City city, Texas,1,2010,83848,45.7,70.7,6.9,43421,40427,70839,6267,3321,0,0,68068,15780
48,42508,4842508,Lewisville city, Texas,1,2010,95691,49.2,75.6,6.7,48354,47337,72492,7598,7135,209,111,68617,27074
48,43888,4843888,Longview city, Texas,1,2010,80238,39.7,74.1,13.6,39161,41077,55478,18406,843,764,0,66527,13711
48,45000,4845000,Lubbock city, Texas,1,2010,230734,48.1,77.2,11.5,115461,115273,175848,18848,6239,1045,102,156070,74664
48,45384,4845384,McAllen city, Texas,1,2010,130767,44.3,72.5,10.6,64239,66528,114817,2067,4061,414,0,22059,108708
48,45744,4845744,McKinney city, Texas,1,2010,132147,45.3,67.6,7.1,62740,69407,109721,11306,4190,287,0,105090,27057
48,47892,4847892,Mesquite city, Texas,1,2010,140293,43.3,70.2,9.6,64668,75625,87271,36714,4642,392,0,100541,39752
48,48072,4848072,Midland city, Texas,1,2010,111238,42.3,71.2,11.1,53217,58021,93333,8589,1668,607,0,66788,44450
48,48768,4848768,Mission city, Texas,1,2010,77586,41.9,61.8,9,37526,40060,-998,-998,-998,-998,-998,8478,69108
48,48804,4848804,Missouri City city, Texas,1,2010,69052,41.1,71,7.8,32727,36325,29238,27474,8181,495,0,53296,15756
48,52356,4852356,North Richland Hills city, Texas,0,2010,63656,40.8,75.1,11.9,29406,34250,53646,1987,2770,33,0,54101,9555
48,53388,4853388,Odessa city, Texas,1,2010,99554,43.5,70.4,10.9,48518,51036,81677,6083,478,1815,61,50622,48932
48,56000,4856000,Pasadena city, Texas,1,2010,149722,41.9,69.1,9.1,71128,78594,100372,4750,3539,1389,0,55959,93763
48,56348,4856348,Pearland city, Texas,1,2010,90811,43.6,68.6,6.3,43849,46962,61479,13047,12802,296,53,70305,20506
48,57200,4857200,Pharr city, Texas,1,2010,70888,42.1,66.6,11.8,33358,37530,-998,-998,-998,-998,-998,4071,66817
48,58016,4858016,Plano city, Texas,1,2010,261697,40.2,74.5,8.8,129796,131901,180649,18883,45010,1521,271,222116,39581
48,61796,4861796,Richardson city, Texas,1,2010,99721,45.3,78.7,11.3,50306,49415,66108,8046,15751,972,0,87184,12537
48,63500,4863500,Round Rock city, Texas,1,2010,102441,46.4,68,5.2,50431,52010,86133,6623,2464,811,155,70451,31990
48,64472,4864472,San Angelo city, Texas,1,2010,93804,43.2,77,14.1,44980,48824,80476,4445,1108,168,330,57524,36280
48,65000,4865000,San Antonio city, Texas,1,2010,1334359,43.7,73.3,10.6,649633,684726,1013972,83132,29928,12549,1099,480705,853654
48,70808,4870808,Sugar Land city, Texas,1,2010,79472,36.1,76.4,10.2,39742,39730,42146,5745,28597,236,0,70958,8514
48,72176,4872176,Temple city, Texas,0,2010,66686,37.6,73.9,15.2,32542,34144,47703,12820,1429,0,17,53360,13326
48,72656,4872656,The Woodlands CDP, Texas,0,2010,92076,34.8,73.1,10.8,46223,45853,81376,1085,4936,197,0,79443,12633
48,74144,4874144,Tyler city, Texas,1,2010,97271,40.6,78.3,15.9,46314,50957,69500,21652,1319,79,0,75668,21603
48,76000,4876000,Waco city, Texas,1,2010,125410,47.3,74.6,11.4,58911,66499,90902,25393,1832,1055,0,84895,40515
48,79000,4879000,Wichita Falls city, Texas,1,2010,104699,44.3,76.4,12.6,55150,49549,82781,14110,2837,793,0,83545,21154
49,43660,4943660,Layton city, Utah,1,2010,67612,42.7,69.2,9.3,34689,32923,62076,671,1033,795,0,62848,4764
49,55980,4955980,Ogden city, Utah,1,2010,83171,47,72,9.5,42448,40723,62362,2098,1150,1273,337,61082,22089
49,57300,4957300,Orem city, Utah,1,2010,88929,49.9,69.9,7.9,43631,45298,77248,564,1340,392,930,74615,14314
49,62470,4962470,Provo city, Utah,1,2010,113196,66.4,77.8,5.6,56782,56414,97408,1573,1629,1654,1318,98592,14604
49,65330,4965330,St. George city, Utah,1,2010,73078,39,70.8,18.3,35914,37164,66395,77,1113,1097,393,64934,8144
49,67000,4967000,Salt Lake City city, Utah,1,2010,187215,50,75.3,10.8,92378,94837,150286,5644,5031,3276,1675,141664,45551
49,67440,4967440,Sandy city, Utah,1,2010,87818,41.3,71.8,9.1,44181,43637,-998,-998,-998,-998,-998,78569,9249
49,82950,4982950,West Jordan city, Utah,1,2010,104145,48,66,4.6,52518,51627,94520,164,2239,445,1138,85136,19009
49,83470,4983470,West Valley City city, Utah,1,2010,130026,43,66.4,7.3,64953,65073,101665,3428,7003,1626,4214,92325,37701
51,1000,5101000,Alexandria city, Virginia,1,2010,140912,51.2,82.9,9.1,69045,71867,89157,30208,8203,691,141,118199,22713
51,3000,5103000,Arlington CDP, Virginia,0,2010,209457,54.7,84.3,8.5,104870,104587,147171,17623,18944,1019,280,177720,31737
51,14440,5114440,Centreville CDP, Virginia,0,2010,77022,49.7,70.7,4.7,37912,39110,41636,6519,16607,2930,72,61897,15125
51,16000,5116000,Chesapeake city, Virginia,1,2010,222986,40.1,74.3,10.5,108448,114538,139675,67715,7354,1319,64,213286,9700
51,21088,5121088,Dale City CDP, Virginia,0,2010,62021,43.1,72.3,6.5,31448,30573,27857,17368,5124,255,0,46829,15192
51,35000,5135000,Hampton city, Virginia,1,2010,137381,42.3,77.3,12.4,65709,71672,59604,69332,3229,476,0,131117,6264
51,47672,5147672,Lynchburg city, Virginia,1,2010,75686,49.7,79.5,13.2,36504,39182,48099,22050,2244,47,0,74087,1599
51,56000,5156000,Newport News city, Virginia,1,2010,180712,45,75.9,10.5,87138,93574,90783,70643,3694,896,1674,167119,13593
51,57000,5157000,Norfolk city, Virginia,1,2010,243135,51.5,79.2,9.7,126067,117068,116707,107983,8352,746,884,226914,16221
51,64000,5164000,Portsmouth city, Virginia,1,2010,95696,41.2,76.4,13.4,46150,49546,39718,50598,1245,159,0,92682,3014
51,67000,5167000,Richmond city, Virginia,1,2010,204389,49.9,81.4,11.1,97377,107012,88900,101128,4811,697,0,191592,12797
51,68000,5168000,Roanoke city, Virginia,1,2010,96967,40.4,78.4,14.3,45860,51107,64439,27977,1124,88,0,91609,5358
51,76432,5176432,Suffolk city, Virginia,1,2010,84906,39.1,73.9,11.8,41328,43578,-998,-998,-998,-998,-998,84066,840
51,82000,5182000,Virginia Beach city, Virginia,1,2010,439172,44,76,10.7,214873,224299,303393,81771,27303,387,788,409966,29206
53,3180,5303180,Auburn city, Washington,1,2010,70873,42,76.1,8.5,35509,35364,48254,6984,6124,889,968,62340,8533
53,5210,5305210,Bellevue city, Washington,1,2010,122808,43,78,14.1,60383,62425,76220,4077,34879,782,339,115287,7521
53,5280,5305280,Bellingham city, Washington,1,2010,81067,54,83.8,12.3,40616,40451,70871,1187,2663,1557,48,74133,6934
53,22640,5322640,Everett city, Washington,1,2010,103321,47.4,77.6,8.6,51414,51907,76215,5713,7429,1133,269,83497,19824
53,57745,5357745,Renton city, Washington,1,2010,91259,47.1,77,9.2,46100,45159,42744,7016,16918,482,35,70602,20657
53,23515,5323515,Federal Way city, Washington,1,2010,89622,42.9,76.8,11.8,43631,45991,58468,6379,17440,634,736,78505,11117
53,35275,5335275,Kennewick city, Washington,1,2010,74455,42.6,70.5,9.9,36883,37572,55313,1115,1678,648,115,55361,19094
53,35415,5335415,Kent city, Washington,1,2010,92722,45.9,73.2,9.2,42865,49857,58844,7956,15312,638,2044,76456,16266
53,70000,5370000,Tacoma city, Washington,1,2010,198506,42.6,77.2,12.8,94236,104270,135145,22242,16343,2092,4102,177453,21053
53,63000,5363000,Seattle city, Washington,1,2010,610710,51.1,84.4,10.3,302316,308394,426223,49351,89475,5317,2841,573849,36861
53,67000,5367000,Spokane city, Washington,1,2010,209334,42.6,78.2,14.3,98976,110358,180843,6386,5828,3681,189,198320,11014
53,67167,5367167,Spokane Valley city, Washington,1,2010,89927,38.2,76.2,14.1,44407,45520,82913,386,1213,391,178,85634,4293
53,74060,5374060,Vancouver city, Washington,1,2010,162430,41,75.4,12.6,78100,84330,135664,4973,6791,1058,1762,146822,15608
53,80010,5380010,Yakima city, Washington,1,2010,91525,39.3,70.7,14.5,44964,46561,59381,912,580,2348,45,52627,38898
55,2375,5502375,Appleton city, Wisconsin,1,2010,71747,40.9,73.2,10.5,35192,36555,65231,141,3789,230,0,68603,3144
55,22300,5522300,Eau Claire city, Wisconsin,0,2010,65489,50.6,80.5,10.7,31857,33632,-998,-998,-998,-998,-998,64003,1486
55,31000,5531000,Green Bay city, Wisconsin,1,2010,104266,42.8,73.4,11.1,51805,52461,86044,2878,3574,3894,0,91692,12574
55,39225,5539225,Kenosha city, Wisconsin,1,2010,99362,44,73.8,11,47633,51729,81273,9534,1753,157,0,84742,14620
55,48000,5548000,Madison city, Wisconsin,1,2010,233777,53.6,82,9.3,115744,118033,188677,18063,16738,645,0,219715,14062
55,53000,5553000,Milwaukee city, Wisconsin,1,2010,595587,46.6,73.4,9,286670,308917,276773,233056,23229,2633,405,490968,104619
55,60500,5560500,Oshkosh city, Wisconsin,0,2010,66110,51.6,80.1,11.4,34790,31320,60454,2741,990,786,0,63340,2770
55,66000,5566000,Racine city, Wisconsin,1,2010,78906,42.7,71,11.1,38342,40564,50514,14472,418,123,0,62270,16636
55,84250,5584250,Waukesha city, Wisconsin,1,2010,70741,45.4,77,8.6,34332,36409,63602,1123,2488,0,0,63278,7463
72,10334,7210334,Caguas zona urbana, Puerto Rico,0,2010,81589,39.1,76.6,17.4,35280,46309,61829,4621,87,0,0,667,80922
72,14290,7214290,Carolina zona urbana, Puerto Rico,0,2010,160324,40.1,77.1,16.5,73458,86866,107516,22365,2510,707,0,2897,157427
72,32522,7232522,Guaynabo zona urbana, Puerto Rico,0,2010,72315,38.9,79.1,16.3,33456,38859,53519,6076,0,232,0,1204,71111
72,63820,7263820,Ponce zona urbana, Puerto Rico,0,2010,134788,39.2,75.3,16.2,62871,71917,93637,5637,129,0,0,861,133927
72,76770,7276770,San Juan zona urbana, Puerto Rico,0,2010,382900,40,78.6,17.1,175308,207592,229914,70821,5851,782,0,8856,374044
72,52431,7252431,Mayag√ºez zona urbana, Puerto Rico,0,2010,71129,43.1,79.4,18.4,33331,37798,36084,2980,357,0,0,1453,69676
72,6593,7206593,Bayam√≥n zona urbana, Puerto Rico,0,2010,187219,40.2,77.5,16.8,88240,98979,106310,20964,773,276,0,2483,184736
32,60600,3260600,Reno city, Nevada,1,2011,227509,43.8,77.1,12.1,117029,110480,171546,7905,13114,2055,1828,169911,57598
32,68400,3268400,Sparks city, Nevada,1,2011,91202,38.9,75.9,13.7,46436,44766,68663,2138,5401,1876,708,66029,25173
32,68585,3268585,Spring Valley CDP, Nevada,0,2011,191336,49.2,78.9,10.1,94592,96744,124842,16892,31343,732,1416,145723,45613
32,71400,3271400,Sunrise Manor CDP, Nevada,0,2011,181940,44.1,70.6,8.8,92688,89252,107767,21225,10148,1493,216,90611,91329
33,45140,3345140,Manchester city, New Hampshire,1,2011,109835,44.1,79.5,12.2,56156,53679,95486,4969,3752,307,27,100225,9610
33,50260,3350260,Nashua city, New Hampshire,1,2011,86702,38.5,77.7,12.7,42164,44538,73355,2383,5563,49,0,77695,9007
34,10000,3410000,Camden city, New Jersey,1,2011,77277,45.6,71,9.3,35903,41374,12427,34172,1251,124,47,38975,38302
34,13690,3413690,Clifton city, New Jersey,1,2011,84262,43.3,77.8,13.8,43398,40864,61141,4729,7460,300,242,56531,27731
34,19390,3419390,East Orange city, New Jersey,0,2011,64363,44,77,13,25046,39317,2945,58046,673,0,0,61002,3361
34,21000,3421000,Elizabeth city, New Jersey,1,2011,125662,45.8,72.6,9.8,61108,64554,52603,25087,3197,134,610,46499,79163
34,36000,3436000,Jersey City city, New Jersey,1,2011,250317,51.5,80.4,9.7,125168,125149,86009,62893,62771,1233,51,180757,69560
34,51000,3451000,Newark city, New Jersey,1,2011,277545,47.6,74,7.8,140926,136619,77546,142195,4318,792,108,185843,91702
34,56550,3456550,Passaic city, New Jersey,1,2011,69906,45,68.7,7.5,35008,34898,28302,5700,2922,787,0,17834,52072
34,57000,3457000,Paterson city, New Jersey,1,2011,146426,44.7,71.5,8.6,68561,77865,74676,45883,5192,451,83,63616,82810
34,73110,3473110,Toms River CDP, New Jersey,0,2011,89032,38.8,79.3,16.3,42823,46209,81047,1107,4440,159,0,80617,8415
34,74000,3474000,Trenton city, New Jersey,1,2011,84912,46.1,74.2,7.9,42710,42202,22752,45552,369,137,0,56409,28503
34,74630,3474630,Union City city, New Jersey,1,2011,67176,46.7,74.3,9.7,34536,32640,48195,1414,1190,120,0,9051,58125
35,2000,3502000,Albuquerque city, New Mexico,1,2011,552801,42.2,76.3,12.3,268747,284054,380518,18881,11796,25328,558,293192,259609
35,39380,3539380,Las Cruces city, New Mexico,1,2011,99661,45.6,76.4,13,48914,50747,89495,2812,1584,1021,3,41485,58176
35,63460,3563460,Rio Rancho city, New Mexico,1,2011,89214,38.8,72,11.2,44257,44957,72163,5913,1693,1040,0,54088,35126
35,70500,3570500,Santa Fe city, New Mexico,1,2011,68634,36.1,80,18.2,32210,36424,57874,770,1990,1021,0,36150,32484
36,1000,3601000,Albany city, New York,1,2011,97664,51.7,82.5,12.1,46115,51549,54083,31363,5853,352,0,90200,7464
36,11000,3611000,Buffalo city, New York,1,2011,261004,44.7,77.2,11.1,124748,136256,131274,96909,8238,1317,62,234640,26364
36,15000,3615000,Cheektowaga CDP, New York,0,2011,76902,39.5,81.3,17.5,35494,41408,66346,7650,1293,380,0,74433,2469
36,49121,3649121,Mount Vernon city, New York,1,2011,67789,42.9,74.7,12,29821,37968,14954,41254,1431,154,0,56622,11167
36,50617,3650617,New Rochelle city, New York,1,2011,77591,37.3,78.4,15.9,37837,39754,51557,14446,3265,140,0,59607,17984
36,51000,3651000,New York city, New York,1,2011,8244910,45.2,78.5,12.3,3925290,4319620,3618421,2054101,1051946,27390,4321,5871606,2373304
36,63000,3663000,Rochester city, New York,1,2011,210850,46.8,75.2,8.8,101831,109019,94135,84858,6412,1169,61,174656,36194
36,65508,3665508,Schenectady city, New York,1,2011,66276,44.1,75.2,12.3,32897,33379,42510,13822,3226,64,0,58233,8043
36,73000,3673000,Syracuse city, New York,1,2011,145150,47.3,77.6,11.2,68475,76675,82693,41500,8772,1773,33,134924,10226
36,84000,3684000,Yonkers city, New York,1,2011,197397,41.3,77.8,14.3,95733,101664,108837,36630,13340,415,0,127478,69919
37,2140,3702140,Asheville city, North Carolina,1,2011,84458,42.6,79.6,15.1,38771,45687,68767,10998,1576,631,66,78429,6029
37,10740,3710740,Cary town, North Carolina,1,2011,138926,41.4,73.6,10.1,68426,70500,98871,10413,20246,943,0,124810,14116
37,12000,3712000,Charlotte city, North Carolina,1,2011,751074,46.6,74.7,9,360553,390521,405266,256410,37653,2238,349,651216,99858
37,14100,3714100,Concord city, North Carolina,1,2011,80604,41.2,72.6,10.4,38397,42207,58697,15488,2597,473,0,71403,9201
37,19000,3719000,Durham city, North Carolina,1,2011,233210,47.8,76.9,9.1,109615,123595,113206,94775,10877,1292,0,200535,32675
37,22920,3722920,Fayetteville city, North Carolina,1,2011,203922,46.2,73.5,9.9,99206,104716,98577,83083,6923,1731,1171,182790,21132
37,25580,3725580,Gastonia city, North Carolina,1,2011,72061,41.8,74.3,11.8,34304,37757,42042,19445,615,512,0,61508,10553
37,28000,3728000,Greensboro city, North Carolina,1,2011,273419,46.1,78,11.4,127597,145822,136542,112753,9596,1468,306,253442,19977
37,28080,3728080,Greenville city, North Carolina,1,2011,86024,60.4,82.4,7.3,37671,48353,48771,30733,2822,621,0,82684,3340
37,31400,3731400,High Point city, North Carolina,1,2011,107089,42.8,74.7,11.5,49791,57298,62496,31501,8466,286,0,95872,11217
37,34200,3734200,Jacksonville city, North Carolina,1,2011,70797,61.1,75.4,5.8,42010,28787,47184,17677,949,503,396,60886,9911
37,55000,3755000,Raleigh city, North Carolina,1,2011,416126,51,76.2,7.9,201006,215120,253036,129952,13883,425,0,369502,46624
37,74440,3774440,Wilmington city, North Carolina,1,2011,108305,47.2,81.4,13.6,51343,56962,77803,26378,1042,476,77,102961,5344
37,75000,3775000,Winston-Salem city, North Carolina,1,2011,232397,41.8,75.7,13.5,108495,123902,140383,80196,4372,544,0,196209,36188
38,25700,3825700,Fargo city, North Dakota,1,2011,107325,51.3,80.1,9.4,50950,56375,96519,2651,3056,2112,0,104130,3195
39,1000,3901000,Akron city, Ohio,1,2011,198415,41.9,77.6,12.6,94249,104166,121675,62416,4735,1001,0,194221,4194
39,12000,3912000,Canton city, Ohio,1,2011,72925,38.5,72.3,12.3,32834,40091,-998,-998,-998,-998,-998,71242,1683
39,15000,3915000,Cincinnati city, Ohio,1,2011,296236,44.7,77.8,11.5,139314,156922,147940,131806,6440,465,0,287979,8257
39,16000,3916000,Cleveland city, Ohio,1,2011,393804,41,77.7,12.6,188327,205477,162831,203289,5805,1130,256,356130,37674
39,18000,3918000,Columbus city, Ohio,1,2011,796014,49,76.7,8.9,388935,407079,495089,220045,31297,1885,73,752364,43650
39,21000,3921000,Dayton city, Ohio,1,2011,142154,45.1,78.9,13.1,68962,73192,77090,57300,1711,684,0,137258,4896
39,44856,3944856,Lorain city, Ohio,0,2011,64155,35.6,74.5,14.9,31131,33024,45379,9019,525,174,105,48193,15962
39,61000,3961000,Parma city, Ohio,1,2011,80980,38.6,77.3,16.8,39436,41544,74937,1198,1585,28,0,76591,4389
39,77000,3977000,Toledo city, Ohio,1,2011,286033,42.1,75.9,12.6,139578,146455,184418,75953,3148,783,79,265252,20781
39,88000,3988000,Youngstown city, Ohio,1,2011,66545,37.5,79,16.2,32136,34409,32491,30024,499,265,0,60890,5655
40,9050,4009050,Broken Arrow city, Oklahoma,1,2011,103118,38.7,73.8,11,51007,52111,79269,6376,3342,4504,170,96677,6441
40,23200,4023200,Edmond city, Oklahoma,1,2011,82961,40.9,76.3,12,41532,41429,68414,5453,2436,1649,0,76870,6091
40,41850,4041850,Lawton city, Oklahoma,1,2011,98180,48.1,74.8,10.4,50018,48162,59233,20479,2854,3526,87,84661,13519
40,52500,4052500,Norman city, Oklahoma,1,2011,113274,52.3,80.4,10.8,55487,57787,90063,5757,3492,5085,35,106353,6921
40,55000,4055000,Oklahoma City city, Oklahoma,1,2011,591912,42.5,74.2,11,293977,297935,399643,86804,24302,20532,752,488572,103340
40,75000,4075000,Tulsa city, Oklahoma,1,2011,396039,41.7,75.6,12.3,191456,204583,267336,59529,9186,17605,369,337780,58259
41,5350,4105350,Beaverton city, Oregon,1,2011,91641,46.2,75.2,10.2,43121,48520,63993,3646,11412,299,553,77316,14325
41,5800,4105800,Bend city, Oregon,1,2011,77907,39.6,80,15.7,38954,38953,68659,383,1728,183,532,70649,7258
41,23850,4123850,Eugene city, Oregon,1,2011,156921,50,82.2,13.4,77287,79634,137625,1237,6009,2715,213,144421,12500
41,31250,4131250,Gresham city, Oregon,1,2011,107439,40.1,73.7,11.3,51565,55874,86825,2828,4017,691,3429,89189,18250
41,34100,4134100,Hillsboro city, Oregon,1,2011,93452,49.2,75.1,7.7,45342,48110,65815,1166,6949,2713,1929,69308,24144
41,47000,4147000,Medford city, Oregon,1,2011,75509,41.8,78.3,15.5,36433,39076,69193,693,1127,586,567,66679,8830
41,59000,4159000,Portland city, Oregon,1,2011,595325,48.1,80.5,10.2,295365,299960,459255,38559,45977,5184,1254,535024,60301
41,64900,4164900,Salem city, Oregon,1,2011,156265,40.5,73.3,12.7,76298,79967,121717,2724,4728,1662,1224,126187,30078
42,2000,4202000,Allentown city, Pennsylvania,1,2011,119142,43.6,73.3,11.3,56847,62295,81372,15492,2653,0,0,68937,50205
42,6088,4206088,Bethlehem city, Pennsylvania,1,2011,76124,44.7,79.8,15.5,37042,39082,60609,4533,1636,159,0,57256,18868
42,24000,4224000,Erie city, Pennsylvania,1,2011,101791,42.3,77.4,12.8,49119,52672,77860,15831,2058,489,0,94392,7399
42,60000,4260000,Philadelphia city, Pennsylvania,1,2011,1536471,45.5,77.5,12.1,725192,811279,643228,651692,99154,2814,478,1342937,193534
42,61000,4261000,Pittsburgh city, Pennsylvania,1,2011,307498,47.5,83.4,14.4,149140,158358,201448,81062,14404,581,136,300186,7312
42,63624,4263624,Reading city, Pennsylvania,1,2011,88422,43,70,10.5,42072,46350,46171,11874,479,197,29,36755,51667
42,69000,4269000,Scranton city, Pennsylvania,1,2011,75995,40.6,80.7,17,35072,40923,65497,5076,2254,22,0,69682,6313
44,19180,4419180,Cranston city, Rhode Island,1,2011,80401,39.3,78.6,14.9,40759,39642,64272,5061,3203,1262,0,70171,10230
44,54640,4454640,Pawtucket city, Rhode Island,1,2011,71151,39.4,76.8,13.6,35325,35826,47539,10025,1814,162,0,56882,14269
44,59000,4459000,Providence city, Rhode Island,1,2011,178059,52.6,77.4,8.7,85247,92812,91939,27329,10760,1889,172,109000,69059
44,74300,4474300,Warwick city, Rhode Island,1,2011,82354,37.2,80,16.6,39094,43260,75661,1386,2221,57,0,78696,3658
45,13330,4513330,Charleston city, South Carolina,1,2011,123240,50.1,81.3,11.4,56593,66647,81797,36299,2120,236,404,119680,3560
45,16000,4516000,Columbia city, South Carolina,1,2011,130092,57.2,84.7,10.4,66780,63312,65883,54037,2590,214,7,122824,7268
45,48535,4548535,Mount Pleasant town, South Carolina,1,2011,69353,40.4,73.7,13.9,34025,35328,-998,-998,-998,-998,-998,67587,1766
45,50875,4550875,North Charleston city, South Carolina,1,2011,101478,46.7,76,8.2,50141,51337,49088,45617,2528,678,0,93165,8313
45,61405,4561405,Rock Hill city, South Carolina,1,2011,67411,49.7,75.8,9.5,30428,36983,38858,24389,775,200,0,62557,4854
46,52980,4652980,Rapid City city, South Dakota,1,2011,69202,38.4,74.9,14.8,33012,36190,55216,505,291,8124,46,66362,2840
46,59020,4659020,Sioux Falls city, South Dakota,1,2011,156284,43.8,75.8,11.5,77106,79178,136091,6810,2869,3689,0,149208,7076
47,14000,4714000,Chattanooga city, Tennessee,1,2011,170136,40.9,78.4,15,81028,89108,97766,59884,3862,809,86,159285,10851
47,15160,4715160,Clarksville city, Tennessee,1,2011,136237,49.5,73.4,8.7,65632,70605,90295,31571,3049,2000,667,122867,13370
47,37640,4737640,Jackson city, Tennessee,0,2011,65189,41,74.8,13,30457,34732,31533,30563,1135,36,76,61929,3260
47,40000,4740000,Knoxville city, Tennessee,1,2011,180753,48.2,81.7,13.2,89578,91175,140807,30213,2742,331,41,170615,10138
47,48000,4748000,Memphis city, Tennessee,1,2011,652078,44.2,75,10.4,310415,341663,193044,406606,13323,1180,0,604799,47279
47,51560,4751560,Murfreesboro city, Tennessee,1,2011,111337,50.9,80.3,10.6,55356,55981,87924,17082,2209,95,0,106139,5198
47,52006,4752006,Nashville-Davidson metropolitan government (balance), Tennessee,1,2011,609637,46.9,78.1,10.3,295606,314031,367204,173224,18054,1922,310,547815,61822
48,1000,4801000,Abilene city, Texas,1,2011,123471,46.3,78.3,12.2,63742,59729,100588,13207,2559,425,0,94743,28728
48,1924,4801924,Allen city, Texas,1,2011,87476,39.5,72.3,7.1,40460,47016,63446,5356,11477,377,81,77401,10075
48,3000,4803000,Amarillo city, Texas,1,2011,194701,41.3,72.9,12.2,95524,99177,160918,12498,6114,1265,286,136117,58584
48,4000,4804000,Arlington city, Texas,1,2011,373681,46.4,72.2,7.8,185705,187976,239090,74329,32228,1874,285,261659,112022
48,4462,4804462,Atascocita CDP, Texas,0,2011,72363,51.3,71.7,6.8,35648,36715,45648,19207,2147,0,0,59376,12987
48,5000,4805000,Austin city, Texas,1,2011,820601,53,78,7,414143,406458,576084,65132,52658,6387,243,522800,297801
48,6128,4806128,Baytown city, Texas,1,2011,71819,40.7,68.5,8.8,34546,37273,45722,15234,931,358,128,39771,32048
48,7000,4807000,Beaumont city, Texas,1,2011,118532,39.9,75.6,12.9,57119,61413,47198,57219,4487,120,104,102798,15734
48,10768,4810768,Brownsville city, Texas,1,2011,178448,40.7,66.3,10.3,85807,92641,159324,218,1768,470,0,11979,166469
48,10912,4810912,Bryan city, Texas,1,2011,77315,47.7,77.7,9.7,39321,37994,51658,14396,1727,158,0,47187,30128
48,13024,4813024,Carrollton city, Texas,1,2011,122656,43.5,76.7,9.6,61539,61117,85458,10901,15774,513,0,81772,40884
48,15976,4815976,College Station city, Texas,1,2011,95147,73.3,84.1,3.7,49685,45462,74586,5784,9060,0,0,83534,11613
48,17000,4817000,Corpus Christi city, Texas,1,2011,307954,40.9,74.1,11.6,150145,157809,265310,13712,5092,1752,85,122112,185842
48,19000,4819000,Dallas city, Texas,1,2011,1223378,46.2,73.5,8.9,613811,609567,693636,288824,31117,3821,213,686564,536814
48,19972,4819972,Denton city, Texas,1,2011,117177,56.8,80.4,8.1,56785,60392,87272,14125,5324,192,441,88768,28409
48,22660,4822660,Edinburg city, Texas,1,2011,79156,48,69.3,5.6,42222,36934,71248,1331,1779,0,0,8610,70546
48,24000,4824000,El Paso city, Texas,1,2011,665577,42.3,71.7,11.2,317490,348087,543742,20308,8712,2527,1164,131232,534345
48,26232,4826232,Flower Mound town, Texas,0,2011,67209,36.8,65.9,5.2,33010,34199,-998,-998,-998,-998,-998,64260,2949
48,27000,4827000,Fort Worth city, Texas,1,2011,760758,44.9,70.2,8.3,363677,397081,534458,135076,24996,9808,503,495739,265019
48,27684,4827684,Frisco city, Texas,1,2011,121389,47.9,65.8,4.9,61611,59778,95602,10540,8658,1058,0,108550,12839
48,29000,4829000,Garland city, Texas,1,2011,231596,42.9,68.5,9.5,114138,117458,95290,27537,24679,305,151,136155,95441
48,30464,4830464,Grand Prairie city, Texas,1,2011,179067,45.9,70.2,6.3,93436,85631,113883,36045,11316,1019,39,107016,72051
48,32372,4832372,Harlingen city, Texas,0,2011,66124,41,67,11.9,31964,34160,61962,1220,267,53,0,14006,52118
48,35000,4835000,Houston city, Texas,1,2011,2145933,46.4,74.3,9.1,1073270,1072663,1241459,494272,120373,7295,1375,1192419,953514
48,37000,4837000,Irving city, Texas,1,2011,220699,48.9,73.6,7.4,112389,108310,126072,29382,31677,745,26,133046,87653
48,39148,4839148,Killeen city, Texas,1,2011,130005,49.1,69.1,4.6,62007,67998,68116,38941,5323,1692,248,100527,29478
48,41464,4841464,Laredo city, Texas,1,2011,241350,44.2,65.7,8.3,116681,124669,224378,316,2344,1541,0,11642,229708
48,41980,4841980,League City city, Texas,1,2011,83999,40.8,69.7,8,42555,41444,68462,8491,4041,0,0,71451,12548
48,42508,4842508,Lewisville city, Texas,1,2011,98489,45.1,71.5,8.4,48103,50386,78433,4886,6260,0,0,64193,34296
48,43888,4843888,Longview city, Texas,1,2011,82278,42.4,73.7,14.3,40840,41438,59154,19148,1275,237,0,68091,14187
48,45000,4845000,Lubbock city, Texas,1,2011,233735,48.2,76.7,11.1,115582,118153,181677,18405,5800,1785,293,156267,77468
48,45384,4845384,McAllen city, Texas,1,2011,133756,44.3,71.8,11.9,64421,69335,119181,1675,3694,489,0,24627,109129
48,45744,4845744,McKinney city, Texas,1,2011,136073,42.8,68.7,6.6,66047,70026,105599,15532,9477,795,0,109634,26439
48,47892,4847892,Mesquite city, Texas,1,2011,142574,43.3,70.7,8.2,63971,78603,90732,36468,5695,564,0,99990,42584
48,48072,4848072,Midland city, Texas,1,2011,113928,41.7,72.8,11.7,54858,59070,93617,9901,2518,302,10,69982,43946
48,48768,4848768,Mission city, Texas,1,2011,79375,42.3,66.6,11,38142,41233,-998,-998,-998,-998,-998,8368,71007
48,48804,4848804,Missouri City city, Texas,1,2011,68776,36.3,71.9,10.7,32801,35975,24108,31108,10623,363,0,58846,9930
48,52356,4852356,North Richland Hills city, Texas,0,2011,64786,42,75.4,11.6,31370,33416,59042,2305,1047,210,0,53264,11522
48,53388,4853388,Odessa city, Texas,1,2011,102841,42,71.1,9.4,51856,50985,87648,6140,526,403,48,49805,53036
48,56000,4856000,Pasadena city, Texas,1,2011,152295,43.8,70,7.7,77152,75143,109354,4541,5381,2790,0,62002,90293
48,56348,4856348,Pearland city, Texas,1,2011,95644,40.4,70.9,9.4,46376,49268,62633,11041,14500,773,0,74229,21415
48,57200,4857200,Pharr city, Texas,1,2011,72513,46.3,66.3,8.8,34681,37832,-998,-998,-998,-998,-998,4567,67946
48,58016,4858016,Plano city, Texas,1,2011,271380,41.9,74.6,9.8,138001,133379,187349,19388,51580,851,209,235888,35492
48,61796,4861796,Richardson city, Texas,1,2011,101731,45.1,75.5,10.4,51919,49812,66137,4223,16711,208,974,80416,21315
48,63500,4863500,Round Rock city, Texas,1,2011,106128,45.4,69.9,4.6,49268,56860,84651,10728,4885,1023,0,72267,33861
48,64472,4864472,San Angelo city, Texas,1,2011,95818,43.4,76.1,13.6,47033,48785,81477,5130,1089,723,0,58982,36836
48,65000,4865000,San Antonio city, Texas,1,2011,1359730,43.8,73.6,10.8,660182,699548,1028684,92378,26871,8113,1346,509384,850346
48,70808,4870808,Sugar Land city, Texas,1,2011,81698,36.1,75.7,10.4,39716,41982,42429,6321,27807,266,0,68999,12699
1,7000,107000,Birmingham city, Alabama,1,2011,211458,41.3,78.7,13.2,96988,114470,50140,156177,2594,751,0,206136,5322
1,21184,121184,Dothan city, Alabama,0,2011,66384,38.8,76.2,15.2,31562,34822,42748,20539,652,285,17,64766,1618
1,35896,135896,Hoover city, Alabama,1,2011,80553,39.3,76.5,12,38826,41727,59020,7241,5355,525,0,72434,8119
1,37000,137000,Huntsville city, Alabama,1,2011,182354,41.3,78.6,14.1,87509,94845,114080,55038,3313,1070,28,170714,11640
1,50000,150000,Mobile city, Alabama,1,2011,194887,42.1,76.5,13.5,93181,101706,89656,98966,2286,302,112,189599,5288
1,51000,151000,Montgomery city, Alabama,1,2011,213132,43.5,74.8,11.9,99465,113667,83403,120140,4839,1045,0,204979,8153
1,77256,177256,Tuscaloosa city, Alabama,1,2011,91604,57,84.2,11.3,40897,50707,-998,-998,-998,-998,-998,87926,3678
2,3000,203000,Anchorage municipality, Alaska,1,2011,295570,45,74.3,7.7,148299,147271,196444,16294,23872,19194,6145,272295,23275
4,4720,404720,Avondale city, Arizona,1,2011,77526,50,67.4,6.1,36926,40600,-998,-998,-998,-998,-998,33738,43788
4,10670,410670,Casas Adobes CDP, Arizona,0,2011,67496,37,78.9,17.3,31751,35745,61269,874,2104,233,58,55687,11809
4,12000,412000,Chandler city, Arizona,1,2011,240098,43.6,72.1,7.6,119460,120638,195297,13698,15075,2797,262,184261,55837
4,23620,423620,Flagstaff city, Arizona,0,2011,65904,56.2,78.4,6.4,32208,33696,46911,1242,1241,8112,42,53359,12545
4,27400,427400,Gilbert town, Arizona,1,2011,211964,44.8,65.8,6.1,105466,106498,180564,6630,15131,1278,219,168587,43377
4,27820,427820,Glendale city, Arizona,1,2011,230466,45.1,74.4,8.9,115974,114492,174808,9681,8234,1303,0,145276,85190
4,28380,428380,Goodyear city, Arizona,0,2011,66312,38.5,81,18,33299,33013,52616,6860,3349,340,0,51505,14807
4,46000,446000,Mesa city, Arizona,1,2011,446498,40.1,75,14.4,219468,227030,362570,21188,7929,9764,2270,331357,115141
4,54050,454050,Peoria city, Arizona,1,2011,156634,38.6,76.6,13.6,76777,79857,138662,5275,4179,1288,0,129957,26677
4,55000,455000,Phoenix city, Arizona,1,2011,1469484,44.8,72.4,8.6,739978,729506,1147215,94911,49531,29628,3030,878340,591144
4,64210,464210,San Tan Valley CDP, Arizona,0,2011,83217,47.5,64.2,3.7,44261,38956,63801,5012,0,4226,0,66329,16888
4,65000,465000,Scottsdale city, Arizona,1,2011,221007,33.9,82.9,23.4,103935,117072,198187,3354,8140,3028,0,198609,22398
4,71510,471510,Surprise city, Arizona,1,2011,119494,38.3,65.8,16.4,57023,62471,-998,-998,-998,-998,-998,95962,23532
4,73000,473000,Tempe city, Arizona,1,2011,164264,56.8,81.1,7.4,82935,81329,127556,10375,11790,1759,1388,130333,33931
4,77000,477000,Tucson city, Arizona,1,2011,525798,44.9,77.7,12,262747,263051,403863,27174,14131,10484,735,303709,222089
4,85540,485540,Yuma city, Arizona,1,2011,94543,44.8,71.7,13.6,47399,47144,66309,2910,1842,1096,54,40997,53546
5,23290,523290,Fayetteville city, Arkansas,1,2011,75109,58.1,83.1,8.7,38204,36905,63458,3887,3710,1089,52,71507,3602
5,24550,524550,Fort Smith city, Arkansas,1,2011,87146,39.1,74.7,12.8,43404,43742,67868,7431,4747,608,227,72691,14455
5,35710,535710,Jonesboro city, Arkansas,1,2011,68541,46.4,74.5,11,33333,35208,-998,-998,-998,-998,-998,66078,2463
5,41000,541000,Little Rock city, Arkansas,1,2011,195310,42.3,76.4,11.6,90708,104602,96447,86184,6046,277,108,185256,10054
5,66080,566080,Springdale city, Arkansas,1,2011,73153,40.9,67.1,9.3,37320,35833,46331,1490,1184,1530,5224,44662,28491
6,562,600562,Alameda city, California,1,2011,74770,41.1,80.4,12.2,37167,37603,37530,6044,23652,86,29,65381,9389
6,884,600884,Alhambra city, California,1,2011,83703,40,81.7,14,39846,43857,23363,1403,44697,167,178,57486,26217
6,2000,602000,Anaheim city, California,1,2011,341348,45.1,73.3,10,171201,170147,214952,9183,51707,1457,640,156853,184495
6,2252,602252,Antioch city, California,1,2011,104027,42.2,74.9,8.4,49606,54421,60651,15737,7520,719,269,71246,32781
6,2364,602364,Apple Valley town, California,1,2011,70173,37.4,72.2,13.7,32728,37445,57299,5502,1892,250,0,50993,19180
6,2553,602553,Arden-Arcade CDP, California,0,2011,91977,37,78.5,15.3,44897,47080,67360,6405,6206,1005,53,75981,15996
6,3526,603526,Bakersfield city, California,1,2011,352429,44.2,68.9,8.1,176625,175804,248289,28606,24328,3936,927,189935,162494
6,3666,603666,Baldwin Park city, California,1,2011,75937,49.1,71.9,8.3,37372,38565,29162,545,14034,593,58,16554,59383
6,4982,604982,Bellflower city, California,1,2011,77179,45.8,68,6.9,35942,41237,29837,12929,7071,223,589,35571,41608
6,6000,606000,Berkeley city, California,1,2011,113893,54.3,87.5,13.9,56611,57282,73164,9894,22126,240,196,102714,11179
6,8786,608786,Buena Park city, California,1,2011,81754,43.6,75,12.4,40679,41075,48000,4106,22202,49,535,51176,30578
6,8954,608954,Burbank city, California,1,2011,104096,44.2,79.1,13.9,48478,55618,77361,1163,13130,87,24,74772,29324
6,10046,610046,Camarillo city, California,0,2011,65904,37.6,73.1,15.3,31558,34346,49198,830,4952,195,182,47775,18129
6,11194,611194,Carlsbad city, California,1,2011,106895,37.4,76.5,16,54052,52843,91253,359,8522,524,0,91899,14996
6,11530,611530,Carson city, California,1,2011,92387,40.8,77.1,13.8,43546,48841,31468,18492,19833,359,1471,52983,39404
6,13014,613014,Chico city, California,1,2011,86287,50.6,80.4,11.2,41147,45140,70255,2194,2701,615,75,71589,14698
6,13210,613210,Chino city, California,1,2011,79061,47.3,74.7,10.4,40100,38961,46574,4133,12094,861,148,41619,37442
6,13214,613214,Chino Hills city, California,1,2011,75931,40.5,71.7,6.6,39449,36482,44559,3156,19447,358,178,50451,25480
6,13392,613392,Chula Vista city, California,1,2011,247514,44.5,73.6,10.1,118413,129101,163601,9768,39608,2114,584,105193,142321
6,13588,613588,Citrus Heights city, California,1,2011,84342,41.2,76.6,11.3,39262,45080,64186,2103,2106,1043,2442,68087,16255
6,14218,614218,Clovis city, California,1,2011,96909,40.1,72,10.1,46057,50852,66742,1963,12007,1187,54,72809,24100
6,15044,615044,Compton city, California,1,2011,97166,45.3,68.2,7.8,46630,50536,39525,28295,555,0,288,31755,65411
6,16000,616000,Concord city, California,1,2011,124059,41.8,76.4,11.5,63511,60548,85916,3911,16319,983,1473,89624,34435
6,16350,616350,Corona city, California,1,2011,155884,45.4,71.1,7.5,77945,77939,107921,9741,17967,753,2373,93861,62023
6,16532,616532,Costa Mesa city, California,1,2011,111603,48.1,78.9,9.5,53111,58492,75935,1428,8532,126,230,74818,36785
6,17918,617918,Daly City city, California,1,2011,102368,44.1,80.8,13.9,53270,49098,23757,2951,62551,326,109,81329,21039
6,18100,618100,Davis city, California,0,2011,66011,58.3,84.4,8.2,32276,33735,39274,1206,15613,451,254,56653,9358
6,19766,619766,Downey city, California,1,2011,112578,43.6,73.2,9.8,56342,56236,74346,4398,5654,181,0,32065,80513
6,20802,620802,East Los Angeles CDP, California,0,2011,131741,49.5,70.4,8.3,67452,64289,78336,1043,810,488,0,2900,128841
6,21712,621712,El Cajon city, California,1,2011,100931,43.1,74.8,12.4,49631,51300,86238,3888,2105,290,695,73836,27095
6,22020,622020,Elk Grove city, California,1,2011,154920,42.2,72.8,10.3,75207,79713,75547,17186,36178,383,1235,125090,29830
6,22230,622230,El Monte city, California,1,2011,114294,46.7,73.9,10.7,56803,57491,59758,1007,29588,498,0,34646,79648
6,22804,622804,Escondido city, California,1,2011,146021,45.6,73.8,8.7,74701,71320,120742,3320,9247,388,130,72324,73697
6,23182,623182,Fairfield city, California,1,2011,106116,45.6,73,10.4,50467,55649,47394,19159,18445,314,1316,79144,26972
6,24477,624477,Florence-Graham CDP, California,0,2011,68626,49,64.5,5.7,33098,35528,49622,4426,53,257,0,4786,63840
6,24638,624638,Folsom city, California,1,2011,72991,44.2,77.1,7.8,40563,32428,54934,2937,7396,90,112,60244,12747
6,24680,624680,Fontana city, California,1,2011,199024,47.6,70.4,6.4,100883,98141,127543,16583,10410,640,42,62546,136478
6,26000,626000,Fremont city, California,1,2011,216912,42.3,74.6,10.4,108853,108059,66993,8247,105587,1291,600,178897,38015
6,27000,627000,Fresno city, California,1,2011,501365,45,70.3,9.2,249398,251967,249032,35612,63800,4221,1561,257031,244334
6,28000,628000,Fullerton city, California,1,2011,137174,42.7,75.5,13,65777,71397,75831,2718,32675,730,150,89934,47240
6,29000,629000,Garden Grove city, California,1,2011,173490,44.5,74.8,9.9,88141,85349,81697,3308,70470,872,1894,112380,61110
6,30000,630000,Glendale city, California,1,2011,193113,38.8,81.6,15.9,92185,100928,152920,1640,29563,846,52,158555,34558
6,32548,632548,Hawthorne city, California,1,2011,84897,49.6,71.2,6.6,39003,45894,49766,21299,3435,243,1047,37038,47859
6,33000,633000,Hayward city, California,1,2011,146083,45.2,76.7,9.4,71031,75052,57244,15970,33303,349,6321,87393,58690
6,33182,633182,Hemet city, California,1,2011,80459,32.9,76.8,25.6,39058,41401,57209,4550,2091,671,79,51249,29210
6,33434,633434,Hesperia city, California,1,2011,91549,39,67.3,9.3,47982,43567,59072,8980,1417,1903,130,51445,40104
6,36000,636000,Huntington Beach city, California,1,2011,192868,38.7,81.5,15.7,94760,98108,148558,1615,20876,1570,293,157539,35329
6,36448,636448,Indio city, California,1,2011,77789,38.7,69.2,13.6,36229,41560,46924,951,1207,1380,0,24615,53174
6,36546,636546,Inglewood city, California,1,2011,110463,42.9,72.4,9.7,51575,58888,34098,48324,2578,548,224,55181,55282
6,36770,636770,Irvine city, California,1,2011,215511,48.6,77,7.3,104508,111003,114571,3780,79380,1305,286,193148,22363
6,39496,639496,Lake Forest city, California,1,2011,78460,42,74.4,9.4,37220,41240,48307,1401,15025,130,536,60621,17839
6,39892,639892,Lakewood city, California,1,2011,80648,41.9,77,11.3,38477,42171,40753,5783,12449,374,525,51809,28839
6,40130,640130,Lancaster city, California,1,2011,157698,43.4,71.3,7.8,81658,76040,100799,30153,6790,855,192,94826,62872
6,41992,641992,Livermore city, California,1,2011,82056,39.2,75,11,43818,38238,65197,1764,10502,21,131,69664,12392
6,43000,643000,Long Beach city, California,1,2011,465584,46.2,74.8,9.3,227873,237711,243830,65958,54359,2518,4812,275878,189706
6,44000,644000,Los Angeles city, California,1,2011,3819708,47,77.6,10.7,1900599,1919109,2043821,353111,442855,19263,7091,1968304,1851404
6,44574,644574,Lynwood city, California,1,2011,70259,48.9,67.4,6.6,34640,35619,22311,5295,520,428,0,6367,63892
6,45484,645484,Manteca city, California,1,2011,68254,40.3,68.2,9.9,33372,34882,49180,3183,4390,352,607,43573,24681
6,46842,646842,Menifee city, California,1,2011,79321,36.9,78.2,17.8,40477,38844,62313,2907,7478,306,177,60803,18518
6,46898,646898,Merced city, California,1,2011,80234,48.6,69.7,8.7,38833,41401,50049,4980,10732,778,91,40858,39376
6,47766,647766,Milpitas city, California,1,2011,67811,43.7,78.2,9.8,35288,32523,14596,2254,41309,525,655,56481,11330
6,48256,648256,Mission Viejo city, California,1,2011,94714,37.9,78.7,14.8,47016,47698,77728,1166,7961,202,37,77650,17064
6,48354,648354,Modesto city, California,1,2011,202761,41,72.8,12.1,97439,105322,151965,8486,14102,2760,1855,129144,73617
6,49270,649270,Moreno Valley city, California,1,2011,197838,44.4,67,6.5,96136,101702,131461,36468,9451,2957,450,85778,112060
6,49670,649670,Mountain View city, California,1,2011,75230,47.1,78.7,12.7,38705,36525,48279,1889,18470,187,391,58771,16459
6,50076,650076,Murrieta city, California,1,2011,105847,41.7,69.5,9.9,48128,57719,73957,11631,3715,838,0,74876,30971
6,50258,650258,Napa city, California,1,2011,77868,40.9,76.3,12.8,38845,39023,67766,483,2354,559,60,48075,29793
6,51182,651182,Newport Beach city, California,1,2011,86485,36.3,80.5,18.7,44521,41964,73891,66,8079,113,0,79714,6771
6,52526,652526,Norwalk city, California,1,2011,106308,47.1,73.3,9.1,55211,51097,39349,5929,13692,972,0,33729,72579
6,53000,653000,Oakland city, California,1,2011,395811,44.9,79.1,11.9,188122,207689,161558,110837,70886,2827,1832,299080,96731
6,53322,653322,Oceanside city, California,1,2011,169565,45.9,76.8,11.8,90537,79028,107148,9211,13627,1235,3595,109977,59588
6,53896,653896,Ontario city, California,1,2011,166412,48.1,71.1,6.3,75664,90748,103162,10084,6889,680,0,44660,121752
6,53980,653980,Orange city, California,1,2011,138405,45.2,77.7,11.4,70211,68194,87129,1527,17361,681,0,85833,52572
6,54652,654652,Oxnard city, California,1,2011,199917,46.8,70.1,7.2,101034,98883,140722,6689,14656,1212,36,52105,147812
6,55156,655156,Palmdale city, California,1,2011,153874,45.6,66.8,5.9,75091,78783,61745,22183,7995,351,20,70381,83493
6,55282,655282,Palo Alto city, California,0,2011,65419,41.6,77.4,16.6,33121,32298,44240,1914,14893,357,0,59372,6047
6,56000,656000,Pasadena city, California,1,2011,138086,46,81.5,13.9,70015,68071,89368,13715,25437,534,0,93869,44217
6,56700,656700,Perris city, California,1,2011,69973,44.8,58.8,3.7,33138,36835,31059,8255,2579,1712,0,17532,52441
6,57456,657456,Pittsburg city, California,0,2011,64307,46.8,76.3,8.8,31250,33057,23570,10526,10192,103,891,37102,27205
6,57792,657792,Pleasanton city, California,1,2011,71206,36.7,74.7,11.6,36333,34873,51144,1791,15511,0,0,63509,7697
6,58072,658072,Pomona city, California,1,2011,150126,47.2,73,9.1,76026,74100,93498,12377,12248,1209,0,47075,103051
6,59444,659444,Rancho Cordova city, California,0,2011,65614,45.1,73.1,11,31940,33674,40174,8099,6788,437,111,53765,11849
6,59451,659451,Rancho Cucamonga city, California,1,2011,167698,47.4,75.8,9.9,86382,81316,109393,13777,17736,1195,456,111956,55742
6,59920,659920,Redding city, California,1,2011,90142,38.3,76.7,16.2,44306,45836,77652,1419,1535,1723,241,82443,7699
6,59962,659962,Redlands city, California,1,2011,69744,41.8,77.5,13.2,34079,35665,49073,3274,5199,383,397,50272,19472
6,60018,660018,Redondo Beach city, California,1,2011,67231,42.8,79.5,11,31443,35788,52795,2408,7723,0,192,55442,11789
6,60102,660102,Redwood City city, California,1,2011,77750,41.7,74.5,11.7,38283,39467,58465,1793,8379,301,72,49179,28571
6,60466,660466,Rialto city, California,1,2011,100680,45.2,66.6,6.8,49115,51565,60447,11626,2764,198,1828,28380,72300
6,60620,660620,Richmond city, California,1,2011,105389,42.7,73.6,9.1,52555,52834,50180,25975,12435,830,569,61701,43688
6,62000,662000,Riverside city, California,1,2011,310654,47.3,73.6,9.5,155223,155431,205326,19896,23526,5218,515,149528,161126
6,62938,662938,Roseville city, California,1,2011,121755,39.2,73.1,14,58375,63380,98550,1248,11256,610,273,104292,17463
6,64000,664000,Sacramento city, California,1,2011,472169,44.6,74.4,11,232917,239252,228198,63119,99538,6491,5806,344579,127590
6,64224,664224,Salinas city, California,1,2011,152995,46.4,68.2,7.8,77600,75395,111906,1559,9322,892,318,37496,115499
6,65000,665000,San Bernardino city, California,1,2011,213008,45.3,68.3,7.5,105824,107184,110446,32316,9074,2540,115,88866,124142
6,65042,665042,San Buenaventura (Ventura) city, California,1,2011,107507,41.3,79,13.4,55405,52102,87461,2745,4427,704,195,71218,36289
6,66000,666000,San Diego city, California,1,2011,1326183,47.7,78.2,10.5,669251,656932,849647,94862,210468,5998,3934,923305,402878
6,67000,667000,San Francisco city, California,1,2011,812826,48.8,86.6,13.8,412823,400003,408583,48564,272088,2791,3703,687577,125249
6,68000,668000,San Jose city, California,1,2011,967478,44.1,75.9,10.4,486623,480855,457275,29661,320225,6935,4381,645984,321494
6,68084,668084,San Leandro city, California,1,2011,86067,41.5,76.6,12.2,41248,44819,41995,12183,22676,364,780,58858,27209
6,68196,668196,San Marcos city, California,1,2011,85009,47.1,71.9,11,40349,44660,63727,3525,9181,258,0,54005,31004
6,68252,668252,San Mateo city, California,1,2011,98403,42.5,81.4,14,49666,48737,65723,2045,19017,184,3353,73100,25303
6,68378,668378,San Ramon city, California,1,2011,73338,41.8,69.1,6.5,35285,38053,37305,2127,27407,657,375,63206,10132
6,69000,669000,Santa Ana city, California,1,2011,329405,49.4,70.3,7.5,165622,163783,172283,4653,31739,1762,499,67640,261765
6,69070,669070,Santa Barbara city, California,1,2011,89058,47.6,81,13.1,43436,45622,67392,1200,2560,245,117,50328,38730
6,69084,669084,Santa Clara city, California,1,2011,118247,48.2,76.2,9.9,57833,60414,61387,3892,41837,617,414,90321,27926
6,69088,669088,Santa Clarita city, California,1,2011,177589,42.4,72.4,9.4,89926,87663,127873,4681,17860,780,427,117363,60226
6,69196,669196,Santa Maria city, California,1,2011,100272,44.4,68.4,9.2,50280,49992,79885,761,6905,1050,140,31832,68440
6,70000,670000,Santa Monica city, California,1,2011,90373,50.7,86.9,14.5,42407,47966,73379,3489,8577,118,0,76888,13485
6,70098,670098,Santa Rosa city, California,1,2011,169302,39.6,76,13.2,87823,81479,131948,4460,10038,1693,1107,122025,47277
6,72016,672016,Simi Valley city, California,1,2011,125546,41.6,75,9.7,61975,63571,94485,1265,11991,1445,356,93546,32000
6,73080,673080,South Gate city, California,1,2011,95088,45.2,70.4,8.4,46594,48494,42190,499,692,0,126,3494,91594
6,75000,675000,Stockton city, California,1,2011,296367,44,69.4,9.1,144348,152019,139399,35629,62491,3044,1540,168301,128066
6,77000,677000,Sunnyvale city, California,1,2011,142299,45.5,77.6,10.7,71005,71294,67323,1883,59279,116,0,113235,29064
6,78120,678120,Temecula city, California,1,2011,102471,37.1,67.1,8.9,50201,52270,75786,2392,7010,3209,1329,73565,28906
6,78582,678582,Thousand Oaks city, California,1,2011,127994,33.5,77.4,16.7,59103,68891,98234,2083,15204,114,104,105744,22250
6,80000,680000,Torrance city, California,1,2011,146467,38.3,78.1,15.8,68454,78013,75635,4334,49891,266,360,120808,25659
6,80238,680238,Tracy city, California,1,2011,84252,41,69.7,8,43949,40303,47942,8031,11403,438,907,53669,30583
6,80812,680812,Turlock city, California,1,2011,69095,46.9,72,9.9,36047,33048,55487,1816,3918,739,627,42501,26594
6,80854,680854,Tustin city, California,1,2011,76699,49.2,74.7,7.4,37907,38792,52215,857,16551,87,1221,50239,26460
6,81204,681204,Union City city, California,1,2011,70441,43.4,76.5,11.9,34595,35846,14246,3670,38537,220,962,56178,14263
6,81344,681344,Upland city, California,1,2011,74854,40.9,76.8,11.3,33220,41634,45085,2713,5336,951,261,46187,28667
6,81554,681554,Vacaville city, California,1,2011,93076,43.9,77.7,10.4,49757,43319,60836,7766,4997,389,437,68162,24914
6,81666,681666,Vallejo city, California,1,2011,116829,37.3,77.7,12.8,56206,60623,48005,24302,28845,1340,1408,87644,29185
6,82590,682590,Victorville city, California,1,2011,117596,44.1,66.4,8.4,58956,58640,64235,11811,10343,865,67,57177,60419
6,82954,682954,Visalia city, California,1,2011,126421,41.6,71,10.8,63478,62943,104880,3651,6792,1657,78,69797,56624
6,82996,682996,Vista city, California,1,2011,95211,48.1,73.9,10.4,46730,48481,79926,3079,4264,419,273,49827,45384
6,83346,683346,Walnut Creek city, California,0,2011,65232,31.6,83.2,27.1,30211,35021,48756,3731,9397,92,0,57843,7389
6,84200,684200,West Covina city, California,1,2011,106864,40.8,75.4,12.6,50343,56521,43599,6575,26579,229,246,50697,56167
6,84550,684550,Westminster city, California,1,2011,91078,38.3,78.2,15.4,44627,46451,30489,1259,40197,75,1687,68458,22620
6,85292,685292,Whittier city, California,1,2011,85933,44.4,74.5,11.3,43071,42862,46505,1518,3366,1340,111,33629,52304
6,86832,686832,Yorba Linda city, California,0,2011,65220,36.7,74.9,11.8,31615,33605,52246,656,9605,348,0,52417,12803
6,86972,686972,Yuba City city, California,0,2011,65041,41.9,73.9,13.2,32542,32499,40708,2131,12136,732,236,47214,17827
8,3455,803455,Arvada city, Colorado,1,2011,107326,36,77.5,14.5,51822,55504,99026,963,2880,987,0,92683,14643
8,4000,804000,Aurora city, Colorado,1,2011,332551,45.2,72.7,8.7,165152,167399,221596,50335,17751,2965,1258,233907,98644
8,7850,807850,Boulder city, Colorado,1,2011,98903,59.1,86.7,8.4,48972,49931,89591,668,3946,140,0,92099,6804
8,12815,812815,Centennial city, Colorado,1,2011,102621,36.2,76.3,13.1,49518,53103,89523,3797,5027,442,58,94422,8199
8,16000,816000,Colorado Springs city, Colorado,1,2011,426406,42.3,75,11,211851,214555,346531,26402,10596,2334,1738,355009,71397
8,20000,820000,Denver city, Colorado,1,2011,619968,48.6,78.3,10.4,310377,309591,445187,59801,23046,8364,765,422850,197118
8,27425,827425,Fort Collins city, Colorado,1,2011,146777,55.1,80.5,7.8,73104,73673,134175,1655,3083,614,114,130821,15956
8,32155,832155,Greeley city, Colorado,1,2011,94966,48.3,76.6,11.6,46666,48300,86130,607,996,560,50,59484,35482
8,36410,836410,Highlands Ranch CDP, Colorado,0,2011,109365,41.8,65.9,7.8,53359,56006,98613,1513,5026,390,0,102400,6965
8,43000,843000,Lakewood city, Colorado,1,2011,144414,39.5,80.5,15.6,72753,71661,130601,2293,3664,725,35,114785,29629
8,45970,845970,Longmont city, Colorado,1,2011,87695,40.5,75.6,11.8,43423,44272,75584,809,3962,776,0,64136,23559
8,46465,846465,Loveland city, Colorado,1,2011,68203,37.8,75.9,14.3,33511,34692,58983,416,3479,1070,0,61700,6503
8,62000,862000,Pueblo city, Colorado,1,2011,107584,39,76.8,15.3,52698,54886,85603,2278,951,3885,82,55041,52543
8,77290,877290,Thornton city, Colorado,1,2011,121449,45,68.8,6.6,61359,60090,104743,1753,4217,852,0,86372,35077
8,83835,883835,Westminster city, Colorado,1,2011,107950,44.4,78.3,9.5,54143,53807,90127,2332,6627,343,0,83483,24467
9,8000,908000,Bridgeport city, Connecticut,1,2011,145634,46.1,74.5,9.5,68581,77053,65788,50531,5866,365,44,84314,61320
9,18430,918430,Danbury city, Connecticut,1,2011,81684,46.5,79.4,10.7,41965,39719,53806,5626,3070,226,80,59416,22268
9,37000,937000,Hartford city, Connecticut,1,2011,124863,50.7,75,9.2,61240,63623,47298,46238,2334,228,267,67295,57568
9,50370,950370,New Britain city, Connecticut,1,2011,73279,41.9,76.7,12.2,32661,40618,42867,9395,2065,324,0,46748,26531
9,52000,952000,New Haven city, Connecticut,1,2011,129591,51.4,77.2,11,62779,66812,58592,39435,6504,417,328,89117,40474
9,55990,955990,Norwalk city, Connecticut,1,2011,86467,40.9,84.2,13.7,43624,42843,67613,11338,2079,319,0,69244,17223
9,73000,973000,Stamford city, Connecticut,1,2011,123871,44.4,77.3,12.9,62634,61237,67976,20073,11147,324,0,92398,31473
9,80000,980000,Waterbury city, Connecticut,1,2011,110196,41.6,76.3,10.9,51524,58672,62070,20451,1701,145,29,75816,34380
10,77580,1077580,Wilmington city, Delaware,1,2011,71317,43.2,75.9,11.7,33990,37327,24329,39400,662,0,0,61256,10061
11,50000,1150000,Washington city, District of Columbia,1,2011,617996,51.3,82.9,11.3,292283,325713,246505,309845,22510,1956,0,559252,58744
12,410,1200410,Alafaya CDP, Florida,0,2011,67743,48.7,73.4,5.2,32867,34876,-998,-998,-998,-998,-998,42478,25265
12,7300,1207300,Boca Raton city, Florida,1,2011,85334,34.7,82.9,21.6,42392,42942,74416,6372,2141,140,0,74367,10967
12,7875,1207875,Boynton Beach city, Florida,1,2011,68997,36.9,81.8,20.8,32866,36131,45461,19599,1356,122,0,62228,6769
12,8150,1208150,Brandon CDP, Florida,0,2011,106312,47.7,79.2,10,51551,54761,83982,14327,2399,97,205,81328,24984
12,10275,1210275,Cape Coral city, Florida,1,2011,157476,32.7,76.4,18.7,79415,78061,143907,5576,2999,312,0,133279,24197
12,12875,1212875,Clearwater city, Florida,1,2011,107774,32.8,81,22.3,50740,57034,93953,9036,1908,96,0,95990,11784
12,14400,1214400,Coral Springs city, Florida,1,2011,123336,42.1,71.9,9.7,61431,61905,84568,25606,6072,758,0,97377,25959
12,16475,1216475,Davie town, Florida,1,2011,93686,43.1,76.2,9.4,43852,49834,74411,5426,5444,230,0,65527,28159
12,16725,1216725,Deerfield Beach city, Florida,1,2011,76392,38.1,81.6,20.6,35863,40529,-998,-998,-998,-998,-998,63596,12796
12,17200,1217200,Deltona city, Florida,1,2011,85212,35.4,78.2,16.7,43806,41406,56175,11540,719,1466,0,59418,25794
12,24000,1224000,Fort Lauderdale city, Florida,1,2011,168527,39.4,84.3,15.8,89956,78571,106543,51369,1699,916,75,140929,27598
12,24125,1224125,Fort Myers city, Florida,0,2011,63528,41.4,77.8,17.5,30874,32654,-998,-998,-998,-998,-998,48626,14902
12,25175,1225175,Gainesville city, Florida,1,2011,125325,65.9,87.9,7.9,59799,65526,81309,29940,9694,211,132,112368,12957
12,30000,1230000,Hialeah city, Florida,1,2011,229967,40.2,80.7,19.1,109303,120664,218181,3626,1102,401,0,15753,214214
12,32000,1232000,Hollywood city, Florida,1,2011,143351,38.8,77.5,15.6,69198,74153,102108,25369,3362,236,0,95614,47737
12,35000,1235000,Jacksonville city, Florida,1,2011,827909,42.9,76.4,11.3,401910,425999,502661,251281,34542,2880,464,760275,67634
12,36100,1236100,Kendall CDP, Florida,0,2011,75893,39.8,83.1,19.1,37609,38284,-998,-998,-998,-998,-998,22818,53075
12,38250,1238250,Lakeland city, Florida,1,2011,98608,38.4,81.3,20.9,46417,52191,71992,19521,1705,436,0,84108,14500
12,39425,1239425,Largo city, Florida,1,2011,77720,35,86,24.8,38079,39641,63041,8586,3186,40,0,69605,8115
12,39550,1239550,Lauderhill city, Florida,1,2011,68115,41.4,76.7,11.5,30798,37317,-998,-998,-998,-998,-998,62456,5659
12,39925,1239925,Lehigh Acres CDP, Florida,0,2011,98100,38.6,71.1,11.9,49067,49033,61611,20105,2103,782,0,66487,31613
12,43975,1243975,Melbourne city, Florida,1,2011,76089,35.4,82.1,20.9,36119,39970,65128,6965,1323,25,0,71212,4877
12,45000,1245000,Miami city, Florida,1,2011,408760,41.9,81.1,16,197819,210941,302767,80310,4557,837,153,121030,287730
12,45025,1245025,Miami Beach city, Florida,1,2011,89845,46.2,82.9,15.1,47323,42522,62419,7293,993,1301,0,41484,48361
12,45060,1245060,Miami Gardens city, Florida,1,2011,109672,44.4,76.3,11.5,50169,59503,-998,-998,-998,-998,-998,87948,21724
12,45975,1245975,Miramar city, Florida,1,2011,124285,44.3,73.7,7.6,61755,62530,53983,56120,6465,0,0,78544,45741
12,53000,1253000,Orlando city, Florida,1,2011,243209,47.3,78.2,10.6,117664,125545,139908,68298,11372,453,0,173948,69261
12,54000,1254000,Palm Bay city, Florida,1,2011,103234,35.7,74.9,14.9,47977,55257,77333,15546,1308,1095,0,90168,13066
12,54200,1254200,Palm Coast city, Florida,1,2011,79538,32.8,80,23.8,37809,41729,61490,10725,843,0,0,71258,8280
12,55775,1255775,Pembroke Pines city, Florida,1,2011,157612,39.3,77.8,14.3,75912,81700,109657,28427,9320,974,0,85410,72202
12,57425,1257425,Plantation city, Florida,1,2011,86516,39,77.2,11.9,40434,46082,59208,17723,4036,0,0,70111,16405
12,58050,1258050,Pompano Beach city, Florida,1,2011,101632,37.8,81.1,18.6,49159,52473,66970,31455,714,108,0,84684,16948
12,58715,1258715,Port St. Lucie city, Florida,1,2011,166162,36.8,75.3,15.5,85155,81007,122251,23331,2623,553,0,130925,35237
12,60950,1260950,Riverview CDP, Florida,0,2011,62319,48,74.4,9.1,30604,31715,43964,8030,2559,102,0,49288,13031
12,63000,1263000,St. Petersburg city, Florida,1,2011,244995,38.3,80.1,14.7,117319,127676,167288,62567,4944,575,508,232070,12925
12,68350,1268350,Spring Hill CDP, Florida,0,2011,106718,30.5,77.2,22.9,53022,53696,96282,5704,1217,265,0,93113,13605
12,69700,1269700,Sunrise city, Florida,1,2011,85990,40.9,77.9,13.9,39995,45995,49111,27967,3926,193,0,57221,28769
12,70600,1270600,Tallahassee city, Florida,1,2011,182955,59.6,84,7.7,88787,94168,103048,65423,7108,686,0,170460,12495
12,71000,1271000,Tampa city, Florida,1,2011,346064,46.4,78.2,10.9,171733,174331,218418,97089,10539,1950,414,273101,72963
12,72145,1272145,Town 'n' Country CDP, Florida,0,2011,78227,43.5,81.2,12.2,38783,39444,62567,5551,3986,717,0,43794,34433
12,76582,1276582,Weston city, Florida,0,2011,66545,36.4,68.8,8.5,33046,33499,59941,1928,1584,0,0,38603,27942
12,76600,1276600,West Palm Beach city, Florida,1,2011,101065,44.6,82.8,17.2,50930,50135,62186,31646,2325,605,91,75958,25107
13,1052,1301052,Albany city, Georgia,1,2011,78701,45,74,11.3,35386,43315,-998,-998,-998,-998,-998,76357,2344
13,3440,1303440,Athens-Clarke County unified government (balance), Georgia,1,2011,115939,61.2,83.3,8.4,55150,60789,77354,29326,4790,171,16,103736,12203
13,4000,1304000,Atlanta city, Georgia,1,2011,432425,52.6,81.4,9.3,214220,218205,172034,233506,14796,1065,231,404430,27995
13,4204,1304204,Augusta-Richmond County consolidated government (balance), Georgia,1,2011,194928,43.2,75.5,11.7,94628,100300,78331,104951,3755,330,319,186374,8554
13,19000,1319000,Columbus city, Georgia,1,2011,194107,43.2,74.8,11.3,93780,100327,89062,86643,4538,502,267,181171,12936
13,42425,1342425,Johns Creek city, Georgia,1,2011,79183,40,72.2,9.5,39888,39295,-998,-998,-998,-998,-998,76616,2567
13,49000,1349000,Macon city, Georgia,1,2011,92138,43.2,71.7,10.9,41234,50904,-998,-998,-998,-998,-998,90037,2101
13,67284,1367284,Roswell city, Georgia,1,2011,91165,42.7,75,10.8,46933,44232,70598,13554,4108,0,0,77779,13386
13,68516,1368516,Sandy Springs city, Georgia,1,2011,96859,42.1,76.5,10.4,46707,50152,67197,20875,5019,109,637,81373,15486
13,69000,1369000,Savannah city, Georgia,1,2011,139499,46.7,76.2,11.6,65688,73811,58518,74067,3150,73,248,133359,6140
13,80508,1380508,Warner Robins city, Georgia,1,2011,68315,46.2,74.2,10.3,32698,35617,38148,22961,2639,62,0,64179,4136
15,71550,1571550,Urban Honolulu CDP, Hawaii,0,2011,340931,40.2,81.5,18.2,166748,174183,60964,7943,181604,504,28755,324522,16409
16,8830,1608830,Boise City city, Idaho,1,2011,210151,45.4,78.2,10.9,105331,104820,188235,2504,7347,539,0,192248,17903
16,52120,1652120,Meridian city, Idaho,1,2011,76742,35.7,68.5,11.6,37434,39308,-998,-998,-998,-998,-998,73579,3163
16,56260,1656260,Nampa city, Idaho,1,2011,82759,40.7,68.5,11.8,40475,42284,75902,324,1127,917,336,62596,20163
17,2154,1702154,Arlington Heights village, Illinois,1,2011,76755,36,81.7,17.7,37556,39199,65096,1130,7066,0,0,71762,4993
17,3012,1703012,Aurora city, Illinois,1,2011,193398,48,69.7,6.8,95621,97777,108846,15595,11997,421,109,115765,77633
17,6613,1706613,Bloomington city, Illinois,1,2011,77078,45.6,75.4,9,38156,38922,59864,9124,5525,432,0,72025,5053
17,7133,1707133,Bolingbrook village, Illinois,1,2011,72719,46.2,72.2,6.8,35112,37607,46889,14318,6779,45,0,53407,19312
17,12385,1712385,Champaign city, Illinois,1,2011,81296,61.3,83.9,8.9,40180,41116,56487,12606,10554,95,0,77194,4102
17,14000,1714000,Chicago city, Illinois,1,2011,2707123,48.2,77.2,10.2,1317085,1390038,1296264,873749,143049,6340,320,1917658,789465
17,14351,1714351,Cicero town, Illinois,1,2011,84263,50.8,67.2,6,41212,43051,-998,-998,-998,-998,-998,10187,74076
17,18823,1718823,Decatur city, Illinois,1,2011,74617,36.7,77.8,17.1,35546,39071,53152,18286,1307,0,100,73199,1418
17,23074,1723074,Elgin city, Illinois,1,2011,116108,43.5,72.4,8.5,55929,60179,77736,4914,8066,611,0,62929,53179
17,24582,1724582,Evanston city, Illinois,1,2011,74791,45.5,82.1,12.6,37222,37569,52437,13529,5158,46,0,66972,7819
17,38570,1738570,Joliet city, Illinois,1,2011,152902,44.4,69.9,8.7,74804,78098,101864,24673,2938,560,0,106598,46304
17,51622,1751622,Naperville city, Illinois,1,2011,143289,39.1,72.7,11,69689,73600,106112,5762,27036,43,37,132777,10512
17,57225,1757225,Palatine village, Illinois,1,2011,68815,39.2,71.5,12.3,33354,35461,51170,2537,10389,0,0,56877,11938
17,59000,1759000,Peoria city, Illinois,1,2011,113715,42.2,74.7,14.5,52652,61063,71363,32738,6169,587,0,108072,5643
17,65000,1765000,Rockford city, Illinois,1,2011,152485,38.4,72.6,14.5,74330,78155,106019,32745,4331,348,145,125632,26853
17,68003,1768003,Schaumburg village, Illinois,1,2011,74198,44.6,80.2,9.9,37038,37160,53919,3651,13907,29,0,69507,4691
17,70122,1770122,Skokie village, Illinois,0,2011,65070,33.6,81.6,21.1,30026,35044,42212,5796,15593,12,0,59025,6045
17,72000,1772000,Springfield city, Illinois,1,2011,117178,38.6,79.1,14.3,56687,60491,88730,22168,2674,553,0,114633,2545
17,79293,1779293,Waukegan city, Illinois,1,2011,92734,45.5,69.8,7.3,46058,46676,54824,15262,3873,297,0,40869,51865
18,5860,1805860,Bloomington city, Indiana,1,2011,81033,69.4,88.2,8.4,40923,40110,66469,2647,7385,171,0,77637,3396
18,10342,1810342,Carmel city, Indiana,1,2011,81534,36.1,69.3,12,38560,42974,67720,2409,8078,104,0,78073,3461
18,22000,1822000,Evansville city, Indiana,1,2011,118117,39.6,78.8,15.2,55901,62216,99657,13569,239,55,0,114693,3424
18,23278,1823278,Fishers town, Indiana,1,2011,78756,44.2,66.9,4.7,39396,39360,69078,2836,3335,206,0,75493,3263
18,25000,1825000,Fort Wayne city, Indiana,1,2011,258803,40.8,73.1,11.7,123762,135041,196074,41079,7302,1256,69,239042,19761
18,27000,1827000,Gary city, Indiana,1,2011,80125,37.8,73.2,13.9,36194,43931,9419,67145,1014,57,112,76263,3862
18,31000,1831000,Hammond city, Indiana,1,2011,80758,41,71.5,9.5,40204,40554,41782,15990,508,472,0,49524,31234
18,36003,1836003,Indianapolis city (balance), Indiana,1,2011,824232,43.7,74.9,10.4,394578,429654,513900,228829,16032,1121,126,746446,77786
18,40788,1840788,Lafayette city, Indiana,1,2011,66105,47.3,76.3,10.5,32528,33577,58373,4652,868,205,0,57240,8865
18,51876,1851876,Muncie city, Indiana,1,2011,69131,52.3,83.7,13.2,32440,36691,57047,5907,1356,0,0,67102,2029
18,71000,1871000,South Bend city, Indiana,1,2011,101103,40.4,74,13.5,49578,51525,63312,28306,1156,247,0,88146,12957
19,12000,1912000,Cedar Rapids city, Iowa,1,2011,127902,42.8,77.6,13.4,63442,64460,112749,7031,2190,388,0,123952,3950
19,19000,1919000,Davenport city, Iowa,1,2011,100805,42.4,75.3,11.9,47305,53500,82546,11499,2543,420,0,92672,8133
19,21000,1921000,Des Moines city, Iowa,1,2011,206577,44.6,74.5,11,99748,106829,160999,22215,10057,528,121,182020,24557
19,38595,1938595,Iowa City city, Iowa,1,2011,68940,60.7,84.8,9.2,34190,34750,57744,3562,4303,205,0,66762,2178
19,73335,1973335,Sioux City city, Iowa,1,2011,81453,41.2,73.8,13.4,39426,42027,63590,2318,1919,1700,0,67547,13906
19,82425,1982425,Waterloo city, Iowa,1,2011,68646,43.2,76.2,14.1,33542,35104,52727,11040,1459,148,0,63951,4695
20,36000,2036000,Kansas City city, Kansas,1,2011,146198,41.7,71.5,10.7,73008,73190,83829,38344,4414,1236,32,104956,41242
20,38900,2038900,Lawrence city, Kansas,1,2011,89851,61.7,83.1,7.7,45566,44285,74349,4718,4239,1950,0,83791,6060
20,52575,2052575,Olathe city, Kansas,1,2011,127902,43.2,71.2,8.4,64635,63267,107410,7226,6664,489,0,115915,11987
20,53775,2053775,Overland Park city, Kansas,1,2011,176182,39.5,73.4,11.7,82790,93392,147180,9696,10336,1030,0,163072,13110
20,71000,2071000,Topeka city, Kansas,1,2011,128194,39.1,76,14.2,61416,66778,98968,15720,1646,1529,0,110858,17336
20,79000,2079000,Wichita city, Kansas,1,2011,384439,40.8,73.7,11.9,189484,194955,285434,39827,17492,3648,237,324514,59925
21,46027,2146027,Lexington-Fayette urban county, Kentucky,1,2011,301569,47,79,10.6,148736,152833,229703,44513,10662,620,44,280528,21041
21,48006,2148006,Louisville/Jefferson County metro government (balance), Kentucky,1,2011,602037,40.2,76.5,13,289734,312303,426236,134666,14558,1092,84,573811,28226
22,5000,2205000,Baton Rouge city, Louisiana,1,2011,230148,47.2,78.5,12,109831,120317,91470,125206,8529,177,0,219874,10274
22,39475,2239475,Kenner city, Louisiana,1,2011,66725,37.7,76.3,13.5,31350,35375,44031,18132,1985,0,0,55388,11337
22,40735,2240735,Lafayette city, Louisiana,1,2011,122128,45.2,78.6,13.3,59817,62311,75764,41797,2093,289,0,116208,5920
22,41155,2241155,Lake Charles city, Louisiana,1,2011,72475,38.8,77,15.1,34515,37960,-998,-998,-998,-998,-998,70227,2248
22,50115,2250115,Metairie CDP, Louisiana,0,2011,137775,39.8,80.2,16.8,69751,68024,110501,14478,5184,401,0,117009,20766
22,55000,2255000,New Orleans city, Louisiana,1,2011,360740,44.7,78.6,11.2,173821,186919,123436,216539,10649,761,147,341813,18927
22,70000,2270000,Shreveport city, Louisiana,1,2011,201871,41.6,75,12.8,94728,107143,79752,113167,1295,941,0,196573,5298
23,60545,2360545,Portland city, Maine,1,2011,66368,46.9,83.6,11.7,32259,34109,-998,-998,-998,-998,-998,64863,1505
24,4000,2404000,Baltimore city, Maryland,1,2011,619493,44.7,78.4,11.7,291984,327509,186050,390096,14561,1760,733,592655,26838
24,19125,2419125,Columbia CDP, Maryland,0,2011,104643,43.3,74.9,9.7,49998,54645,55960,24869,13943,239,137,96097,8546
24,26000,2426000,Ellicott City CDP, Maryland,0,2011,68010,35.6,73.3,13.8,33751,34259,-998,-998,-998,-998,-998,65056,2954
24,30325,2430325,Frederick city, Maryland,0,2011,66165,42,75.9,10.7,33122,33043,43364,13457,3354,566,0,54423,11742
24,32025,2432025,Germantown CDP, Maryland,0,2011,84447,46.2,74,5.1,39011,45436,36310,21195,18860,264,0,69109,15338
24,32650,2432650,Glen Burnie CDP, Maryland,0,2011,69026,44.1,80.3,9.5,32277,36749,44674,17795,2664,262,0,62077,6949
24,72450,2472450,Silver Spring CDP, Maryland,0,2011,78430,48.2,75.4,8.4,39113,39317,34053,23355,4770,173,0,59046,19384
24,81175,2481175,Waldorf CDP, Maryland,0,2011,71674,45.7,70.9,6.5,33074,38600,21966,39419,4595,0,90,67779,3895
25,7000,2507000,Boston city, Massachusetts,1,2011,624969,55.3,83.2,10.3,296744,328225,333558,161596,56844,1594,60,510228,114741
25,9000,2509000,Brockton city, Massachusetts,1,2011,94312,41,74.3,12.6,45336,48976,42120,34485,2437,206,45,82874,11438
25,11000,2511000,Cambridge city, Massachusetts,1,2011,106039,61,87.7,9.7,50282,55757,69524,11798,17604,238,44,99403,6636
25,23000,2523000,Fall River city, Massachusetts,1,2011,88964,42.5,77.8,14.9,41123,47841,78293,2678,2618,0,0,82825,6139
25,24960,2524960,Framingham CDP, Massachusetts,0,2011,68986,42.1,76.3,12.3,32142,36844,52201,6297,5073,120,0,59128,9858
25,34550,2534550,Lawrence city, Massachusetts,1,2011,76971,45.8,73.2,8.1,36832,40139,27332,4427,2308,0,0,21478,55493
25,37000,2537000,Lowell city, Massachusetts,1,2011,107582,46.7,78.3,11.7,51315,56267,66194,7178,19096,439,88,92074,15508
25,37490,2537490,Lynn city, Massachusetts,1,2011,91035,44.9,75.4,12.5,42983,48052,48153,10224,6606,413,28,60268,30767
25,45000,2545000,New Bedford city, Massachusetts,1,2011,95180,41.6,78.2,14.5,45782,49398,70801,9967,1019,326,0,79990,15190
25,45560,2545560,Newton city, Massachusetts,1,2011,85946,38.8,80.3,17.2,39895,46051,70538,3123,10422,68,0,81935,4011
25,55745,2555745,Quincy city, Massachusetts,1,2011,92914,43.8,83.1,13.4,45913,47001,64364,4979,19882,233,0,89217,3697
25,62535,2562535,Somerville city, Massachusetts,1,2011,76529,63,86.4,7.9,38249,38280,55947,6915,8433,19,0,66598,9931
25,67000,2567000,Springfield city, Massachusetts,1,2011,153157,42.8,72.8,11.2,74274,78883,84313,32118,2911,1010,9,90685,62472
25,82000,2582000,Worcester city, Massachusetts,1,2011,181641,45.2,77.8,12.1,84173,97468,131184,21096,13985,856,106,145714,35927
26,3000,2603000,Ann Arbor city, Michigan,1,2011,114932,60.8,88.6,10.6,58181,56751,85867,6937,17287,267,0,108869,6063
26,21000,2621000,Dearborn city, Michigan,1,2011,97131,42.7,71.6,10.8,48829,48302,88285,2454,1758,232,0,94540,2591
26,22000,2622000,Detroit city, Michigan,1,2011,706640,41,73.9,11.9,336931,369709,86625,578298,7914,1790,76,655138,51502
26,27440,2627440,Farmington Hills city, Michigan,1,2011,80255,38.2,79.1,16,37887,42368,54245,13413,9319,135,0,78442,1813
26,29000,2629000,Flint city, Michigan,1,2011,101568,42.2,73.7,11.7,48738,52830,40445,56018,683,1071,28,96737,4831
26,34000,2634000,Grand Rapids city, Michigan,1,2011,189813,47.4,76,11.6,93297,96516,130404,41971,2974,640,0,162377,27436
26,42160,2642160,Kalamazoo city, Michigan,1,2011,74743,55.7,80.2,9.2,38713,36030,50409,17424,2042,142,114,69987,4756
26,46000,2646000,Lansing city, Michigan,1,2011,114738,47,78.6,9.9,55212,59526,70396,24246,6954,593,0,99464,15274
26,49000,2649000,Livonia city, Michigan,1,2011,95947,34.1,80.5,19.3,47117,48830,87381,3633,2840,362,65,93390,2557
26,69035,2669035,Rochester Hills city, Michigan,1,2011,71457,36.8,76.4,13.8,35323,36134,57461,3745,7467,326,0,67497,3960
26,74900,2674900,Southfield city, Michigan,1,2011,72201,35.2,79,17.3,30308,41893,16038,50837,1059,171,0,71101,1100
26,76460,2676460,Sterling Heights city, Michigan,1,2011,129884,37.5,78.9,17.6,64214,65670,108542,8280,9736,231,0,128536,1348
26,80700,2680700,Troy city, Michigan,1,2011,81507,36,75.7,13.2,39115,42392,58361,3919,16160,25,0,78778,2729
26,84000,2684000,Warren city, Michigan,1,2011,134250,37.7,80.5,16.4,65669,68581,108845,13888,7175,1184,57,133379,871
26,86000,2686000,Westland city, Michigan,1,2011,83235,40.3,77.1,14.1,37577,45658,57350,19011,3751,439,0,80660,2575
26,88940,2688940,Wyoming city, Michigan,1,2011,72839,46.7,73.4,6.4,36265,36574,61726,3518,1279,132,0,57579,15260
27,6616,2706616,Bloomington city, Minnesota,1,2011,84060,38,82.5,19.1,41246,42814,67757,6465,4761,883,0,79111,4949
27,7966,2707966,Brooklyn Park city, Minnesota,1,2011,76830,45.2,72.1,7.6,37431,39399,41328,19165,11190,121,0,72846,3984
27,17000,2717000,Duluth city, Minnesota,1,2011,86284,47.1,79.9,14,42956,43328,79069,1845,1427,1439,47,85451,833
27,43000,2743000,Minneapolis city, Minnesota,1,2011,387736,50.4,80,9.5,194953,192783,260411,72030,20282,6954,120,346810,40926
27,51730,2751730,Plymouth city, Minnesota,1,2011,71561,37.6,75.9,10.9,34282,37279,59600,2199,5797,560,0,68860,2701
27,54880,2754880,Rochester city, Minnesota,1,2011,107887,40.5,74.9,13.2,52538,55349,89429,7173,7390,379,0,101857,6030
27,56896,2756896,St. Cloud city, Minnesota,0,2011,68066,51.9,80.9,9.7,34800,33266,56031,6323,2566,209,0,66931,1135
27,58000,2758000,St. Paul city, Minnesota,1,2011,288437,46.8,75.5,9,141202,147235,177353,42836,42046,2991,138,259923,28514
28,29700,2829700,Gulfport city, Mississippi,1,2011,69221,43.4,74.8,12.3,35666,33555,-998,-998,-998,-998,-998,65783,3438
28,36000,2836000,Jackson city, Mississippi,1,2011,175607,44.2,72.8,10.2,81588,94019,33314,139293,398,0,0,172271,3336
29,15670,2915670,Columbia city, Missouri,1,2011,110432,57.1,81.5,9,53664,56768,85828,12706,6011,289,17,105930,4502
29,35000,2935000,Independence city, Missouri,1,2011,117210,36.7,78.4,18,53306,63904,97658,9144,1328,217,397,106215,10995
29,38000,2938000,Kansas City city, Missouri,1,2011,463156,43.6,76.3,10.7,225330,237826,278420,129146,13430,1976,811,416600,46556
29,41348,2941348,Lee's Summit city, Missouri,1,2011,91352,38.9,68.3,9.9,43997,47355,72687,11761,998,64,0,88459,2893
29,54074,2954074,O'Fallon city, Missouri,1,2011,80534,42.5,67.5,8.9,40588,39946,-998,-998,-998,-998,-998,79832,702
29,64082,2964082,St. Charles city, Missouri,0,2011,66600,46.6,82,11.8,31910,34690,59630,2882,1240,266,0,62390,4210
29,64550,2964550,St. Joseph city, Missouri,1,2011,77095,42.2,77.6,13.4,38131,38964,66880,4462,501,264,248,72843,4252
29,65000,2965000,St. Louis city, Missouri,1,2011,318069,46.2,78.8,11,154173,163896,144377,152646,7381,481,329,306625,11444
29,70000,2970000,Springfield city, Missouri,1,2011,160662,48.1,83.5,15,78978,81684,144519,6158,2363,408,571,154650,6012
30,6550,3006550,Billings city, Montana,1,2011,105623,38.5,78.4,15.4,50417,55206,94843,273,494,4606,511,99926,5697
30,50200,3050200,Missoula city, Montana,1,2011,67297,50.3,82.3,12.5,33397,33900,62006,502,484,2669,36,65054,2243
31,28000,3128000,Lincoln city, Nebraska,1,2011,262350,47.1,77.6,11.3,131777,130573,230615,10066,10799,2044,0,245531,16819
31,37000,3137000,Omaha city, Nebraska,1,2011,415076,42.8,75.5,11.4,202234,212842,311639,52035,11065,3072,234,358227,56849
32,23770,3223770,Enterprise CDP, Nevada,0,2011,120194,48.7,73.7,6.7,60683,59511,73906,14569,22893,1310,167,95834,24360
32,31900,3231900,Henderson city, Nevada,1,2011,260072,37.3,77.6,16.2,120505,139567,200761,21424,21678,900,2428,225974,34098
32,40000,3240000,Las Vegas city, Nevada,1,2011,589340,41.2,74.2,12.5,303067,286273,393218,68577,39130,5044,4588,400722,188618
32,51800,3251800,North Las Vegas city, Nevada,1,2011,219017,46.3,69.7,8.5,110585,108432,122532,38496,7759,345,2547,125720,93297
32,54600,3254600,Paradise CDP, Nevada,0,2011,216387,44.1,79.1,11.9,109091,107296,155864,16070,21482,1487,542,154794,61593
48,72176,4872176,Temple city, Texas,0,2011,67183,39.1,75.9,15.5,34195,32988,54307,7615,2430,13,24,52245,14938
48,72656,4872656,The Woodlands CDP, Texas,0,2011,112858,37.6,69,9.7,55946,56912,95073,4458,6363,0,0,92600,20258
48,74144,4874144,Tyler city, Texas,1,2011,98573,45,76.4,14.3,45404,53169,66316,24630,2368,481,76,78142,20431
48,76000,4876000,Waco city, Texas,1,2011,126691,47.6,74.4,10.7,61266,65425,90276,28364,2170,129,57,87884,38807
48,79000,4879000,Wichita Falls city, Texas,1,2011,103932,43.3,77,12.1,53261,50671,81816,12722,2696,756,70,83087,20845
49,43660,4943660,Layton city, Utah,1,2011,68488,44.1,69.5,7.9,34767,33721,60339,2442,1129,98,359,61318,7170
49,55980,4955980,Ogden city, Utah,1,2011,83950,46,70.6,8.3,42101,41849,62530,1085,1303,926,202,59776,24174
49,57300,4957300,Orem city, Utah,1,2011,90719,48.1,67.3,7.9,45987,44732,82141,1536,983,427,549,78310,12409
49,62470,4962470,Provo city, Utah,1,2011,115324,65,76.8,4.7,57288,58036,101694,1139,3634,312,1452,93254,22070
49,65330,4965330,St. George city, Utah,1,2011,74776,39.9,67.6,18,38478,36298,68804,236,401,1771,1054,62684,12092
49,67000,4967000,Salt Lake City city, Utah,1,2011,189906,50.9,76.2,8.5,97530,92376,141084,5382,9255,3097,5363,153905,36001
49,67440,4967440,Sandy city, Utah,1,2011,89191,40.8,72.2,11.4,45103,44088,80129,419,2140,228,514,82881,6310
49,82950,4982950,West Jordan city, Utah,1,2011,105694,45,64.6,3.9,52643,53051,94180,1084,2692,1021,934,88819,16875
49,83470,4983470,West Valley City city, Utah,1,2011,131928,45.5,69.1,6.5,69224,62704,101985,4156,8735,913,3473,85226,46702
51,1000,5101000,Alexandria city, Virginia,1,2011,144301,51,82.5,8.7,70047,74254,93723,30380,8547,310,0,120592,23709
51,3000,5103000,Arlington CDP, Virginia,0,2011,216004,55.8,84.1,8.9,107590,108414,152764,18017,20711,1443,237,183211,32793
51,14440,5114440,Centreville CDP, Virginia,0,2011,77602,46.2,72.6,3.6,40528,37074,37842,5249,24122,0,0,65193,12409
51,16000,5116000,Chesapeake city, Virginia,1,2011,225050,40.3,74.7,10.7,109746,115304,140666,65759,7439,609,391,214721,10329
51,21088,5121088,Dale City CDP, Virginia,0,2011,65174,44.1,73.9,7.1,33434,31740,27883,22834,5746,0,0,49255,15919
51,35000,5135000,Hampton city, Virginia,1,2011,136401,41.9,77.2,12.3,65934,70467,59098,68574,3086,560,39,129936,6465
51,47672,5147672,Lynchburg city, Virginia,1,2011,76503,48.2,82.6,15.5,35935,40568,51780,20921,1930,229,0,73585,2918
51,56000,5156000,Newport News city, Virginia,1,2011,179611,44.8,75.7,11,86048,93563,91478,72777,5172,581,264,165877,13734
51,57000,5157000,Norfolk city, Virginia,1,2011,242628,50.7,79.1,9.4,125041,117587,115500,102621,8528,917,418,225914,16714
51,64000,5164000,Portsmouth city, Virginia,1,2011,95684,41.8,76.1,13,45963,49721,39758,50965,643,70,0,92572,3112
51,67000,5167000,Richmond city, Virginia,1,2011,205533,49.1,81,11.1,98856,106677,89030,101361,4904,286,31,192495,13038
51,68000,5168000,Roanoke city, Virginia,1,2011,96714,39.9,78.3,14.3,46393,50321,62443,24781,1933,188,0,91293,5421
51,76432,5176432,Suffolk city, Virginia,1,2011,84930,38.9,74.8,11.7,40585,44345,44314,34648,664,103,0,82238,2692
51,82000,5182000,Virginia Beach city, Virginia,1,2011,442707,43.9,76.4,10.9,217227,225480,302996,86949,28736,1705,240,411769,30938
53,3180,5303180,Auburn city, Washington,1,2011,70724,40.7,77.4,12.2,34067,36657,50990,2942,6112,1646,1167,60672,10052
53,5210,5305210,Bellevue city, Washington,1,2011,124790,41.4,80.8,13.5,64431,60359,82043,1926,30183,372,584,116931,7859
53,5280,5305280,Bellingham city, Washington,1,2011,81865,53,83.9,12.9,39976,41889,72310,1040,3889,770,0,74355,7510
53,22640,5322640,Everett city, Washington,1,2011,104304,44.6,80.1,10.3,52311,51993,79903,3196,10554,1156,1170,90892,13412
53,23515,5323515,Federal Way city, Washington,1,2011,91079,42.2,77.2,10.1,44373,46706,60267,8971,9125,1599,1848,72413,18666
53,35275,5335275,Kennewick city, Washington,1,2011,76219,39.9,68.6,8.5,39455,36764,56888,2299,2046,112,0,57866,18353
53,35415,5335415,Kent city, Washington,1,2011,120919,42.8,72,8.9,62357,58562,68629,11054,21345,612,3477,100319,20600
53,57745,5357745,Renton city, Washington,1,2011,92827,44.8,77.8,10.7,45963,46864,52047,10008,19853,660,287,83870,8957
53,63000,5363000,Seattle city, Washington,1,2011,620778,50.5,84.1,11.2,309128,311650,433436,45994,95955,4523,1361,583143,37635
53,67000,5367000,Spokane city, Washington,1,2011,210107,43.8,78.1,13.8,101677,108430,183697,5621,5737,3854,536,198324,11783
53,67167,5367167,Spokane Valley city, Washington,1,2011,90282,38.8,76.4,15.2,44940,45342,79424,1331,903,2384,490,86048,4234
53,70000,5370000,Tacoma city, Washington,1,2011,200677,43.9,78.2,12.1,98736,101941,132653,21038,20980,2370,964,176219,24458
53,74060,5374060,Vancouver city, Washington,1,2011,164774,42.2,77,13.3,78445,86329,134114,5290,9306,2038,1622,150161,14613
53,80010,5380010,Yakima city, Washington,1,2011,92521,42.7,74.8,14.3,48119,44402,66893,993,996,756,0,53598,38923
55,2375,5502375,Appleton city, Wisconsin,1,2011,72395,37.1,75.1,13.8,35837,36558,64547,579,4155,499,30,68217,4178
55,22300,5522300,Eau Claire city, Wisconsin,0,2011,65973,50.7,80.5,11.4,31541,34432,59925,171,3046,322,0,65277,696
55,31000,5531000,Green Bay city, Wisconsin,1,2011,105815,42.8,74.3,10.9,50322,55493,87221,4422,4461,2652,25,93141,12674
55,39225,5539225,Kenosha city, Wisconsin,1,2011,99743,43.6,73.4,10.9,49191,50552,84430,10631,1049,588,0,82388,17355
55,48000,5548000,Madison city, Wisconsin,1,2011,236889,54.7,81.9,9.1,115647,121242,190145,15082,18927,1010,0,218639,18250
55,53000,5553000,Milwaukee city, Wisconsin,1,2011,597884,46.3,73.5,9.2,286738,311146,284607,233507,20552,3333,349,493154,104730
55,60500,5560500,Oshkosh city, Wisconsin,0,2011,66339,51.3,81.1,11.1,35062,31277,60548,2342,1668,498,0,64270,2069
55,66000,5566000,Racine city, Wisconsin,1,2011,78847,42.2,72,10.9,37546,41301,53752,17925,1054,92,0,62228,16619
55,84250,5584250,Waukesha city, Wisconsin,1,2011,70872,46.7,75.3,9.9,35129,35743,63198,1239,1843,321,0,60359,10513
72,10334,7210334,Caguas zona urbana, Puerto Rico,0,2011,87617,41.1,74.6,15.3,39871,47746,69700,6541,100,55,0,374,87243
72,14290,7214290,Carolina zona urbana, Puerto Rico,0,2011,156916,40.4,76.9,17.1,71820,85096,93016,34334,387,1020,0,1836,155080
72,32522,7232522,Guaynabo zona urbana, Puerto Rico,0,2011,77821,39.7,78.8,16.7,35791,42030,61314,3807,167,390,0,1514,76307
72,63820,7263820,Ponce zona urbana, Puerto Rico,0,2011,133464,39.3,75.7,16,62813,70651,91316,7331,51,87,0,181,133283
72,76770,7276770,San Juan zona urbana, Puerto Rico,0,2011,373584,39.6,78.7,17.8,170575,203009,232289,62028,3757,1204,0,7591,365993
72,6593,7206593,Bayam√≥n zona urbana, Puerto Rico,0,2011,184282,40.3,78.5,17.4,86945,97337,109110,17369,327,1319,0,1623,182659
72,52431,7252431,Mayag√ºez zona urbana, Puerto Rico,0,2011,68888,43.4,79.7,17,33212,35676,39318,3415,11,0,0,608,68280
1,7000,107000,Birmingham city, Alabama,1,2012,212835,42.7,78,12,97165,115670,47736,156390,2715,117,132,202823,10012
1,21184,121184,Dothan city, Alabama,0,2012,68104,39,75,14.5,32389,35715,42431,23371,712,50,0,66215,1889
1,35896,135896,Hoover city, Alabama,1,2012,81627,40.8,72.2,12.6,39770,41857,60744,12290,4563,0,74,77054,4573
1,37000,137000,Huntsville city, Alabama,1,2012,183076,42.2,78,14.2,91227,91849,113590,58439,3884,527,253,173067,10009
1,50000,150000,Mobile city, Alabama,1,2012,194823,41,76.8,13.8,92531,102292,85239,103503,2417,1004,44,191818,3005
1,51000,151000,Montgomery city, Alabama,1,2012,205285,42.9,75.4,12,96393,108892,78369,115936,4977,77,96,197435,7850
1,77256,177256,Tuscaloosa city, Alabama,1,2012,93351,56.7,82.4,10.1,45060,48291,52784,37621,1892,286,52,89455,3896
2,3000,203000,Anchorage municipality, Alaska,1,2012,298610,45.4,74.9,8,151752,146858,196090,18866,27691,19165,5977,274017,24593
4,4720,404720,Avondale city, Arizona,1,2012,78274,48.6,66.1,6.4,37383,40891,57783,9485,2723,1283,218,34796,43478
4,10670,410670,Casas Adobes CDP, Arizona,0,2012,71976,35.8,75.2,18.9,34718,37258,61753,1387,2591,1161,0,55610,16366
4,12000,412000,Chandler city, Arizona,1,2012,245642,44.4,73.3,8.9,122484,123158,190170,12157,20086,4051,592,190195,55447
4,23620,423620,Flagstaff city, Arizona,0,2012,67472,58.3,78.9,6,33773,33699,50596,1906,1348,7870,82,54713,12759
4,27400,427400,Gilbert town, Arizona,1,2012,221136,42.8,68.2,7.6,107354,113782,187591,5792,12334,1646,560,185258,35878
4,27820,427820,Glendale city, Arizona,1,2012,232118,44,74.1,9.4,114099,118019,181779,15421,7510,3620,258,143717,88401
4,28380,428380,Goodyear city, Arizona,0,2012,69631,38.8,73.1,13,32540,37091,58187,4955,1623,734,0,48474,21157
4,46000,446000,Mesa city, Arizona,1,2012,452068,39.4,75,15.8,220768,231300,375765,14982,8021,9780,1138,326599,125469
4,54050,454050,Peoria city, Arizona,1,2012,159761,38,72.9,14.4,76732,83029,135820,6417,7662,616,459,128447,31314
4,55000,455000,Phoenix city, Arizona,1,2012,1488759,44.7,72.9,9.2,743172,745587,1141686,105152,51432,29472,2772,888308,600451
4,64210,464210,San Tan Valley CDP, Arizona,0,2012,82760,41.4,64.6,6.9,41569,41191,68821,2604,2301,1941,302,65613,17147
4,65000,465000,Scottsdale city, Arizona,1,2012,223517,37.5,82.6,20.5,109243,114274,201917,5342,9901,1320,399,203029,20488
4,71510,471510,Surprise city, Arizona,1,2012,121276,35.1,70.2,20.4,61288,59988,100905,10938,2554,1021,322,99705,21571
4,73000,473000,Tempe city, Arizona,1,2012,166862,59.4,84.8,8.4,87008,79854,120196,6835,12331,4372,532,126552,40310
4,77000,477000,Tucson city, Arizona,1,2012,524278,45.7,77.7,12.4,260034,264244,384306,27562,13327,11165,755,295768,228510
4,85540,485540,Yuma city, Arizona,1,2012,95424,45,72.2,13.3,49685,45739,66806,3295,2121,885,656,40537,54887
5,23290,523290,Fayetteville city, Arkansas,1,2012,76892,58.5,82.9,8.7,38830,38062,63768,4702,1948,930,213,70944,5948
5,24550,524550,Fort Smith city, Arkansas,1,2012,87437,40.8,73.4,13.2,43528,43909,67162,7562,5251,1910,209,72894,14543
5,35710,535710,Jonesboro city, Arkansas,1,2012,70183,44.5,76.8,11.6,33964,36219,54205,13398,804,144,0,66480,3703
5,41000,541000,Little Rock city, Arkansas,1,2012,196530,43.8,78,12.7,93400,103130,103201,82170,7063,1036,0,183676,12854
5,66080,566080,Springdale city, Arkansas,1,2012,76480,43.5,64.1,7.4,37250,39230,48349,2168,2141,326,4425,50007,26473
6,562,600562,Alameda city, California,1,2012,75632,42.1,78.9,13.2,36485,39147,37726,5179,23429,521,704,66680,8952
6,884,600884,Alhambra city, California,1,2012,84322,42.4,81.7,12.2,42413,41909,22519,1465,40841,153,141,52678,31644
6,2000,602000,Anaheim city, California,1,2012,343241,44.8,73.6,9.9,170755,172486,233546,7450,52130,1057,2313,160795,182446
6,2252,602252,Antioch city, California,1,2012,105495,39.9,72.8,8.9,52428,53067,50421,16971,11378,2098,493,69139,36356
6,2364,602364,Apple Valley town, California,1,2012,70682,38.2,73.8,16.7,35154,35528,55944,6872,789,2034,0,47262,23420
6,2553,602553,Arden-Arcade CDP, California,0,2012,88995,39,78.5,16.7,41862,47133,62130,7418,5066,1329,185,71739,17256
6,3526,603526,Bakersfield city, California,1,2012,358600,44.3,69.1,9,177627,180973,227512,32587,25949,5545,334,194676,163924
6,3666,603666,Baldwin Park city, California,1,2012,76437,46.4,74.3,8.8,39534,36903,24435,1643,11530,335,352,17667,58770
6,4982,604982,Bellflower city, California,1,2012,77334,44.4,71.3,10,36987,40347,39859,11293,10262,201,0,37147,40187
6,6000,606000,Berkeley city, California,1,2012,115417,54.7,87.2,13,57679,57738,72460,8986,20924,741,243,100568,14849
6,8786,608786,Buena Park city, California,1,2012,82152,41.5,74.8,13.4,40154,41998,49808,2067,23341,711,664,48969,33183
6,8954,608954,Burbank city, California,1,2012,104380,46.8,79.6,12.1,50995,53385,79642,2433,10892,179,93,74578,29802
6,10046,610046,Camarillo city, California,0,2012,65972,37.6,82.8,19.6,32366,33606,50220,2241,6307,247,81,48759,17213
6,11194,611194,Carlsbad city, California,1,2012,109333,36.9,79.4,14.1,53388,55945,92829,1606,7703,623,0,93296,16037
6,11530,611530,Carson city, California,1,2012,92992,43.2,77.7,14.6,44935,48057,29205,14637,22099,863,2638,51744,41248
6,13014,613014,Chico city, California,1,2012,87712,53.2,80.3,12.1,42640,45072,74941,1628,3344,387,153,74293,13419
6,13210,613210,Chino city, California,1,2012,80181,45,78.6,10.1,42052,38129,45171,4067,9021,1313,122,41274,38907
6,13214,613214,Chino Hills city, California,1,2012,76462,43.1,75.5,7.5,38416,38046,41194,2372,25148,192,0,55075,21387
6,13392,613392,Chula Vista city, California,1,2012,252424,44.1,73.3,10.6,128245,124179,173959,12625,35082,878,1765,108333,144091
6,13588,613588,Citrus Heights city, California,1,2012,84862,40.8,78.6,13.8,41802,43060,71151,2158,2333,650,0,68733,16129
6,14218,614218,Clovis city, California,1,2012,98626,43.9,70.3,9.9,47881,50745,74354,1216,9027,1309,248,68105,30521
6,15044,615044,Compton city, California,1,2012,97560,46.6,66.2,6.6,46654,50906,15913,30554,524,283,267,33052,64508
6,16000,616000,Concord city, California,1,2012,124717,42.8,77.9,12.2,62400,62317,82972,8078,16254,607,1393,86801,37916
6,16350,616350,Corona city, California,1,2012,158388,45.9,70.6,7.4,78142,80246,113387,8748,17969,1347,605,90567,67821
6,16532,616532,Costa Mesa city, California,1,2012,111910,46,78.8,9.2,58018,53892,74348,1827,9704,214,140,73031,38879
6,17918,617918,Daly City city, California,1,2012,103677,42.4,81,14.2,50005,53672,20761,1954,64398,346,205,81815,21862
6,18100,618100,Davis city, California,0,2012,66009,58.1,83.5,8.8,32846,33163,40897,2226,14662,201,84,56499,9510
6,19766,619766,Downey city, California,1,2012,112878,43.1,74,12.1,53865,59013,73025,4529,10239,72,67,35756,77122
6,20802,620802,East Los Angeles CDP, California,0,2012,126918,46.9,69.5,9.2,60453,66465,70748,1029,1598,553,33,3780,123138
6,21712,621712,El Cajon city, California,1,2012,101449,45.1,74.8,10.2,48765,52684,71529,6629,5325,197,2121,72628,28821
6,22020,622020,Elk Grove city, California,1,2012,159064,42.2,69.8,9.1,78482,80582,71280,17192,44859,630,1592,129450,29614
6,22230,622230,El Monte city, California,1,2012,115113,44.1,74.3,10.2,55566,59547,58308,429,33146,422,592,39010,76103
6,22804,622804,Escondido city, California,1,2012,147556,42.7,71.4,11.2,70473,77083,120409,2847,9110,1541,13,83843,63713
6,23182,623182,Fairfield city, California,1,2012,107676,44,75.7,10.2,52352,55324,51527,12926,20059,662,1096,80232,27444
6,24477,624477,Florence-Graham CDP, California,0,2012,63284,49.5,65.8,5.9,32269,31015,35250,4885,68,978,8,5467,57817
6,24638,624638,Folsom city, California,1,2012,73381,41.1,74.5,10.8,40160,33221,53465,3466,9979,627,298,64729,8652
6,24680,624680,Fontana city, California,1,2012,201817,47.1,67.4,5.2,98638,103179,114607,18479,10460,2977,1070,67386,134431
6,26000,626000,Fremont city, California,1,2012,222001,43.5,75.5,10.3,110093,111908,67213,8251,115288,1534,964,195073,26928
6,27000,627000,Fresno city, California,1,2012,505870,44.3,70.3,9.7,249701,256169,245070,43739,68813,6128,935,268695,237175
6,28000,628000,Fullerton city, California,1,2012,138589,46.1,79.2,12.5,70074,68515,75571,2632,39130,400,157,95057,43532
6,29000,629000,Garden Grove city, California,1,2012,174401,41.6,75.8,11.7,87050,87351,76936,2087,68143,679,388,112115,62286
6,30000,630000,Glendale city, California,1,2012,194501,39.8,80,18.4,92391,102110,144148,3367,30594,657,104,160779,33722
6,32548,632548,Hawthorne city, California,1,2012,85682,50.1,71.7,7.2,41839,43843,34330,25803,6102,154,760,42008,43674
6,33000,633000,Hayward city, California,1,2012,149398,43.5,75.9,12.1,71935,77463,58768,21503,35000,1166,2837,90034,59364
6,33182,633182,Hemet city, California,1,2012,81041,35.2,71.3,19.9,39508,41533,53659,7371,1150,522,157,53568,27473
6,33434,633434,Hesperia city, California,1,2012,92066,42.3,71.6,10.2,46535,45531,66291,6511,1745,1486,477,48041,44025
6,36000,636000,Huntington Beach city, California,1,2012,194712,42.3,79.9,13.7,94876,99836,150990,1644,20659,790,501,155259,39453
6,36448,636448,Indio city, California,1,2012,79308,40.1,70.8,13.8,39287,40021,39738,3228,1579,719,90,26780,52528
6,36546,636546,Inglewood city, California,1,2012,111174,44,73.5,9.8,52203,58971,32872,48566,1178,705,800,55868,55306
6,36770,636770,Irvine city, California,1,2012,230005,49.1,76.7,9.7,117386,112619,115796,3894,93022,315,173,204432,25573
6,37692,637692,Jurupa Valley city, California,0,2012,97419,45.2,72.9,8.9,49057,48362,53546,2708,2469,2161,613,30213,67206
6,39496,639496,Lake Forest city, California,1,2012,78853,41,75.4,8.4,39428,39425,54126,879,11673,43,472,58730,20123
6,39892,639892,Lakewood city, California,1,2012,80835,39.7,77.2,12.2,38606,42229,46904,5776,15544,364,765,57513,23322
6,40130,640130,Lancaster city, California,1,2012,159041,44.1,69.7,8.4,81918,77123,109865,27353,6956,273,950,93483,65558
6,41992,641992,Livermore city, California,1,2012,83541,41.4,78.7,11.9,41560,41981,66568,2328,6265,585,695,65166,18375
6,43000,643000,Long Beach city, California,1,2012,467888,45.5,75.4,9.8,230532,237356,253647,61983,56805,3831,2841,272174,195714
6,44000,644000,Los Angeles city, California,1,2012,3857786,46.5,77.5,11,1918378,1939408,2013642,360124,442498,16392,4853,1989027,1868759
6,44574,644574,Lynwood city, California,1,2012,70720,47.4,64.4,5.9,34013,36707,17256,6864,300,408,0,8543,62177
6,45484,645484,Manteca city, California,1,2012,71070,42.7,73.6,10.3,33938,37132,47664,2106,5722,216,0,43507,27563
6,46842,646842,Menifee city, California,1,2012,81467,38.2,73.7,18.3,39112,42355,64840,4412,2237,252,97,52078,29389
6,46898,646898,Merced city, California,1,2012,80799,45.2,68.3,9.5,39516,41283,46325,3396,10397,668,0,39920,40879
6,47766,647766,Milpitas city, California,1,2012,68807,40.5,78.4,10.4,36015,32792,12936,1128,46126,187,116,59887,8920
6,48256,648256,Mission Viejo city, California,1,2012,95289,35.6,75.7,13.6,46248,49041,79713,717,7269,272,314,81458,13831
6,48354,648354,Modesto city, California,1,2012,203560,41.7,74.5,12.1,98031,105529,146283,7178,13681,1303,1143,124566,78994
6,49270,649270,Moreno Valley city, California,1,2012,199561,47.1,71.1,7.8,97667,101894,111335,33734,8539,1571,1000,86426,113135
6,49670,649670,Mountain View city, California,1,2012,76612,48.6,80.7,10.1,41646,34966,48728,1150,18913,198,400,57810,18802
6,50076,650076,Murrieta city, California,1,2012,106809,41.9,71.7,10.5,50828,55981,74260,6415,9548,888,717,79074,27735
6,50258,650258,Napa city, California,1,2012,78332,40.2,76,13.6,37952,40380,64641,436,1699,592,0,48122,30210
6,51182,651182,Newport Beach city, California,1,2012,87060,37.2,82.4,18.7,43470,43590,72694,497,4874,63,347,77208,9852
6,52526,652526,Norwalk city, California,1,2012,106286,43.1,75.8,12.9,52561,53725,62699,5342,16111,586,1346,36743,69543
6,53000,653000,Oakland city, California,1,2012,400740,45,78.5,11.3,194880,205860,164376,102456,64663,2536,2570,293461,107279
6,53322,653322,Oceanside city, California,1,2012,171272,41.8,76.2,13.4,86278,84994,109963,7936,11577,771,2076,109675,61597
6,53896,653896,Ontario city, California,1,2012,167207,44.8,72.9,8.2,82667,84540,95983,7469,9470,1349,0,45149,122058
6,53980,653980,Orange city, California,1,2012,139425,46.4,79.7,11.6,68762,70663,92068,2461,16859,746,1665,87792,51633
6,54652,654652,Oxnard city, California,1,2012,201565,46.4,71.6,9,104241,97324,150691,6272,15163,1754,773,50548,151017
6,55156,655156,Palmdale city, California,1,2012,155660,43.5,67.9,8.2,76224,79436,70519,17176,4694,596,149,59591,96069
6,55282,655282,Palo Alto city, California,0,2012,66359,35.4,77.8,16.8,32030,34329,42502,800,19788,49,0,61574,4785
6,56000,656000,Pasadena city, California,1,2012,138553,45.6,81.7,15.7,67221,71332,85532,16124,21230,695,112,98724,39829
6,56700,656700,Perris city, California,1,2012,71327,48.1,61.4,5.1,34511,36816,37602,11195,3485,436,0,23302,48025
6,57456,657456,Pittsburg city, California,0,2012,65655,43.3,71.1,8.8,31109,34546,23213,13899,9731,140,995,39584,26071
6,57792,657792,Pleasanton city, California,1,2012,72326,35.8,75.5,12.2,35453,36873,49138,1413,17203,22,186,61523,10803
6,58072,658072,Pomona city, California,1,2012,150817,47.9,72.1,8.3,73042,77775,98793,10248,14090,1399,363,44408,106409
6,59444,659444,Rancho Cordova city, California,0,2012,66999,41.8,75.1,12.9,33333,33666,41720,5927,7441,362,1413,54986,12013
6,59451,659451,Rancho Cucamonga city, California,1,2012,170740,42.8,76.1,9.4,83006,87734,109667,14011,24949,392,294,105812,64928
6,59920,659920,Redding city, California,1,2012,90750,41.1,79.5,19.1,46047,44703,78898,1692,4421,2081,0,82988,7762
6,59962,659962,Redlands city, California,1,2012,69908,37.8,75.9,15.6,33992,35916,53606,2456,5617,896,0,50560,19348
6,60018,660018,Redondo Beach city, California,1,2012,67683,42.1,78.6,11.2,33720,33963,49057,1902,8031,237,0,56349,11334
6,60102,660102,Redwood City city, California,1,2012,79005,43.5,76.9,10.8,40792,38213,57660,2219,8091,106,318,46184,32821
6,60466,660466,Rialto city, California,1,2012,101747,46.6,65.8,6.2,51368,50379,64166,14140,2381,888,0,24775,76972
6,60620,660620,Richmond city, California,1,2012,106526,43.9,75.6,9.8,51707,54819,49703,27395,13681,452,607,64186,42340
6,62000,662000,Riverside city, California,1,2012,313700,46.5,73.8,9.7,155676,158024,201768,18038,20773,2976,648,150157,163543
6,62938,662938,Roseville city, California,1,2012,124525,38.5,75.5,15,58081,66444,97596,1610,11086,192,199,105630,18895
6,64000,664000,Sacramento city, California,1,2012,475524,44.7,76.2,11.3,227955,247569,232757,71297,87977,2665,6729,343427,132097
6,64224,664224,Salinas city, California,1,2012,154463,47.6,68.6,7.7,78504,75959,105402,2761,11471,933,394,36057,118406
6,65000,665000,San Bernardino city, California,1,2012,213298,46.5,69.7,8.3,107045,106253,112628,27947,10766,2689,779,83665,129633
6,65042,665042,San Buenaventura (Ventura) city, California,1,2012,107755,38.9,78.8,14.9,51828,55927,89488,1935,4969,287,173,74690,33065
6,66000,666000,San Diego city, California,1,2012,1338354,48.1,79.2,11.3,670519,667835,852307,87569,230434,11130,5814,929566,408788
6,67000,667000,San Francisco city, California,1,2012,825863,48.8,86.6,14,419784,406079,409803,46406,274340,2640,3381,698987,126876
6,68000,668000,San Jose city, California,1,2012,982783,43.7,75.7,10.9,494487,488296,453617,30619,325098,6287,5174,656955,325828
6,68084,668084,San Leandro city, California,1,2012,86884,41.1,80.8,13.2,43240,43644,34179,10009,27678,1010,1508,63734,23150
6,68196,668196,San Marcos city, California,1,2012,86756,44,74.9,11.4,40808,45948,66933,1886,6671,269,409,60348,26408
6,68252,668252,San Mateo city, California,1,2012,99653,42.9,80.2,14.7,48469,51184,63584,1706,18918,486,1791,72165,27488
6,68378,668378,San Ramon city, California,1,2012,73922,40.2,72,8.8,35814,38108,37980,1802,27583,251,232,68611,5311
6,69000,669000,Santa Ana city, California,1,2012,330913,49.2,70.8,6.7,165599,165314,174088,3887,32089,1843,655,70179,260734
6,69070,669070,Santa Barbara city, California,1,2012,89638,42.4,80.4,15.5,45666,43972,67966,2038,2919,407,74,53525,36113
6,69084,669084,Santa Clara city, California,1,2012,119307,48.1,76.5,9.7,59759,59548,55488,6070,45662,719,270,96215,23092
6,69088,669088,Santa Clarita city, California,1,2012,179005,39.6,74.7,11.1,88866,90139,131553,3282,17966,360,396,121063,57942
6,69196,669196,Santa Maria city, California,1,2012,101469,45.6,70.6,10.1,53229,48240,67231,1696,5657,1177,576,30582,70887
6,70000,670000,Santa Monica city, California,1,2012,91814,46,86.4,14.1,44445,47369,73780,3078,8579,235,330,74057,17757
6,70098,670098,Santa Rosa city, California,1,2012,170684,39.2,76.8,14,83382,87302,129599,2834,7489,2633,1439,118813,51871
6,72016,672016,Simi Valley city, California,1,2012,125794,38.9,73.6,11.1,62490,63304,96173,2229,11134,335,123,96731,29063
6,73080,673080,South Gate city, California,1,2012,95297,49,71.5,8.7,47883,47414,47633,854,547,930,0,3263,92034
6,73262,673262,South San Francisco city, California,0,2012,65565,41,74.9,11.8,32568,32997,26360,1626,23314,286,1838,42080,23485
6,75000,675000,Stockton city, California,1,2012,297975,42.4,68.6,10.3,143947,154028,122464,32986,63383,3059,3364,177737,120238
6,77000,677000,Sunnyvale city, California,1,2012,146199,46.4,76.7,10.8,75394,70805,71663,3951,58560,644,649,114898,31301
6,78120,678120,Temecula city, California,1,2012,105213,43.5,68.2,7.2,51383,53830,80152,2337,12031,1452,36,80385,24828
6,78582,678582,Thousand Oaks city, California,1,2012,128411,36.9,75.6,15.2,64030,64381,104423,1090,9844,106,81,103878,24533
6,80000,680000,Torrance city, California,1,2012,147036,38.6,78.9,15.8,71747,75289,74888,4917,49749,122,655,118035,29001
6,80238,680238,Tracy city, California,1,2012,84682,42.1,70.6,9.6,43195,41487,54145,5124,9700,158,124,48040,36642
6,80812,680812,Turlock city, California,1,2012,69735,42.1,72.7,13.8,33597,36138,56806,1082,6019,123,198,45648,24087
6,80854,680854,Tustin city, California,1,2012,78044,46.3,71.2,7.9,38252,39792,37723,2814,16918,84,128,46685,31359
6,81204,681204,Union City city, California,1,2012,71749,40.8,74.9,12.5,35001,36748,18502,4702,34583,781,1156,55439,16310
6,81344,681344,Upland city, California,1,2012,75208,41,75.2,14,35662,39546,46607,3963,5192,401,0,45279,29929
6,81554,681554,Vacaville city, California,1,2012,93899,42.1,75,11.1,50278,43621,63287,6935,6861,196,543,74300,19599
6,81666,681666,Vallejo city, California,1,2012,117814,40.8,78.2,13.1,56908,60906,52357,26370,26260,529,1125,87022,30792
6,82590,682590,Victorville city, California,1,2012,120327,45.9,66.1,9,58379,61948,70094,32116,3164,1471,72,63821,56506
6,82954,682954,Visalia city, California,1,2012,127072,44.5,70.1,11.1,61595,65477,97344,1985,8829,1549,87,68198,58874
6,82996,682996,Vista city, California,1,2012,96046,45.3,77.2,11.5,48178,47868,80970,3346,3191,1102,99,48938,47108
6,83346,683346,Walnut Creek city, California,0,2012,65696,31,83.6,27.8,30347,35349,54272,261,8469,657,0,61020,4676
6,84200,684200,West Covina city, California,1,2012,107472,45.1,75.5,12.8,51914,55558,39311,4262,26944,1015,160,47189,60283
6,84550,684550,Westminster city, California,1,2012,91355,39.9,77.7,16.7,45124,46231,32701,632,47561,89,327,73281,18074
6,85292,685292,Whittier city, California,1,2012,86159,44.8,77.3,11.8,41956,44203,52973,914,3920,52,371,26087,60072
6,86832,686832,Yorba Linda city, California,0,2012,66739,35.4,76.5,15.5,32185,34554,47445,67,13667,0,0,55670,11069
6,86972,686972,Yuba City city, California,0,2012,65105,43.9,73.4,12.6,33191,31914,42388,1218,12119,726,0,47148,17957
8,3455,803455,Arvada city, Colorado,1,2012,109315,34.9,77.9,15.9,53305,56010,98113,984,1907,1058,26,93596,15719
8,4000,804000,Aurora city, Colorado,1,2012,338835,43.6,73.3,9.9,168352,170483,223122,56817,14916,3243,808,243919,94916
8,7850,807850,Boulder city, Colorado,1,2012,101812,58.9,85.1,9.3,50702,51110,91562,1352,3726,93,19,92889,8923
8,12815,812815,Centennial city, Colorado,1,2012,103735,34.8,74.6,13.9,50819,52916,88763,2561,4805,817,319,95842,7893
8,16000,816000,Colorado Springs city, Colorado,1,2012,431846,43.1,76,11.6,214440,217406,348013,28963,13552,2172,636,357287,74559
8,20000,820000,Denver city, Colorado,1,2012,634265,48.4,78.3,10.5,317233,317032,479745,64566,21689,5941,464,434399,199866
8,27425,827425,Fort Collins city, Colorado,1,2012,148634,53.2,80.9,8.4,73287,75347,131686,2081,4415,751,373,131815,16819
8,32155,832155,Greeley city, Colorado,1,2012,95365,46.7,75.3,12,47098,48267,69531,2114,1776,1532,35,62990,32375
8,36410,836410,Highlands Ranch CDP, Colorado,0,2012,101898,39.3,71.1,7.9,51276,50622,90853,508,7763,207,0,94597,7301
8,43000,843000,Lakewood city, Colorado,1,2012,145522,42.6,79.5,13.9,71927,73595,129486,2412,4654,2336,0,112972,32550
8,45970,845970,Longmont city, Colorado,1,2012,88636,43.1,75.2,11.7,47119,41517,76416,1832,3624,464,0,64521,24115
8,46465,846465,Loveland city, Colorado,1,2012,70214,36.1,76.3,15.1,34525,35689,61977,108,747,155,0,61351,8863
8,62000,862000,Pueblo city, Colorado,1,2012,107775,39.1,76.3,16.2,51325,56450,79933,2736,430,2134,0,51247,56528
8,77290,877290,Thornton city, Colorado,1,2012,124131,45.1,69.7,7.1,61642,62489,107507,1158,7043,632,78,86484,37647
8,83835,883835,Westminster city, Colorado,1,2012,109181,41.5,77.7,10,54269,54912,91743,1367,6700,582,0,87429,21752
9,8000,908000,Bridgeport city, Connecticut,1,2012,146434,47.2,75,9.8,71262,75172,61154,52636,4767,971,0,86177,60257
9,18430,918430,Danbury city, Connecticut,1,2012,82783,46.5,82.6,12.7,41435,41348,52751,7517,5519,223,253,64434,18349
9,37000,937000,Hartford city, Connecticut,1,2012,124887,48.3,74.8,8.6,61378,63509,54065,47485,3134,566,28,70630,54257
9,50370,950370,New Britain city, Connecticut,1,2012,73148,43.8,75.2,11,34040,39108,49952,6600,1604,0,0,43716,29432
9,52000,952000,New Haven city, Connecticut,1,2012,130749,51.6,77.3,10.4,62720,68029,55794,48665,5997,327,63,96932,33817
9,55990,955990,Norwalk city, Connecticut,1,2012,87196,39.8,80.1,14.8,43724,43472,60975,14518,5287,238,0,68956,18240
9,73000,973000,Stamford city, Connecticut,1,2012,125102,44,76.4,12.7,61575,63527,81386,16103,9846,143,62,92735,32367
9,80000,980000,Waterbury city, Connecticut,1,2012,109915,41.7,74.7,12.4,53857,56058,73722,20998,1296,475,0,70985,38930
10,77580,1077580,Wilmington city, Delaware,1,2012,71289,43.1,76.2,12.8,32771,38518,26947,39561,806,102,0,60245,11044
11,50000,1150000,Washington city, District of Columbia,1,2012,632323,51.2,82.7,11.4,299036,333287,250657,313224,21858,2258,54,569597,62726
12,410,1200410,Alafaya CDP, Florida,0,2012,85334,46.6,72.7,7.9,41455,43879,60789,8009,10499,310,0,52190,33144
12,7300,1207300,Boca Raton city, Florida,1,2012,87848,36.8,80.3,20.2,43048,44800,76469,5204,2511,0,0,77283,10565
12,7875,1207875,Boynton Beach city, Florida,1,2012,70120,39,80.2,22.3,32918,37202,41745,20697,3638,120,0,60314,9806
12,8150,1208150,Brandon CDP, Florida,0,2012,101167,44.2,76.1,11.1,48682,52485,72018,19139,2217,134,13,79827,21340
12,10275,1210275,Cape Coral city, Florida,1,2012,161237,33.1,77.4,17.6,78778,82459,144166,9008,3050,1010,0,129434,31803
12,12875,1212875,Clearwater city, Florida,1,2012,108732,34.7,80.7,21,51784,56948,88290,11724,3349,124,82,96150,12582
12,14400,1214400,Coral Springs city, Florida,1,2012,125275,42,73.7,8.6,59216,66059,87281,23628,6075,130,0,95841,29434
12,16475,1216475,Davie town, Florida,1,2012,95492,39.6,78.3,12.9,45511,49981,73837,10446,4316,0,0,64087,31405
12,16725,1216725,Deerfield Beach city, Florida,1,2012,77426,35.3,80,21.9,36624,40802,47608,26006,655,0,0,67789,9637
12,17200,1217200,Deltona city, Florida,1,2012,85436,40,78.3,14.8,41969,43467,70027,7440,1292,561,249,55827,29609
12,24000,1224000,Fort Lauderdale city, Florida,1,2012,170747,38.8,79.6,16,88017,82730,106854,51586,2824,157,320,141420,29327
12,24125,1224125,Fort Myers city, Florida,0,2012,65733,38.6,83.2,19.9,32714,33019,43526,19396,969,136,0,54826,10907
12,25175,1225175,Gainesville city, Florida,1,2012,126038,62.8,85.7,7.5,61036,65002,83661,25371,8866,450,196,112990,13048
12,30000,1230000,Hialeah city, Florida,1,2012,231953,40.4,81.3,18.7,111493,120460,218084,7367,1444,0,0,11980,219973
12,32000,1232000,Hollywood city, Florida,1,2012,145241,37.4,79.9,16.5,72482,72759,106545,22264,3569,288,0,96815,48426
12,35000,1235000,Jacksonville city, Florida,1,2012,836507,42.4,76.7,11.7,404710,431797,505082,250500,37272,2467,1058,767713,68794
12,36100,1236100,Kendall CDP, Florida,0,2012,75640,37.1,80.5,16.6,35507,40133,68198,3764,1872,186,0,29969,45671
12,38250,1238250,Lakeland city, Florida,1,2012,100009,38.5,76.2,19.1,47900,52109,75649,18634,773,214,118,84617,15392
12,39425,1239425,Largo city, Florida,1,2012,77871,34,84.3,25.1,36543,41328,67176,5135,1682,380,63,68860,9011
12,39550,1239550,Lauderhill city, Florida,1,2012,69083,39.1,75.8,13.3,32001,37082,13764,52055,1237,370,0,64647,4436
12,39925,1239925,Lehigh Acres CDP, Florida,0,2012,104011,42.9,70.9,12.2,53952,50059,70670,17610,500,554,0,64214,39797
12,43975,1243975,Melbourne city, Florida,1,2012,77047,34.5,82.6,21.2,37009,40038,64240,7400,2751,0,0,70309,6738
12,45000,1245000,Miami city, Florida,1,2012,413864,42.8,81.2,15.6,209756,204108,313496,82688,4652,557,0,130757,283107
12,45025,1245025,Miami Beach city, Florida,1,2012,90579,45.3,84.4,15.5,46532,44047,67190,4518,2376,152,112,44244,46335
12,45060,1245060,Miami Gardens city, Florida,1,2012,110739,44,76,11.8,51250,59489,23560,82454,679,0,0,83811,26928
12,45975,1245975,Miramar city, Florida,1,2012,128737,46.6,74.8,7.5,60274,68463,57927,57404,3526,48,0,78301,50436
12,53000,1253000,Orlando city, Florida,1,2012,249525,50.6,77,9.2,116126,133399,142314,77311,7653,394,36,180652,68873
12,54000,1254000,Palm Bay city, Florida,1,2012,104136,34.1,76.9,18.3,47435,56701,82113,16082,1571,0,0,87633,16503
12,54200,1254200,Palm Coast city, Florida,1,2012,79980,31.2,79.1,24.2,36924,43056,61002,10990,1825,0,64,71846,8134
12,55775,1255775,Pembroke Pines city, Florida,1,2012,160292,39.3,78.4,15.3,76521,83771,106064,32182,7898,458,93,89722,70570
12,56825,1256825,Pine Hills CDP, Florida,0,2012,69219,44.3,70.3,10.2,34822,34397,10413,50698,1233,180,0,61470,7749
12,57425,1257425,Plantation city, Florida,1,2012,88019,39.5,79.4,15.8,42696,45323,61106,16910,3884,0,0,68769,19250
12,58050,1258050,Pompano Beach city, Florida,1,2012,102968,39,82,17.4,54494,48474,63110,32270,1245,146,243,86247,16721
12,58715,1258715,Port St. Lucie city, Florida,1,2012,168718,36.7,75,17.2,81988,86730,126452,27863,2924,401,228,135788,32930
12,60950,1260950,Riverview CDP, Florida,0,2012,79420,41.3,73.6,8.7,40470,38950,58280,14864,1246,32,0,64962,14458
12,63000,1263000,St. Petersburg city, Florida,1,2012,246533,39.3,81.8,17.1,120515,126018,169944,60839,7368,832,121,225799,20734
12,68350,1268350,Spring Hill CDP, Florida,0,2012,101269,33.6,79.1,23.3,47902,53367,89295,4839,1828,77,0,86226,15043
12,69700,1269700,Sunrise city, Florida,1,2012,88859,41.6,78,14.2,38985,49874,52031,25941,4840,51,0,62200,26659
12,70600,1270600,Tallahassee city, Florida,1,2012,186977,60.5,83.1,8.3,89040,97937,107303,64337,7351,355,0,173911,13066
12,71000,1271000,Tampa city, Florida,1,2012,347650,45.4,77.7,10.9,169497,178153,225771,86746,13124,624,126,265595,82055
12,72145,1272145,Town 'n' Country CDP, Florida,0,2012,81597,44.7,78.6,12.5,42213,39384,65745,5893,3140,282,0,47198,34399
12,76582,1276582,Weston city, Florida,0,2012,67645,40,69.5,7.7,32200,35445,54911,3248,4921,84,0,36642,31003
12,76600,1276600,West Palm Beach city, Florida,1,2012,101910,41.4,82.1,17.1,49206,52704,66073,29545,1720,73,0,79900,22010
13,1052,1301052,Albany city, Georgia,1,2012,79150,43.4,73.9,12.1,37199,41951,20993,55507,904,22,0,77137,2013
13,3440,1303440,Athens-Clarke County unified government (balance), Georgia,1,2012,118866,59.4,82.3,9,55528,63338,78220,32149,5031,366,0,106048,12818
13,4000,1304000,Atlanta city, Georgia,1,2012,443768,52.9,81.6,9.6,223655,220113,173766,237154,17449,1351,308,420446,23322
13,4204,1304204,Augusta-Richmond County consolidated government (balance), Georgia,1,2012,197696,43,75.7,12.1,96043,101653,76825,109162,3419,932,0,188717,8979
13,19000,1319000,Columbus city, Georgia,1,2012,198413,43.7,74.6,11.4,97554,100859,92326,89055,4368,564,178,184151,14262
13,42425,1342425,Johns Creek city, Georgia,1,2012,82325,38,70,5.4,39801,42524,53847,10427,14726,90,0,77534,4791
13,49000,1349000,Macon city, Georgia,1,2012,91271,40.7,72.7,13,41158,50113,26416,61846,628,26,0,88387,2884
13,67284,1367284,Roswell city, Georgia,1,2012,93683,37.4,75.7,13.5,47866,45817,75684,11282,4353,563,0,81548,12135
13,68516,1368516,Sandy Springs city, Georgia,1,2012,99423,48.1,77.7,11.2,47083,52340,69092,17427,6629,108,0,84281,15142
13,69000,1369000,Savannah city, Georgia,1,2012,142010,46.9,77.4,12.2,68149,73861,54817,79663,2874,567,144,134070,7940
13,80508,1380508,Warner Robins city, Georgia,1,2012,70970,45,73.2,9.6,33507,37463,35223,27358,987,84,238,64904,6066
15,71550,1571550,Urban Honolulu CDP, Hawaii,0,2012,345604,40.9,82.7,17.7,172670,172934,58816,5885,190481,370,29365,321952,23652
16,8830,1608830,Boise City city, Idaho,1,2012,212299,42.8,78.1,11.9,106562,105737,191564,2530,7369,2056,179,196866,15433
16,52120,1652120,Meridian city, Idaho,1,2012,80391,41,66.1,10.9,38881,41510,-998,-998,-998,-998,-998,73672,6719
16,56260,1656260,Nampa city, Idaho,1,2012,83932,43.9,67.4,10.6,40145,43787,-998,-998,-998,-998,-998,66053,17879
17,2154,1702154,Arlington Heights village, Illinois,1,2012,74976,33.4,77.7,21.5,36299,38677,67806,1132,4452,79,0,70571,4405
17,3012,1703012,Aurora city, Illinois,1,2012,203318,44.8,69.1,7.5,102797,100521,116142,18137,14501,1168,0,113218,90100
17,6613,1706613,Bloomington city, Illinois,1,2012,77733,43.1,75.8,11.3,36722,41011,60932,9008,4950,40,0,74650,3083
17,7133,1707133,Bolingbrook village, Illinois,1,2012,77155,44.8,70,7.4,39347,37808,39818,17660,8276,599,0,61722,15433
17,12385,1712385,Champaign city, Illinois,1,2012,82509,58.1,84.2,8.6,42726,39783,55545,11310,12277,99,0,78373,4136
17,14000,1714000,Chicago city, Illinois,1,2012,2714844,47.6,77.4,10.9,1315782,1399062,1311393,866026,160568,8066,979,1926336,788508
17,14351,1714351,Cicero town, Illinois,1,2012,84129,50.6,65,4.9,44091,40038,41733,2905,468,314,0,8711,75418
17,18823,1718823,Decatur city, Illinois,1,2012,76346,37.4,77.7,17.1,36547,39799,54797,16585,1012,0,0,74404,1942
17,23074,1723074,Elgin city, Illinois,1,2012,109290,44.2,70.1,9.2,54154,55136,69812,9327,4641,750,0,60282,49008
17,24582,1724582,Evanston city, Illinois,1,2012,75420,47.7,78.5,11.3,35181,40239,49363,14265,8034,0,0,68140,7280
17,38570,1738570,Joliet city, Illinois,1,2012,146781,44.9,71.5,8.8,72672,74109,100674,19687,2837,905,37,107183,39598
17,51622,1751622,Naperville city, Illinois,1,2012,145137,37.2,72.3,10.7,71443,73694,104750,8414,25973,162,0,135318,9819
17,57225,1757225,Palatine village, Illinois,1,2012,69254,40.2,76,12.4,33644,35610,51338,2543,9319,0,740,59091,10163
17,59000,1759000,Peoria city, Illinois,1,2012,116845,43.3,75.3,13,56540,60305,73170,31270,6040,682,0,109958,6887
17,65000,1765000,Rockford city, Illinois,1,2012,151019,39.1,74.7,14.9,73312,77707,99044,30526,4287,139,0,125016,26003
17,68003,1768003,Schaumburg village, Illinois,1,2012,74228,40.6,78,14,35473,38755,50729,3079,14488,0,0,64791,9437
17,70122,1770122,Skokie village, Illinois,0,2012,65076,34.8,77.4,15.7,30636,34440,41226,3891,17293,66,0,57971,7105
17,72000,1772000,Springfield city, Illinois,1,2012,117019,39.5,76.7,14.2,56657,60362,88162,22167,2610,314,0,113619,3400
17,79293,1779293,Waukegan city, Illinois,1,2012,86273,43.6,70.7,8.6,43687,42586,59180,15817,3415,217,0,38196,48077
18,5860,1805860,Bloomington city, Indiana,1,2012,78592,69.3,88.9,8.6,40247,38345,64325,3214,7552,639,67,75556,3036
18,10342,1810342,Carmel city, Indiana,1,2012,84515,37.2,73.1,11.1,40773,43742,69952,3390,7223,107,0,81770,2745
18,22000,1822000,Evansville city, Indiana,1,2012,120059,41,78.6,15.1,56031,64028,99683,13287,837,646,26,115957,4102
18,23278,1823278,Fishers town, Indiana,1,2012,82087,39.9,69.7,5.7,39462,42625,71985,3070,3407,294,0,78729,3358
18,25000,1825000,Fort Wayne city, Indiana,1,2012,252427,40.7,74.3,13.3,122279,130148,184069,41147,9720,913,936,230686,21741
18,27000,1827000,Gary city, Indiana,1,2012,75611,35.1,72.8,16.4,34389,41222,9031,64453,116,104,0,72518,3093
18,31000,1831000,Hammond city, Indiana,1,2012,79686,41.7,72.3,9.9,38964,40722,37448,18775,971,449,85,52364,27322
18,36003,1836003,Indianapolis city (balance), Indiana,1,2012,835806,43.5,75,10.8,402471,433335,511806,229068,18298,2949,0,752188,83618
18,40788,1840788,Lafayette city, Indiana,1,2012,66820,45.6,76.6,12.7,32308,34512,58704,5436,769,91,0,57630,9190
18,51876,1851876,Muncie city, Indiana,1,2012,69841,52.1,83.7,13.1,32457,37384,58776,3631,837,219,0,68027,1814
18,71000,1871000,South Bend city, Indiana,1,2012,100003,41.3,72.2,12.2,49285,50718,61156,26958,1414,470,53,85518,14485
19,12000,1912000,Cedar Rapids city, Iowa,1,2012,128124,42.4,76.6,12.9,62798,65326,111093,8550,2988,202,86,122868,5256
19,19000,1919000,Davenport city, Iowa,1,2012,101354,40.5,77.3,13,50082,51272,83578,10206,1475,407,0,93412,7942
19,21000,1921000,Des Moines city, Iowa,1,2012,206568,42.9,74.8,11.2,100899,105669,159799,21311,10833,923,139,179977,26591
19,38595,1938595,Iowa City city, Iowa,1,2012,70131,59.9,84.6,8.5,35649,34482,55490,4100,6316,0,0,65732,4399
19,73335,1973335,Sioux City city, Iowa,1,2012,84297,40.2,74.6,12.9,42170,42127,70239,2706,2379,1518,0,69979,14318
19,82425,1982425,Waterloo city, Iowa,1,2012,68294,39.7,76.7,14.6,33701,34593,54401,10381,823,0,0,63617,4677
20,36000,2036000,Kansas City city, Kansas,1,2012,145410,40.7,71.8,11.1,71406,74004,87070,38888,4146,1378,828,104224,41186
20,38900,2038900,Lawrence city, Kansas,1,2012,88634,59.2,82.8,8.3,43369,45265,74778,3726,4396,1808,81,82727,5907
20,52575,2052575,Olathe city, Kansas,1,2012,130031,43.6,70.6,7.4,63343,66688,112816,6485,4912,363,107,114662,15369
20,53775,2053775,Overland Park city, Kansas,1,2012,178941,39.4,77,14.1,88836,90105,150739,7656,14129,256,36,166809,12132
20,71000,2071000,Topeka city, Kansas,1,2012,127942,39.3,75.2,15.2,61052,66890,99200,13004,1921,1371,0,109815,18127
20,79000,2079000,Wichita city, Kansas,1,2012,385586,40.5,74.3,12.3,190196,195390,297088,43503,18928,4272,24,326343,59243
21,46027,2146027,Lexington-Fayette urban county, Kentucky,1,2012,305489,47.2,78.9,11,150269,155220,235352,42816,10493,511,45,284170,21319
21,48006,2148006,Louisville/Jefferson County metro government (balance), Kentucky,1,2012,605108,40.5,76.8,13,294111,310997,430659,138894,13352,543,208,575717,29391
22,5000,2205000,Baton Rouge city, Louisiana,1,2012,230040,48.2,80.1,11.6,111949,118091,88624,127558,7794,624,0,224255,5785
22,39475,2239475,Kenner city, Louisiana,1,2012,66813,38.8,81.5,15.5,32331,34482,42257,16679,2894,122,0,55200,11613
22,40735,2240735,Lafayette city, Louisiana,1,2012,122749,46.6,76.9,11.4,59772,62977,78367,36838,2820,215,13,117065,5684
22,41155,2241155,Lake Charles city, Louisiana,1,2012,73481,41.1,77.2,13.1,34655,38826,34153,34609,1870,105,0,70458,3023
22,50115,2250115,Metairie CDP, Louisiana,0,2012,137210,40.9,80.3,17.1,65985,71225,110059,15212,5418,657,0,118419,18791
22,55000,2255000,New Orleans city, Louisiana,1,2012,369250,44.3,78.6,11.4,177208,192042,125220,220735,10775,1235,0,349593,19657
22,70000,2270000,Shreveport city, Louisiana,1,2012,201878,40.5,75.4,13.3,95818,106060,84900,109836,3229,402,55,195739,6139
23,60545,2360545,Portland city, Maine,1,2012,66211,48.9,83,11.9,32476,33735,54690,4693,4198,76,0,64247,1964
24,4000,2404000,Baltimore city, Maryland,1,2012,621342,44.6,78.5,11.9,292599,328743,187742,394998,15757,1862,46,593771,27571
24,19125,2419125,Columbia CDP, Maryland,0,2012,104129,42,75.1,10.6,51358,52771,58455,24761,12427,249,516,96048,8081
24,26000,2426000,Ellicott City CDP, Maryland,0,2012,71933,34.7,73,13.9,34902,37031,46367,7948,14608,0,0,68962,2971
24,30325,2430325,Frederick city, Maryland,0,2012,66390,44.4,78.5,12.5,31083,35307,44246,11815,2802,601,229,55894,10496
24,32025,2432025,Germantown CDP, Maryland,0,2012,91541,43.5,73.5,6.8,43822,47719,45408,17747,19917,232,0,71503,20038
24,32650,2432650,Glen Burnie CDP, Maryland,0,2012,70285,41.7,80.4,12.7,32689,37596,46515,15235,4227,49,148,66249,4036
24,72450,2472450,Silver Spring CDP, Maryland,0,2012,73958,51.5,81.7,7.9,34917,39041,31325,20286,8020,93,0,57200,16758
24,81175,2481175,Waldorf CDP, Maryland,0,2012,72890,45.3,72.8,6.6,34753,38137,26082,39777,2787,1099,0,67592,5298
25,7000,2507000,Boston city, Massachusetts,1,2012,637516,54.5,82.7,10.5,306561,330955,340877,166148,58186,2300,0,518942,118574
25,9000,2509000,Brockton city, Massachusetts,1,2012,94092,38.9,73.6,14.2,45778,48314,45298,37817,1947,278,0,86737,7355
25,11000,2511000,Cambridge city, Massachusetts,1,2012,106456,61.6,89.8,11.9,52607,53849,75710,12152,12243,243,46,98995,7461
25,23000,2523000,Fall River city, Massachusetts,1,2012,88943,38,79.7,15.5,42070,46873,76759,3320,1544,244,0,81402,7541
25,24960,2524960,Framingham CDP, Massachusetts,0,2012,70076,44.2,81.6,14.2,33599,36477,52737,5319,5587,5,0,60230,9846
25,34550,2534550,Lawrence city, Massachusetts,1,2012,77321,45.4,70.6,8.8,36316,41005,28797,10446,1988,203,0,18204,59117
25,37000,2537000,Lowell city, Massachusetts,1,2012,108528,46.4,78,9.9,53078,55450,60370,7814,22954,611,0,89502,19026
25,37490,2537490,Lynn city, Massachusetts,1,2012,91247,43.5,73,10.9,45273,45974,46406,10831,6741,60,53,58992,32255
25,45000,2545000,New Bedford city, Massachusetts,1,2012,94929,41,78.4,17.1,45835,49094,73724,7022,1031,777,0,78888,16041
25,45560,2545560,Newton city, Massachusetts,1,2012,86304,37.8,76.6,16.9,39893,46411,68295,3188,12403,8,0,82355,3949
25,55745,2555745,Quincy city, Massachusetts,1,2012,93031,45.6,84.4,13.7,45940,47091,61727,4568,23021,169,0,89746,3285
25,62535,2562535,Somerville city, Massachusetts,1,2012,77112,62.7,85.2,8.6,36317,40795,57074,6453,9268,36,0,70644,6468
25,67000,2567000,Springfield city, Massachusetts,1,2012,153557,43,73.3,11.4,73411,80146,84052,31844,2593,1087,0,88061,65496
25,82000,2582000,Worcester city, Massachusetts,1,2012,182680,45,76.1,11.2,87696,94984,131261,23637,11225,520,0,145153,37527
26,3000,2603000,Ann Arbor city, Michigan,1,2012,116128,59.1,86.2,10.4,57942,58186,84544,8154,19000,168,0,111977,4151
26,21000,2621000,Dearborn city, Michigan,1,2012,96470,38.4,70,12.6,46011,50459,86508,3882,1621,182,0,93142,3328
26,22000,2622000,Detroit city, Michigan,1,2012,701524,41.6,74.6,12.2,331941,369583,87281,572298,7569,2580,42,649103,52421
26,27440,2627440,Farmington Hills city, Michigan,1,2012,80752,36.6,79.7,15.8,38285,42467,54497,13915,9106,490,0,78546,2206
26,29000,2629000,Flint city, Michigan,1,2012,100515,39.9,75.5,12.8,48809,51706,39531,56638,202,483,0,96489,4026
26,34000,2634000,Grand Rapids city, Michigan,1,2012,190426,47.6,75.1,10.9,92359,98067,132308,37894,4529,1008,0,159904,30522
26,42160,2642160,Kalamazoo city, Michigan,1,2012,75092,54.7,80.1,10.2,36645,38447,51555,17175,2049,315,0,70889,4203
26,46000,2646000,Lansing city, Michigan,1,2012,113488,48.1,76.9,9.6,52941,60547,71038,26068,4308,749,140,101046,12442
26,49000,2649000,Livonia city, Michigan,1,2012,95576,35.6,78.4,16.5,47448,48128,88700,2268,2427,152,0,93198,2378
26,69035,2669035,Rochester Hills city, Michigan,1,2012,72288,34.6,78.4,16.9,35365,36923,58795,6471,5483,103,9,71213,1075
26,74900,2674900,Southfield city, Michigan,1,2012,72502,35.1,80,20.1,32561,39941,20512,47513,1259,126,0,70574,1928
26,76460,2676460,Sterling Heights city, Michigan,1,2012,130414,40.2,78.6,14.2,63970,66444,111601,6821,9161,36,0,127937,2477
26,80700,2680700,Troy city, Michigan,1,2012,82211,38.4,79,14.8,39744,42467,62481,2516,15015,72,0,80510,1701
26,84000,2684000,Warren city, Michigan,1,2012,134155,38.4,77.6,16.6,64559,69596,101118,21321,6267,201,0,131286,2869
26,86000,2686000,Westland city, Michigan,1,2012,82868,41.2,77.8,13.1,40951,41917,61477,14851,3198,245,0,79267,3601
26,88940,2688940,Wyoming city, Michigan,1,2012,73374,43.3,76,8.5,38798,34576,63033,3088,1552,1070,0,59468,13906
27,6616,2706616,Bloomington city, Minnesota,1,2012,86031,36.3,81.4,19.1,40764,45267,67130,6710,5195,175,264,78604,7427
27,7966,2707966,Brooklyn Park city, Minnesota,1,2012,77762,41.2,71.7,9.9,39527,38235,43869,19749,11061,319,0,74112,3650
27,17000,2717000,Duluth city, Minnesota,1,2012,86197,47.4,81.7,13.7,43086,43111,77941,2080,1123,1583,68,85476,721
27,43000,2743000,Minneapolis city, Minnesota,1,2012,392871,51.6,79.3,8.1,197360,195511,262253,70474,22628,4780,108,351687,41184
27,51730,2751730,Plymouth city, Minnesota,1,2012,72928,40.8,77.6,12.2,35815,37113,60716,3037,6579,352,0,69495,3433
27,54880,2754880,Rochester city, Minnesota,1,2012,108994,41.3,76.1,13.3,52687,56307,89784,6996,8456,125,0,103352,5642
27,56896,2756896,St. Cloud city, Minnesota,0,2012,64949,49.4,80.4,10.7,35487,29462,52803,6027,1535,546,0,63546,1403
27,58000,2758000,St. Paul city, Minnesota,1,2012,290776,46.9,74.2,9,142871,147905,177504,45731,45634,1235,52,264461,26315
28,29700,2829700,Gulfport city, Mississippi,1,2012,70101,40,77,13.5,35308,34793,42098,25476,581,238,0,64704,5397
28,36000,2836000,Jackson city, Mississippi,1,2012,175376,44.4,73.5,10.3,80687,94689,31889,139207,749,129,0,172359,3017
29,15670,2915670,Columbia city, Missouri,1,2012,113230,57,81.2,8.5,54366,58864,91039,7928,6068,532,0,108607,4623
29,35000,2935000,Independence city, Missouri,1,2012,117264,36.6,77.9,17.3,56924,60340,101471,6230,547,901,76,107072,10192
29,38000,2938000,Kansas City city, Missouri,1,2012,464346,42.4,75.6,11.6,222506,241840,272691,139934,10825,2698,118,417852,46494
29,41348,2941348,Lee's Summit city, Missouri,1,2012,92770,39.9,73.8,12.1,43766,49004,78893,7824,2453,63,576,87173,5597
29,54074,2954074,O'Fallon city, Missouri,1,2012,81983,41.5,71.5,9.8,39986,41997,-998,-998,-998,-998,-998,80085,1898
29,64082,2964082,St. Charles city, Missouri,0,2012,66454,44.9,78.8,14.2,32986,33468,57247,5238,1722,622,0,64336,2118
29,64550,2964550,St. Joseph city, Missouri,1,2012,76523,42.3,77.8,14.3,38509,38014,67344,3274,1082,151,299,71787,4736
29,65000,2965000,St. Louis city, Missouri,1,2012,318172,45.8,78.7,11.2,153196,164976,143417,152068,9220,900,0,306574,11598
29,70000,2970000,Springfield city, Missouri,1,2012,162193,49.4,81.6,14.2,77130,85063,143851,6710,4368,1320,1098,156244,5949
30,6550,3006550,Billings city, Montana,1,2012,106964,39,78,14.9,51607,55357,95649,517,1210,5038,0,101867,5097
30,50200,3050200,Missoula city, Montana,1,2012,68386,51.4,81.4,11.5,33894,34492,62390,40,1131,720,214,65517,2869
31,28000,3128000,Lincoln city, Nebraska,1,2012,265389,46.6,77.7,11.2,132472,132917,231664,10319,10239,2481,201,248311,17078
31,37000,3137000,Omaha city, Nebraska,1,2012,421564,42.6,74.6,11.6,205466,216098,314990,57054,11594,2856,25,363702,57862
32,23770,3223770,Enterprise CDP, Nevada,0,2012,123493,49.6,75.2,6.9,62847,60646,71568,12413,24061,546,2526,99911,23582
32,31900,3231900,Henderson city, Nevada,1,2012,265688,38.1,79,16.7,129401,136287,212809,14575,19577,1057,301,226655,39033
32,40000,3240000,Las Vegas city, Nevada,1,2012,596440,41.4,76.2,13.6,298671,297769,400931,61749,36402,3346,2099,400647,195793
32,51800,3251800,North Las Vegas city, Nevada,1,2012,223489,45.5,66.4,7.1,110870,112619,106952,45868,13477,1494,3619,138743,84746
32,54600,3254600,Paradise CDP, Nevada,0,2012,230184,44.6,76.7,11.3,119102,111082,145791,21328,21162,1081,1489,153799,76385
32,60600,3260600,Reno city, Nevada,1,2012,231004,43.9,77.3,13.1,115821,115183,182512,6180,15340,2827,1768,171495,59509
32,68400,3268400,Sparks city, Nevada,1,2012,92177,40,76.7,12.9,44232,47945,74569,2030,5247,1378,311,67506,24671
32,68585,3268585,Spring Valley CDP, Nevada,0,2012,177162,44.3,79.9,12.3,88787,88375,101025,19259,34126,1200,1585,137721,39441
32,71400,3271400,Sunrise Manor CDP, Nevada,0,2012,190583,42.7,72,9.6,95304,95279,117206,23740,12285,2241,1453,101436,89147
33,45140,3345140,Manchester city, New Hampshire,1,2012,110197,43.6,78.9,13.8,53275,56922,95680,5275,4039,80,0,102212,7985
33,50260,3350260,Nashua city, New Hampshire,1,2012,86932,42.4,79.2,13.2,43823,43109,74678,2241,7118,0,0,78317,8615
34,10000,3410000,Camden city, New Jersey,1,2012,77235,46.8,67,7,37594,39641,8972,39662,1284,675,0,39151,38084
34,13690,3413690,Clifton city, New Jersey,1,2012,84722,42.1,77.3,11.8,41650,43072,65136,3976,7019,484,0,56206,28516
34,19390,3419390,East Orange city, New Jersey,0,2012,64275,39.7,76.6,15.2,29933,34342,2017,57184,433,102,0,58537,5738
34,21000,3421000,Elizabeth city, New Jersey,1,2012,126459,43.8,71.8,9.6,60572,65887,67565,28860,2019,451,0,47013,79446
34,36000,3436000,Jersey City city, New Jersey,1,2012,254444,49.4,79.2,9.8,124851,129593,88488,67085,61965,1459,25,185209,69235
34,51000,3451000,Newark city, New Jersey,1,2012,277718,47.2,73.7,8.5,135983,141735,63733,137461,5954,1055,432,180026,97692
34,56550,3456550,Passaic city, New Jersey,1,2012,70215,47.9,66.1,6.6,35529,34686,37638,12150,1382,154,0,22392,47823
34,57000,3457000,Paterson city, New Jersey,1,2012,145236,43.7,73.4,10.4,68700,76536,65402,46986,5468,329,0,57838,87398
34,73110,3473110,Toms River CDP, New Jersey,0,2012,88984,36.1,77.5,17.2,43912,45072,82400,2176,3294,0,0,81984,7000
34,74000,3474000,Trenton city, New Jersey,1,2012,84492,47.2,74,8,41508,42984,31829,44606,828,99,0,57562,26930
34,74630,3474630,Union City city, New Jersey,1,2012,67751,48.8,77.7,9.6,34260,33491,40427,4417,1853,0,0,9636,58115
35,2000,3502000,Albuquerque city, New Mexico,1,2012,555419,42.4,76.3,12.8,269330,286089,384566,18373,14026,23905,665,296235,259184
35,39380,3539380,Las Cruces city, New Mexico,1,2012,101053,44,74.1,13.4,51347,49706,87275,1767,2201,1982,0,42478,58575
35,63460,3563460,Rio Rancho city, New Mexico,1,2012,90805,39.8,71.7,11.2,44234,46571,76364,3040,891,1987,45,53689,37116
35,70500,3570500,Santa Fe city, New Mexico,1,2012,69211,34,80.3,19.5,31524,37687,59339,829,1019,1120,0,34610,34601
36,1000,3601000,Albany city, New York,1,2012,97905,48.8,83.9,12.2,46725,51180,56811,30691,4536,453,0,88374,9531
36,11000,3611000,Buffalo city, New York,1,2012,259386,44.9,76.9,11.3,123034,136352,128663,95223,11733,1140,173,232234,27152
51,3000,5103000,Arlington CDP, Virginia,0,2012,221045,55.3,83.8,8.9,110100,110945,160578,19583,22006,450,293,187035,34010
51,14440,5114440,Centreville CDP, Virginia,0,2012,67202,45.4,76.5,6.5,34107,33095,36438,5001,19065,96,0,60497,6705
51,16000,5116000,Chesapeake city, Virginia,1,2012,228417,40.5,75.2,11.1,111029,117388,143877,67827,7209,681,103,217420,10997
51,21088,5121088,Dale City CDP, Virginia,0,2012,73534,41.1,70,7.5,36612,36922,37376,21581,5833,271,0,52921,20613
51,35000,5135000,Hampton city, Virginia,1,2012,136836,42.3,77.8,13,64924,71912,58445,69705,3862,652,0,129992,6844
51,47672,5147672,Lynchburg city, Virginia,1,2012,77113,48.7,80.8,13.8,36615,40498,49237,21565,1732,246,0,74643,2470
51,56000,5156000,Newport News city, Virginia,1,2012,180726,45,76.3,11,87544,93182,91747,71199,5015,775,209,166493,14233
51,57000,5157000,Norfolk city, Virginia,1,2012,245782,51.2,79.3,9.6,127912,117870,117707,104236,6662,995,492,228159,17623
51,64000,5164000,Portsmouth city, Virginia,1,2012,96470,41.2,76.3,13.6,46024,50446,39785,51722,946,176,93,93242,3228
51,67000,5167000,Richmond city, Virginia,1,2012,210309,48.1,80.6,11.3,99218,111091,91110,103831,3887,1123,72,196899,13410
51,68000,5168000,Roanoke city, Virginia,1,2012,97469,40.4,78.1,14.3,46510,50959,62594,26434,2104,792,68,91870,5599
51,76432,5176432,Suffolk city, Virginia,1,2012,85181,38.9,74.7,12.3,40650,44531,44969,35709,1414,105,0,82420,2761
51,82000,5182000,Virginia Beach city, Virginia,1,2012,447021,44,76.8,11.3,219367,227654,303805,86078,28845,976,347,414862,32159
53,3180,5303180,Auburn city, Washington,1,2012,73165,44.2,73.4,9.2,35828,37337,50474,3450,5269,1536,415,59437,13728
53,5210,5305210,Bellevue city, Washington,1,2012,126447,44.9,80.6,13.9,64846,61601,75486,3282,39275,460,148,119584,6863
53,5280,5305280,Bellingham city, Washington,1,2012,82234,48,84.6,15.8,39836,42398,71526,669,3422,1879,109,76280,5954
53,22640,5322640,Everett city, Washington,1,2012,104643,45.2,76.9,10.3,54136,50507,76196,5651,9136,864,1175,84264,20379
53,23515,5323515,Federal Way city, Washington,1,2012,91933,42.5,75.1,9.2,45102,46831,53376,9248,10933,1563,1959,74885,17048
53,35275,5335275,Kennewick city, Washington,1,2012,75984,44.7,74.2,11.9,37982,38002,61224,1396,2148,279,0,58099,17885
53,35415,5335415,Kent city, Washington,1,2012,123005,45.5,71.6,9,61903,61102,68198,14218,18220,764,5008,101192,21813
53,53545,5353545,Pasco city, Washington,0,2012,64029,44.7,64.4,5,31222,32807,37511,958,1702,0,75,29542,34487
53,57745,5357745,Renton city, Washington,1,2012,95422,44.2,78.9,11.7,46117,49305,53714,12261,22190,294,1105,85994,9428
53,63000,5363000,Seattle city, Washington,1,2012,634541,50.7,84.7,11.4,313386,321155,441308,45715,92535,5103,1327,588128,46413
53,67000,5367000,Spokane city, Washington,1,2012,209504,41.5,77.8,14.5,102984,106520,183521,4098,6649,3997,470,199083,10421
53,67167,5367167,Spokane Valley city, Washington,1,2012,90638,39.6,76.3,14.4,45011,45627,80154,2607,3340,1062,51,86156,4482
53,70000,5370000,Tacoma city, Washington,1,2012,201999,43.3,76,11.3,99392,102607,127766,21381,16263,3565,2634,178833,23166
53,74060,5374060,Vancouver city, Washington,1,2012,165502,42.5,76.5,13.8,83286,82216,126688,5302,12286,1361,3115,145848,19654
53,80010,5380010,Yakima city, Washington,1,2012,93123,40.5,72.9,13.9,45739,47384,70038,1124,2001,768,220,53024,40099
55,2375,5502375,Appleton city, Wisconsin,1,2012,71898,42,77,11.9,34991,36907,63041,1402,3546,639,86,68862,3036
55,22300,5522300,Eau Claire city, Wisconsin,0,2012,67186,52.4,81.3,12.1,33474,33712,62117,790,2628,194,0,65906,1280
55,31000,5531000,Green Bay city, Wisconsin,1,2012,104869,41.4,76,14.1,52370,52499,89415,3390,5122,2820,0,90181,14688
55,39225,5539225,Kenosha city, Wisconsin,1,2012,100139,43.2,73.2,10.9,49274,50865,83955,11220,2005,201,37,83550,16589
55,48000,5548000,Madison city, Wisconsin,1,2012,240315,54.1,81.5,9.8,120240,120075,189831,19523,19814,1004,0,225067,15248
55,53000,5553000,Milwaukee city, Wisconsin,1,2012,598920,46.6,72.8,8.9,287906,311014,274226,238310,21198,3903,88,490129,108791
55,60500,5560500,Oshkosh city, Wisconsin,0,2012,66647,47.3,80.9,12.9,34203,32444,61005,2654,1226,323,0,63649,2998
55,66000,5566000,Racine city, Wisconsin,1,2012,78293,40.6,72.6,11.6,38238,40055,52309,16584,133,946,0,61220,17073
55,84250,5584250,Waukesha city, Wisconsin,1,2012,70914,43.3,78.2,12.4,35171,35743,60732,3107,2815,216,0,63282,7632
72,10334,7210334,Caguas zona urbana, Puerto Rico,0,2012,80119,38.3,77.2,19.3,36797,43322,66163,7597,401,37,0,590,79529
72,14290,7214290,Carolina zona urbana, Puerto Rico,0,2012,155111,39.9,78.3,17.8,70458,84653,93197,36189,549,3623,0,2211,152900
72,32522,7232522,Guaynabo zona urbana, Puerto Rico,0,2012,74216,40.5,79.3,18,34930,39286,58743,3615,431,469,0,1049,73167
72,63820,7263820,Ponce zona urbana, Puerto Rico,0,2012,130627,38.8,75.4,16.5,61022,69605,95921,8655,37,44,0,867,129760
72,76770,7276770,San Juan zona urbana, Puerto Rico,0,2012,367412,39.1,79.3,18.3,168085,199327,239357,61586,3773,1903,0,6470,360942
36,15000,3615000,Cheektowaga CDP, New York,0,2012,75599,35.9,82.5,19.8,34807,40792,61740,10265,1190,131,0,73312,2287
36,49121,3649121,Mount Vernon city, New York,1,2012,67902,41.1,77.4,15.1,30605,37297,17721,41590,2200,91,74,56935,10967
36,50617,3650617,New Rochelle city, New York,1,2012,78390,39,78.2,16.4,38808,39582,54525,13985,3048,109,0,56064,22326
36,51000,3651000,New York city, New York,1,2012,8336697,45,78.6,12.5,3971426,4365271,3647131,2058522,1091449,30230,3548,5929807,2406890
36,63000,3663000,Rochester city, New York,1,2012,210521,45.9,77.5,10.7,102531,107990,94990,86386,8569,1151,0,175877,34644
36,65508,3665508,Schenectady city, New York,1,2012,66072,44,75.8,11.9,31528,34544,40055,12881,2898,236,0,59008,7064
36,73000,3673000,Syracuse city, New York,1,2012,144161,47.4,76.9,12,68739,75422,80011,42015,8167,1962,50,132582,11579
36,84000,3684000,Yonkers city, New York,1,2012,198457,39.5,77.5,14.8,92620,105837,111061,34889,11791,1248,54,127260,71197
37,2140,3702140,Asheville city, North Carolina,1,2012,85721,43.1,81.1,16.7,40142,45579,70482,10697,2084,0,0,81287,4434
37,10740,3710740,Cary town, North Carolina,1,2012,145830,40.6,72.1,8.7,71152,74678,108123,11968,18050,1199,162,131743,14087
37,12000,3712000,Charlotte city, North Carolina,1,2012,775208,46.6,75.1,8.8,372991,402217,407772,271441,42313,3597,980,670295,104913
37,14100,3714100,Concord city, North Carolina,1,2012,81976,41.3,72.1,11,40692,41284,62565,15175,2084,87,0,71143,10833
37,19000,3719000,Durham city, North Carolina,1,2012,239320,48.6,77.5,9.7,112315,127005,117578,95537,11417,1470,388,208164,31156
37,22920,3722920,Fayetteville city, North Carolina,1,2012,202105,46.8,75.2,10.9,97667,104438,93781,82881,5265,2558,297,179126,22979
37,25580,3725580,Gastonia city, North Carolina,1,2012,72735,37.5,72,12.7,35552,37183,46509,19916,1011,140,0,67476,5259
37,28000,3728000,Greensboro city, North Carolina,1,2012,277095,45.6,77.3,12,132167,144928,131026,118409,12671,1161,65,255468,21627
37,28080,3728080,Greenville city, North Carolina,1,2012,87248,59.5,80.6,7.5,40196,47052,48339,34030,2461,334,0,83265,3983
37,31400,3731400,High Point city, North Carolina,1,2012,108443,42.7,77.3,13.6,50079,58364,61174,34312,8158,974,0,100377,8066
37,34200,3734200,Jacksonville city, North Carolina,1,2012,69221,59.8,75.7,7.4,39414,29807,43894,16610,1760,252,65,58239,10982
37,55000,3755000,Raleigh city, North Carolina,1,2012,423743,50,77.8,8.8,202748,220995,255854,126167,20142,883,79,379660,44083
37,74440,3774440,Wilmington city, North Carolina,1,2012,109927,45.8,81.2,14,51603,58324,84603,18980,2359,63,0,104117,5810
37,75000,3775000,Winston-Salem city, North Carolina,1,2012,234354,42.7,75.9,12.9,110099,124255,136932,83870,5192,122,0,199601,34753
38,25700,3825700,Fargo city, North Dakota,1,2012,109467,51.3,80.5,10,54723,54744,97759,3137,2473,1562,19,106100,3367
39,1000,3901000,Akron city, Ohio,1,2012,198551,42,76.8,12.4,95383,103168,124941,59211,4847,381,47,194533,4018
39,12000,3912000,Canton city, Ohio,1,2012,72684,39.9,77.2,14.2,32767,39917,50878,14764,659,617,0,71740,944
39,15000,3915000,Cincinnati city, Ohio,1,2012,296552,46.2,77.6,11,140789,155763,150005,130712,5194,1116,0,289480,7072
39,16000,3916000,Cleveland city, Ohio,1,2012,390923,41.3,76.5,12.2,186203,204720,150263,210520,7403,1180,95,349282,41641
39,18000,3918000,Columbus city, Ohio,1,2012,809890,49.6,77.1,9,395576,414314,500239,225908,35453,2138,270,765512,44378
39,21000,3921000,Dayton city, Ohio,1,2012,141354,43.5,77.2,11.8,68474,72880,77228,56668,1351,146,0,135522,5832
39,44856,3944856,Lorain city, Ohio,0,2012,63710,38.1,76.1,14.8,28408,35302,46849,11158,318,147,0,46403,17307
39,61000,3961000,Parma city, Ohio,1,2012,80596,37.6,80.1,18.2,38072,42524,73921,2506,2166,28,0,76549,4047
39,77000,3977000,Toledo city, Ohio,1,2012,284022,41.9,77.1,12.8,138808,145214,183094,77134,3038,1130,0,260694,23328
39,88000,3988000,Youngstown city, Ohio,1,2012,65387,36.9,75.7,15.5,32739,32648,30515,29274,885,623,0,58054,7333
40,9050,4009050,Broken Arrow city, Oklahoma,1,2012,103534,40.4,73.5,12.5,50332,53202,79706,4579,4379,4325,26,96061,7473
40,23200,4023200,Edmond city, Oklahoma,1,2012,84871,40.3,72.2,10.5,40963,43908,70407,4609,3450,2245,122,80341,4530
40,41850,4041850,Lawton city, Oklahoma,1,2012,98373,47.2,77,9.6,50990,47383,59450,19772,2486,5698,650,84749,13624
40,52500,4052500,Norman city, Oklahoma,1,2012,115563,51.4,79.9,10.7,57910,57653,94558,4007,4487,4037,71,108327,7236
40,55000,4055000,Oklahoma City city, Oklahoma,1,2012,599309,42.5,74.4,11.2,294837,304472,404951,84566,24898,17577,0,494497,104812
40,75000,4075000,Tulsa city, Oklahoma,1,2012,394098,41.3,75.6,12.4,192172,201926,262157,58472,9987,16341,596,335960,58138
41,5350,4105350,Beaverton city, Oregon,1,2012,92677,45.1,76.6,10.4,43935,48742,65392,1992,11823,1306,618,77389,15288
41,5800,4105800,Bend city, Oregon,1,2012,79118,38,75.4,14.6,38830,40288,74503,0,1316,68,35,72432,6686
41,23850,4123850,Eugene city, Oregon,1,2012,157984,50.2,84.4,13.3,77005,80979,135505,2519,6713,968,492,146150,11834
41,31250,4131250,Gresham city, Oregon,1,2012,108958,42.6,75.7,12.6,54656,54302,85066,4795,5999,1128,400,86228,22730
41,34100,4134100,Hillsboro city, Oregon,1,2012,95340,47.8,72.8,8.4,45167,50173,68861,1349,9646,759,484,73420,21920
41,47000,4147000,Medford city, Oregon,1,2012,76459,37.4,75.1,16.2,37643,38816,67613,1062,1237,750,322,65501,10958
41,59000,4159000,Portland city, Oregon,1,2012,603650,47.5,80.8,10.8,297942,305708,475727,36746,42465,3581,4730,546601,57049
41,64900,4164900,Salem city, Oregon,1,2012,157425,41.3,74.5,12.2,78074,79351,128450,1885,5154,1381,2028,123816,33609
42,2000,4202000,Allentown city, Pennsylvania,1,2012,118974,43.4,74.4,11.2,57207,61767,73358,16365,1271,390,0,63817,55157
42,6088,4206088,Bethlehem city, Pennsylvania,1,2012,75729,45.7,78.5,15.6,37191,38538,60437,5698,1999,63,0,56255,19474
42,24000,4224000,Erie city, Pennsylvania,1,2012,101040,43.5,77.2,13.8,49392,51648,73987,16970,2421,730,19,94640,6400
42,60000,4260000,Philadelphia city, Pennsylvania,1,2012,1547607,45.4,77.5,12.2,731316,816291,637549,667585,99319,5680,5151,1346606,201001
42,61000,4261000,Pittsburgh city, Pennsylvania,1,2012,306212,50,83.9,13.4,148331,157881,204589,75220,15299,689,197,297832,8380
42,63624,4263624,Reading city, Pennsylvania,1,2012,88096,44.6,68.1,8.8,43441,44655,53193,12157,1706,1314,206,35313,52783
42,69000,4269000,Scranton city, Pennsylvania,1,2012,75813,41.6,81.9,16,36835,38978,65040,4856,3394,61,30,67337,8476
44,19180,4419180,Cranston city, Rhode Island,1,2012,80539,39.1,79.9,14.4,39422,41117,65547,4369,4929,305,64,72156,8383
44,54640,4454640,Pawtucket city, Rhode Island,1,2012,71174,42.1,78.5,12.3,35146,36028,48298,10283,1246,209,57,56233,14941
44,59000,4459000,Providence city, Rhode Island,1,2012,178438,53.3,78,8.4,87262,91176,91665,30625,11969,2164,25,107542,70896
44,74300,4474300,Warwick city, Rhode Island,1,2012,81873,36.6,81,16.6,38948,42925,73239,1628,3870,182,0,78141,3732
45,13330,4513330,Charleston city, South Carolina,1,2012,125941,49.3,82.9,12.1,60789,65152,91468,29947,1209,134,43,120711,5230
45,16000,4516000,Columbia city, South Carolina,1,2012,131303,54.6,80.8,9.4,69060,62243,65433,56840,2752,0,158,122613,8690
45,48535,4548535,Mount Pleasant town, South Carolina,1,2012,71883,37.6,73.3,12.3,32907,38976,-998,-998,-998,-998,-998,67238,4645
45,50875,4550875,North Charleston city, South Carolina,1,2012,102262,47.2,75.8,8.6,50730,51532,47649,46335,2359,289,0,93016,9246
45,61405,4561405,Rock Hill city, South Carolina,1,2012,68087,48.1,75.7,9.6,33123,34964,35432,27944,1117,124,0,64862,3225
46,52980,4652980,Rapid City city, South Dakota,1,2012,69849,39.5,74.7,14.3,35303,34546,55790,926,1010,6668,290,66272,3577
46,59020,4659020,Sioux Falls city, South Dakota,1,2012,159992,43,75.7,11.5,78714,81278,136845,7408,3741,5098,0,152089,7903
47,14000,4714000,Chattanooga city, Tennessee,1,2012,171282,42,79.5,15,83520,87762,103821,58559,4227,336,85,162600,8682
47,15160,4715160,Clarksville city, Tennessee,1,2012,142517,50.9,72,6.3,69128,73389,94761,32368,3166,985,507,127427,15090
47,27740,4727740,Franklin city, Tennessee,0,2012,66278,39.6,75,10.9,32271,34007,-998,-998,-998,-998,-998,62841,3437
47,37640,4737640,Jackson city, Tennessee,0,2012,67263,41.4,76.3,14,30579,36684,-998,-998,-998,-998,-998,64471,2792
47,40000,4740000,Knoxville city, Tennessee,1,2012,182196,47,82.7,15.8,86097,96099,139551,34605,2031,325,156,176927,5269
47,48000,4748000,Memphis city, Tennessee,1,2012,655141,43.6,75,10.6,314253,340888,202136,413365,9516,2069,406,612187,42954
47,51560,4751560,Murfreesboro city, Tennessee,1,2012,114044,50.1,75.6,8.6,56998,57046,87096,17598,4513,111,363,109491,4553
47,52006,4752006,Nashville-Davidson metropolitan government (balance), Tennessee,1,2012,623255,47,78.2,10.4,301627,321628,377215,178796,21226,1151,82,560113,63142
48,1000,4801000,Abilene city, Texas,1,2012,118881,44.8,77.4,13.7,60924,57957,94331,12087,2428,423,0,87653,31228
48,1924,4801924,Allen city, Texas,1,2012,89631,39.2,70.1,6.6,43365,46266,62460,11433,9372,1032,0,82866,6765
48,3000,4803000,Amarillo city, Texas,1,2012,195571,42.6,72.5,12,94805,100766,161335,12211,6303,1597,804,133748,61823
48,4000,4804000,Arlington city, Texas,1,2012,375598,46.5,73.6,8.1,184403,191195,258389,72464,23724,1207,85,270796,104802
48,4462,4804462,Atascocita CDP, Texas,0,2012,67714,42.2,66.1,7,33910,33804,44576,19075,1072,184,0,52716,14998
48,5000,4805000,Austin city, Texas,1,2012,842595,52.9,78.3,7.3,424725,417870,647851,65431,54084,5272,776,555745,286850
48,6128,4806128,Baytown city, Texas,1,2012,72044,39.6,70.8,11.3,35351,36693,52339,8492,616,1208,0,37931,34113
48,7000,4807000,Beaumont city, Texas,1,2012,118241,42.1,73.4,12.1,55667,62574,56595,55840,2140,307,94,99145,19096
48,10768,4810768,Brownsville city, Texas,1,2012,180077,43,67.2,10.4,85723,94354,164033,973,1970,139,29,12292,167785
48,10912,4810912,Bryan city, Texas,1,2012,78073,51.6,77.3,10.5,40920,37153,47932,13646,1860,502,0,48382,29691
48,13024,4813024,Carrollton city, Texas,1,2012,125395,41.6,73.6,9.3,61547,63848,88560,10607,15831,1182,100,86875,38520
48,15976,4815976,College Station city, Texas,1,2012,97794,68.4,83.3,5.1,49775,48019,78127,6357,9209,203,78,83267,14527
48,17000,4817000,Corpus Christi city, Texas,1,2012,312192,41.4,74.6,12.4,153740,158452,261050,14644,5753,1594,376,121988,190204
48,19000,4819000,Dallas city, Texas,1,2012,1241108,46.5,74.5,9.4,626205,614903,738525,309069,40222,2858,915,727082,514026
48,19972,4819972,Denton city, Texas,1,2012,121123,54.8,78,9,58491,62632,92845,15268,3985,496,59,95809,25314
48,22660,4822660,Edinburg city, Texas,1,2012,81033,46.8,71.2,6.9,39940,41093,74721,964,1378,680,0,8743,72290
48,24000,4824000,El Paso city, Texas,1,2012,672534,42.5,71.8,11.7,326575,345959,563281,25380,8582,3785,1066,140349,532185
48,26232,4826232,Flower Mound town, Texas,0,2012,67808,39.2,72.1,6,33512,34296,57021,3326,4540,469,0,60508,7300
48,27000,4827000,Fort Worth city, Texas,1,2012,782027,44.8,71.3,8.9,381663,400364,531430,148245,32330,3094,2004,518434,263593
48,27684,4827684,Frisco city, Texas,1,2012,128171,43.4,67,7.1,62972,65199,95240,7527,17400,616,0,114330,13841
48,29000,4829000,Garland city, Texas,1,2012,233623,42.2,71.6,10.2,116876,116747,101637,30920,26646,1234,320,133192,100431
48,30464,4830464,Grand Prairie city, Texas,1,2012,181791,43.9,70,6,90699,91092,120516,38462,9834,883,0,95497,86294
48,32372,4832372,Harlingen city, Texas,0,2012,65688,39.9,70.1,13.1,32617,33071,-998,-998,-998,-998,-998,13668,52020
48,35000,4835000,Houston city, Texas,1,2012,2161686,46.1,74.4,9.6,1085083,1076603,1247112,508366,141213,8144,1157,1222804,938882
48,37000,4837000,Irving city, Texas,1,2012,225427,48.8,73.9,7.3,106232,119195,104681,31458,35752,2057,0,140370,85057
48,39148,4839148,Killeen city, Texas,1,2012,134662,52.3,70.2,5,66606,68056,64861,49849,4216,573,1674,104261,30401
48,41464,4841464,Laredo city, Texas,1,2012,244143,44,65.6,8.3,119111,125032,229556,329,2120,570,94,11697,232446
48,41980,4841980,League City city, Texas,1,2012,88679,40.4,73.4,7.7,44338,44341,75053,5645,3974,460,0,70546,18133
48,42508,4842508,Lewisville city, Texas,1,2012,99763,49.4,74.9,8,48424,51339,68104,9754,11626,119,175,71299,28464
48,43888,4843888,Longview city, Texas,1,2012,80831,40,75.4,13.8,38842,41989,56507,17872,1529,320,751,63719,17112
48,45000,4845000,Lubbock city, Texas,1,2012,236060,48,77.1,11.6,115966,120094,183915,18399,5566,666,525,155251,80809
48,45384,4845384,McAllen city, Texas,1,2012,134729,43,71.6,11.2,66102,68627,114215,642,5317,818,0,17116,117613
48,45744,4845744,McKinney city, Texas,1,2012,143216,45.3,67.8,7.6,70862,72354,117866,13794,6328,713,71,116476,26740
48,47892,4847892,Mesquite city, Texas,1,2012,143484,43.1,68.2,7.7,68103,75381,102400,30464,3563,405,0,86907,56577
48,48072,4848072,Midland city, Texas,1,2012,119384,42.8,73.4,11.2,57626,61758,98725,9781,1927,224,0,70141,49243
48,48768,4848768,Mission city, Texas,1,2012,80449,40.2,65.3,11.4,38874,41575,-998,-998,-998,-998,-998,15502,64947
48,48804,4848804,Missouri City city, Texas,1,2012,67968,38.3,78.3,13.8,31973,35995,19848,27451,11082,176,0,56679,11289
48,52356,4852356,North Richland Hills city, Texas,0,2012,65289,40,77,14.1,32241,33048,53771,3766,1890,1130,0,53141,12148
48,53388,4853388,Odessa city, Texas,1,2012,106483,43.2,72.2,10.5,53132,53351,90732,6403,1521,543,0,49384,57099
48,56000,4856000,Pasadena city, Texas,1,2012,152257,44.6,70.2,8.4,77207,75050,123367,4891,3839,1602,0,55918,96339
48,56348,4856348,Pearland city, Texas,1,2012,96665,45,71.9,8.4,49328,47337,57581,17182,8987,380,0,72988,23677
48,57200,4857200,Pharr city, Texas,1,2012,73126,42.5,63.5,12.6,36244,36882,-998,-998,-998,-998,-998,6199,66927
48,58016,4858016,Plano city, Texas,1,2012,270816,40.1,74.3,9.7,134416,136400,193072,19979,45167,449,133,223522,47294
48,61796,4861796,Richardson city, Texas,1,2012,103268,41.7,78,14.5,53237,50031,69979,9710,13490,521,55,86242,17026
48,63500,4863500,Round Rock city, Texas,1,2012,105933,47.8,70.7,6.6,52402,53531,83094,11686,5811,446,0,74777,31156
48,64472,4864472,San Angelo city, Texas,1,2012,99085,42.8,76.9,14.5,48686,50399,86320,5456,1459,591,0,59923,39162
48,65000,4865000,San Antonio city, Texas,1,2012,1383194,43.5,73.9,11.2,674220,708974,1022508,96310,32699,12033,2582,503968,879226
48,70808,4870808,Sugar Land city, Texas,1,2012,82479,35.7,78,10.2,40781,41698,41680,4995,32567,140,126,75467,7012
48,72176,4872176,Temple city, Texas,0,2012,69147,36.9,76.8,16.6,33346,35801,52230,11837,1955,222,216,53469,15678
48,72656,4872656,The Woodlands CDP, Texas,0,2012,103533,36.4,71.1,11,49312,54221,92454,797,4699,233,0,89328,14205
48,74144,4874144,Tyler city, Texas,1,2012,99321,45,77.1,14.9,47764,51557,70267,21867,1874,396,51,73328,25993
48,76000,4876000,Waco city, Texas,1,2012,127003,47.4,76.2,11.1,61602,65401,86739,25935,2517,610,33,84272,42731
48,79000,4879000,Wichita Falls city, Texas,1,2012,104557,44.9,77.3,13,54706,49851,82369,12538,2278,873,48,82682,21875
49,43660,4943660,Layton city, Utah,1,2012,68684,44,70.3,8.8,35538,33146,59570,877,2713,559,651,60272,8412
49,50150,4950150,Millcreek CDP, Utah,0,2012,66939,43,75.8,13.4,32689,34250,59039,969,3395,418,1178,63530,3409
49,55980,4955980,Ogden city, Utah,1,2012,83799,46.2,73,10.8,43992,39807,64436,2452,1015,1112,256,56927,26872
49,57300,4957300,Orem city, Utah,1,2012,90754,48.5,69.6,8.4,45507,45247,81676,574,1675,517,1388,75972,14782
49,62470,4962470,Provo city, Utah,1,2012,115925,60.9,77,7.1,56717,59208,102933,325,3367,198,1614,94696,21229
49,65330,4965330,St. George city, Utah,1,2012,75560,38.2,74.3,19.6,35798,39762,69736,680,431,913,217,67012,8548
49,67000,4967000,Salt Lake City city, Utah,1,2012,189311,52,78.9,10.1,97343,91968,136245,6215,11696,1706,5131,149503,39808
49,67440,4967440,Sandy city, Utah,1,2012,89348,39.9,69.6,10.2,44559,44789,81947,416,2362,138,43,83321,6027
49,82950,4982950,West Jordan city, Utah,1,2012,108390,46.6,68.2,5.1,54685,53705,93761,2879,2101,1301,2708,88628,19762
49,83470,4983470,West Valley City city, Utah,1,2012,132431,43.9,66.9,7.3,65994,66437,96155,2422,5379,1561,3397,82608,49823
51,1000,5101000,Alexandria city, Virginia,1,2012,146294,51.5,82.3,10,70447,75847,94618,32065,9688,227,0,121763,24531
72,6593,7206593,Bayam√≥n zona urbana, Puerto Rico,0,2012,181758,40.3,79.3,18.5,86152,95606,108141,15533,580,2075,22,1948,179810
72,52431,7252431,Mayag√ºez zona urbana, Puerto Rico,0,2012,67802,42.6,78.3,18.1,32085,35717,36659,2046,47,122,0,1001,66801
47,14000,4714000,Chattanooga city, Tennessee,1,2013,173375,41.4,77.5,14.5,82956,90419,103813,61264,3320,338,412,165825,7550
1,7000,107000,Birmingham city, Alabama,1,2013,211933,44.2,80.3,13,102318,109615,50047,154377,1704,307,0,204561,7372
1,21184,121184,Dothan city, Alabama,0,2013,67296,39.8,76.6,15.1,32208,35088,42739,21638,981,256,0,64717,2579
1,35896,135896,Hoover city, Alabama,1,2013,84128,41.1,74.5,13.6,38013,46115,59310,16897,4211,590,0,80103,4025
1,37000,137000,Huntsville city, Alabama,1,2013,186416,41.6,79,14.3,91771,94645,117148,58720,3813,804,156,177838,8578
1,50000,150000,Mobile city, Alabama,1,2013,194879,40.5,77,15.2,93792,101087,88827,99171,2829,144,0,187922,6957
1,51000,151000,Montgomery city, Alabama,1,2013,201335,41.9,75.1,12.7,95755,105580,72867,118085,3863,123,0,194215,7120
1,77256,177256,Tuscaloosa city, Alabama,1,2013,95334,53.7,80.7,9.4,46928,48406,46629,43538,2680,130,0,93437,1897
2,3000,203000,Anchorage municipality, Alaska,1,2013,300950,45.1,74.9,8.4,153776,147174,197183,17842,24675,22764,6800,274929,26021
4,4720,404720,Avondale city, Arizona,1,2013,78817,46.6,71.4,7.7,38195,40622,57766,9396,2874,994,89,40660,38157
4,10670,410670,Casas Adobes CDP, Arizona,0,2013,69653,36.1,74.5,17.2,34226,35427,60364,758,1885,373,0,54521,15132
4,12000,412000,Chandler city, Arizona,1,2013,249139,44.2,72.9,9,120608,128531,190254,13132,23219,2571,778,193329,55810
4,23620,423620,Flagstaff city, Arizona,0,2013,68661,61,83.1,8.4,34324,34337,49444,2273,1236,6560,277,54910,13751
4,27400,427400,Gilbert town, Arizona,1,2013,229989,43.4,68.2,7.7,116912,113077,195583,5516,17852,883,180,198157,31832
4,27820,427820,Glendale city, Arizona,1,2013,234618,41.8,73,10.8,118809,115809,188693,12116,7911,6230,300,145909,88709
4,28380,428380,Goodyear city, Arizona,0,2013,72862,39.8,74.9,15.7,31726,41136,52065,7188,4692,1291,130,53797,19065
4,46000,446000,Mesa city, Arizona,1,2013,457595,41.1,75.3,15.1,225463,232132,391780,15821,8813,10262,1827,333623,123972
4,54050,454050,Peoria city, Arizona,1,2013,162617,36.1,74.1,16.1,76476,86141,143391,3241,5501,1132,413,131149,31468
4,55000,455000,Phoenix city, Arizona,1,2013,1513350,44.5,73.3,9.1,756150,757200,1134127,104192,44936,31862,2643,888434,624916
4,64210,464210,San Tan Valley CDP, Arizona,0,2013,93346,44.3,63.9,6.6,47157,46189,78427,5297,918,884,1360,70095,23251
4,65000,465000,Scottsdale city, Arizona,1,2013,226909,35.8,81.9,21.1,112422,114487,200920,5017,9298,2008,44,201948,24961
4,71510,471510,Surprise city, Arizona,1,2013,123569,32.5,75,25.3,57361,66208,105634,6797,2672,738,183,100363,23206
4,73000,473000,Tempe city, Arizona,1,2013,168231,57.6,82.4,9,87787,80444,115657,9080,12949,4476,774,129511,38720
4,77000,477000,Tucson city, Arizona,1,2013,526141,45.6,78.1,13.1,260131,266010,379631,27614,16250,15974,1296,303741,222400
4,85540,485540,Yuma city, Arizona,1,2013,91915,42.5,73.3,14.5,49541,42374,63405,4019,1825,456,0,40126,51789
5,23290,523290,Fayetteville city, Arkansas,1,2013,78967,59.7,81,6.4,39325,39642,61939,8570,2150,520,0,72079,6888
5,24550,524550,Fort Smith city, Arkansas,1,2013,87654,40.2,75.4,11.9,42655,44999,68212,7669,5219,695,0,71757,15897
5,35710,535710,Jonesboro city, Arkansas,1,2013,71547,45.1,75,12.3,35821,35726,54265,12844,1083,477,0,67347,4200
5,41000,541000,Little Rock city, Arkansas,1,2013,197357,42.4,76.5,13,96468,100889,102255,81757,5656,641,182,186667,10690
5,50450,550450,North Little Rock city, Arkansas,0,2013,66086,39.2,74.9,14.3,31629,34457,-998,-998,-998,-998,-998,61992,4094
5,66080,566080,Springdale city, Arkansas,1,2013,73795,45.3,69.3,11.1,38288,35507,47016,2434,1669,1257,292,48613,25182
6,562,600562,Alameda city, California,1,2013,76413,37.2,79.1,15.9,37674,38739,35112,6541,23309,130,614,68199,8214
6,884,600884,Alhambra city, California,1,2013,84566,43.9,81.5,15.1,40301,44265,17806,1068,41535,316,64,51662,32904
6,2000,602000,Anaheim city, California,1,2013,345015,44.6,74.8,11.2,171941,173074,246909,9707,54741,1114,1678,166223,178792
6,2252,602252,Antioch city, California,1,2013,107098,41.5,73.3,11.1,50370,56728,52108,23652,10961,970,775,73124,33974
6,2364,602364,Apple Valley town, California,1,2013,70923,34.3,76.4,18,35978,34945,56546,3822,3080,377,0,45262,25661
6,2553,602553,Arden-Arcade CDP, California,0,2013,92438,41.3,78.5,16.7,44509,47929,61609,11019,5579,1484,243,76261,16177
6,3526,603526,Bakersfield city, California,1,2013,363630,44.1,69.1,9,179150,184480,247768,29040,27287,3237,536,194047,169583
6,3666,603666,Baldwin Park city, California,1,2013,76633,45,74.9,9.4,39069,37564,28450,723,10951,1561,0,15729,60904
6,4982,604982,Bellflower city, California,1,2013,77594,45.4,75.1,9.7,37964,39630,29263,11308,8392,595,522,34933,42661
6,6000,606000,Berkeley city, California,1,2013,116774,56.4,87.4,13.4,55703,61071,70246,10254,23997,499,487,105174,11600
6,8786,608786,Buena Park city, California,1,2013,82885,45.2,75.8,10.2,40746,42139,50447,4244,22416,99,289,50564,32321
6,8954,608954,Burbank city, California,1,2013,104717,41,80.1,15.7,49300,55417,76706,3018,10348,188,67,78198,26519
6,10046,610046,Camarillo city, California,0,2013,66076,39.8,75.2,18.2,32525,33551,47988,464,9053,0,0,49724,16352
6,11194,611194,Carlsbad city, California,1,2013,110977,34.6,76.6,14.6,56877,54100,94491,2363,7131,0,467,96591,14386
6,11390,611390,Carmichael CDP, California,0,2013,66747,37.8,76.5,17.6,31065,35682,54596,3433,2151,291,315,58629,8118
6,11530,611530,Carson city, California,1,2013,92597,40.7,78.3,14.6,44996,47601,27425,21781,25193,698,1112,57652,34945
6,13014,613014,Chico city, California,1,2013,88075,52,81.3,11.5,41729,46346,73572,1837,3397,715,321,72973,15102
6,13210,613210,Chino city, California,1,2013,81001,44.7,74.5,9.5,45007,35994,52386,3669,8353,177,56,38537,42464
6,13214,613214,Chino Hills city, California,1,2013,76575,40.5,73.7,8.2,36801,39774,37444,1931,28881,56,423,58070,18505
6,13392,613392,Chula Vista city, California,1,2013,256765,43,72,11,123706,133059,183472,10761,32162,1189,598,95964,160801
6,13588,613588,Citrus Heights city, California,1,2013,85288,42.7,81.5,13.7,41999,43289,70432,2920,3595,2076,46,72839,12449
6,14218,614218,Clovis city, California,1,2013,99758,41.7,73.3,12.6,47467,52291,70519,3185,11178,638,501,73958,25800
6,15044,615044,Compton city, California,1,2013,97872,44.7,69.2,9.4,47835,50037,37036,30259,503,571,0,31367,66505
6,16000,616000,Concord city, California,1,2013,125892,40.7,76.5,14.1,63078,62814,87069,4960,9969,842,0,82934,42958
6,16350,616350,Corona city, California,1,2013,159507,44,74.2,9.3,80964,78543,113725,9006,19927,970,364,93558,65949
6,16532,616532,Costa Mesa city, California,1,2013,112184,49.8,79.5,8.5,59396,52788,76144,1118,11754,376,1071,75895,36289
6,17918,617918,Daly City city, California,1,2013,104747,46.5,81.9,15.1,53029,51718,25447,3714,55900,305,249,74316,30431
6,18100,618100,Davis city, California,0,2013,66197,56.3,83.4,10.6,32704,33493,43798,1765,13955,38,127,57698,8499
6,19766,619766,Downey city, California,1,2013,113240,48.3,77,12,55806,57434,83815,6280,5990,499,54,32344,80896
6,20802,620802,East Los Angeles CDP, California,0,2013,137967,48.8,70.6,9,67176,70791,90389,221,1609,254,0,3424,134543
6,21712,621712,El Cajon city, California,1,2013,102207,42.7,73.5,10.8,50753,51454,73696,5855,3061,202,717,72324,29883
6,22020,622020,Elk Grove city, California,1,2013,161029,41.9,68.6,9.4,80252,80777,76985,18427,43231,392,2975,129951,31078
6,22230,622230,El Monte city, California,1,2013,115685,43.7,75.6,14,58680,57005,66096,1028,35486,253,0,41354,74331
6,22804,622804,Escondido city, California,1,2013,148728,46.2,74.9,10.1,71886,76842,119407,4063,8288,1199,310,75325,73403
6,23182,623182,Fairfield city, California,1,2013,109302,44.5,75,10.6,54416,54886,47581,16492,16242,752,1789,74704,34598
6,24638,624638,Folsom city, California,1,2013,73099,39.1,75.4,12,38633,34466,49922,4105,12403,108,204,66126,6973
6,24680,624680,Fontana city, California,1,2013,203008,46.2,68.3,6.7,100416,102592,105540,22012,14667,1169,1157,69644,133364
6,26000,626000,Fremont city, California,1,2013,224904,42.9,76.1,10.7,108836,116068,62417,7183,120731,1074,1311,193964,30940
6,27000,627000,Fresno city, California,1,2013,509965,44.2,70.1,9.7,249538,260427,268855,42836,68125,6867,961,265804,244161
6,28000,628000,Fullerton city, California,1,2013,138979,47.4,77.8,12.5,66085,72894,75660,4014,32258,305,492,85643,53336
6,29000,629000,Garden Grove city, California,1,2013,175115,42.5,75.6,11.9,89197,85918,74672,1752,61583,767,1645,107153,67962
6,30000,630000,Glendale city, California,1,2013,196000,42.1,81.6,16.2,93038,102962,141375,3339,31805,475,105,164009,31991
6,32548,632548,Hawthorne city, California,1,2013,86204,49.5,74.2,7.7,43101,43103,36391,18796,5637,159,931,36236,49968
6,33000,633000,Hayward city, California,1,2013,151582,45.1,78.3,11.7,73500,78082,55033,15394,37828,1379,4158,91764,59818
6,33182,633182,Hemet city, California,1,2013,81734,36.5,75.3,21.5,39449,42285,58863,5150,1791,525,0,47148,34586
6,33434,633434,Hesperia city, California,1,2013,92159,44.8,68.5,8,46928,45231,76847,4217,809,478,138,43823,48336
6,36000,636000,Huntington Beach city, California,1,2013,197577,41.3,79.4,15.3,97676,99901,155576,1808,23476,224,1065,158258,39319
6,36448,636448,Indio city, California,1,2013,83546,41.9,70.4,13.1,42526,41020,42321,1845,1635,899,777,23847,59699
6,36546,636546,Inglewood city, California,1,2013,111544,43.7,74,10.5,52735,58809,31645,45315,762,123,0,51040,60504
6,36770,636770,Irvine city, California,1,2013,236724,47.2,79,9.6,113416,123308,122292,3932,91945,523,15,208787,27937
6,37692,637692,Jurupa Valley city, California,0,2013,98036,44.2,72.4,8.9,46915,51121,55919,3602,873,980,364,29092,68944
6,39496,639496,Lake Forest city, California,1,2013,79300,39.6,76.3,12.6,39630,39670,51266,2155,10850,156,366,60976,18324
6,39892,639892,Lakewood city, California,1,2013,81136,40.2,74,10.6,38356,42780,44482,5632,13746,620,2874,55739,25397
6,40130,640130,Lancaster city, California,1,2013,159521,42.7,70.6,9.5,80263,79258,104446,31722,6161,898,284,95785,63736
6,41992,641992,Livermore city, California,1,2013,85169,37.3,72.3,10.8,40627,44542,68295,153,9706,94,0,66700,18469
6,43000,643000,Long Beach city, California,1,2013,469384,45.6,75.4,10.4,233932,235452,247260,64295,58532,9999,4057,271705,197679
6,44000,644000,Los Angeles city, California,1,2013,3884340,47,78,11,1928557,1955783,1994140,346154,441638,25381,8217,1970839,1913501
6,44574,644574,Lynwood city, California,1,2013,71387,49.5,65,5.3,34219,37168,46707,5444,1076,296,42,7869,63518
6,45484,645484,Manteca city, California,1,2013,71949,42.2,71.6,9.7,35327,36622,50704,2489,6079,337,210,44308,27641
6,46842,646842,Menifee city, California,1,2013,83459,38.5,76.9,21.4,39822,43637,59012,6051,4052,324,43,53633,29826
6,46898,646898,Merced city, California,1,2013,81089,43,67.1,9.5,40601,40488,37125,2956,11151,526,0,37949,43140
6,47766,647766,Milpitas city, California,1,2013,69796,45,79.7,11.4,33916,35880,13466,1762,46128,539,771,58561,11235
6,48256,648256,Mission Viejo city, California,1,2013,96350,32.5,79.3,17.9,47257,49093,77505,2936,8646,177,75,79676,16674
6,48354,648354,Modesto city, California,1,2013,204925,41.8,74.6,12.8,100772,104153,136008,8420,17706,1251,784,130492,74433
6,49270,649270,Moreno Valley city, California,1,2013,201187,46.7,70.7,7.4,97059,104128,101184,33926,10379,1850,1097,84056,117131
6,49670,649670,Mountain View city, California,1,2013,77839,47.5,78.6,10.1,39001,38838,47399,1369,23796,242,0,63643,14196
6,50076,650076,Murrieta city, California,1,2013,107457,41.7,70.3,11.1,53391,54066,71238,7976,7308,279,298,78358,29099
6,50258,650258,Napa city, California,1,2013,79059,41.3,75.7,13.1,39174,39885,59156,1133,1766,1065,54,48556,30503
6,51182,651182,Newport Beach city, California,1,2013,87265,35.3,81.8,18.7,43287,43978,75633,696,6590,78,351,81318,5947
6,52526,652526,Norwalk city, California,1,2013,106588,44.5,73.2,11.3,51357,55231,71659,4473,9819,1570,0,28031,78557
6,53000,653000,Oakland city, California,1,2013,406228,46,79.5,11.7,202378,203850,159842,103294,65753,2923,2291,298147,108081
6,53322,653322,Oceanside city, California,1,2013,172795,44,78.5,12.9,85047,87748,118738,10189,11022,1629,2504,110125,62670
6,53896,653896,Ontario city, California,1,2013,167496,46.3,70.2,8.2,81781,85715,82603,10122,8837,746,1534,52087,115409
6,53980,653980,Orange city, California,1,2013,139983,45.8,78.1,11.6,71017,68966,96897,1542,14537,809,77,78539,61444
6,54652,654652,Oxnard city, California,1,2013,203014,46.7,72.3,9,102892,100122,155944,7686,13968,2119,196,50668,152346
6,55156,655156,Palmdale city, California,1,2013,157146,39.9,69.1,8.5,79785,77361,68990,19876,8111,1653,0,71697,85449
6,55282,655282,Palo Alto city, California,0,2013,66638,33.1,76.3,19.4,32683,33955,44516,372,16876,0,0,60772,5866
6,56000,656000,Pasadena city, California,1,2013,139727,46.4,81.9,15.1,67371,72356,83946,17158,19061,424,67,91022,48705
6,56700,656700,Perris city, California,1,2013,72334,45.4,68.5,7.3,34605,37729,27190,7992,1772,90,0,21526,50808
6,57456,657456,Pittsburg city, California,0,2013,66703,43.9,76.1,12.5,31736,34967,23203,10321,11485,685,2051,38289,28414
6,57792,657792,Pleasanton city, California,1,2013,74112,33.1,73,15.2,36963,37149,46761,1699,20642,94,237,68339,5773
6,58072,658072,Pomona city, California,1,2013,151349,46.6,74.6,8.8,75369,75980,102192,9248,15971,1757,944,51325,100024
6,59444,659444,Rancho Cordova city, California,0,2013,67919,40.6,76.2,13.1,31655,36264,43829,8171,6732,706,782,53351,14568
6,59451,659451,Rancho Cucamonga city, California,1,2013,171359,45.7,75.5,10.3,87775,83584,116339,16354,20491,671,90,108155,63204
6,59920,659920,Redding city, California,1,2013,91124,38.5,77.7,17.8,43919,47205,74879,1314,3793,2396,0,83713,7411
6,59962,659962,Redlands city, California,1,2013,70000,39.9,72.5,13.2,33020,36980,50774,8116,5853,201,105,47031,22969
6,60018,660018,Redondo Beach city, California,1,2013,67816,40.2,79.8,12.3,31836,35980,47468,2725,9784,292,97,55665,12151
6,60102,660102,Redwood City city, California,1,2013,80875,43.4,77.2,11.3,40022,40853,54934,2709,11314,168,147,53919,26956
6,60466,660466,Rialto city, California,1,2013,101889,44.4,67.7,6.8,51573,50316,64188,14498,1178,48,211,28559,73330
6,60620,660620,Richmond city, California,1,2013,107580,45.3,76.9,12.1,51831,55749,44512,22538,15283,275,588,64353,43227
6,62000,662000,Riverside city, California,1,2013,316613,46.8,73.7,9.3,156957,159656,217849,17135,23184,1879,816,147286,169327
6,62938,662938,Roseville city, California,1,2013,127039,40.7,75.1,14.1,60972,66067,99852,1885,11708,601,214,108204,18835
6,64000,664000,Sacramento city, California,1,2013,479671,44.2,75.8,11.4,232923,246748,243460,64174,88123,2116,7776,351199,128472
6,64224,664224,Salinas city, California,1,2013,155649,46.8,68.8,6.7,79842,75807,121162,2820,11394,1169,109,42596,113053
6,65000,665000,San Bernardino city, California,1,2013,213700,43.8,71.8,8.8,103840,109860,127260,30083,10264,1720,811,80454,133246
6,65042,665042,San Buenaventura (Ventura) city, California,1,2013,108811,38.3,80.1,15.4,53262,55549,91582,766,4609,725,288,74697,34114
6,65084,665084,San Clemente city, California,0,2013,65021,37,77.1,14.9,33335,31686,49978,1437,1790,11,0,49690,15331
6,66000,666000,San Diego city, California,1,2013,1355885,47.1,78.1,11.6,689167,666718,870219,85305,233507,7268,6017,950096,405789
6,67000,667000,San Francisco city, California,1,2013,837442,48.5,86.6,14.2,425845,411597,406041,47985,280667,4079,3481,709047,128395
6,68000,668000,San Jose city, California,1,2013,998514,43.7,76,11.2,501691,496823,429466,32276,331114,5775,1476,663779,334735
6,68084,668084,San Leandro city, California,1,2013,87967,37.9,79.8,13.5,45527,42440,38405,11957,28401,747,326,65039,22928
6,68196,668196,San Marcos city, California,1,2013,89375,44.1,77.3,12.2,43627,45748,65721,1788,7347,327,137,53097,36278
6,68252,668252,San Mateo city, California,1,2013,101132,41.2,81.2,16.6,49095,52037,59487,3452,22742,96,1726,75300,25832
6,68378,668378,San Ramon city, California,1,2013,74514,37.3,71.1,9,37813,36701,35711,1973,31592,158,0,68488,6026
6,69000,669000,Santa Ana city, California,1,2013,334241,48.2,71.6,7.7,169122,165119,147726,3592,34063,524,1207,75011,259230
6,69070,669070,Santa Barbara city, California,1,2013,90431,47.7,82.5,15.5,44687,45744,66423,1292,3496,353,91,54339,36092
6,69084,669084,Santa Clara city, California,1,2013,120250,49.8,79.3,9.6,61144,59106,49138,4929,53333,233,266,101502,18748
6,69088,669088,Santa Clarita city, California,1,2013,179582,39.4,75.3,11.7,88283,91299,131491,6038,17454,888,112,125421,54161
6,69196,669196,Santa Maria city, California,1,2013,102205,43.6,67.1,9.1,51214,50991,42614,818,4568,242,314,23272,78933
6,70000,670000,Santa Monica city, California,1,2013,92484,45,84.8,17.8,45265,47219,74719,3672,8261,0,0,80110,12374
6,70098,670098,Santa Rosa city, California,1,2013,171996,40,77.4,15.2,83556,88440,122706,5234,7252,4279,1151,120473,51523
6,72016,672016,Simi Valley city, California,1,2013,126177,37.4,77.5,14.9,60478,65699,102196,1735,8700,360,144,93561,32616
6,73080,673080,South Gate city, California,1,2013,95664,47.4,74.4,9.4,49046,46618,59138,1247,747,165,162,3710,91954
6,73262,673262,South San Francisco city, California,0,2013,66174,38.6,77.2,13.9,33280,32894,19388,1149,27426,219,2000,43943,22231
6,73430,673430,South Whittier CDP, California,0,2013,65365,44.3,73.9,9.4,31534,33831,49465,101,4174,180,0,14916,50449
6,75000,675000,Stockton city, California,1,2013,298115,42.3,71.8,12,146145,151970,125699,32577,64079,1481,1633,168260,129855
6,77000,677000,Sunnyvale city, California,1,2013,147559,44.8,79.5,14.1,76888,70671,68905,3853,62253,428,1236,127280,20279
6,78120,678120,Temecula city, California,1,2013,106783,44,71.2,9.6,51092,55691,73019,5554,11978,1494,663,81512,25271
6,78582,678582,Thousand Oaks city, California,1,2013,128739,34.9,78.3,15.9,63556,65183,98182,971,13379,432,0,104558,24181
6,80000,680000,Torrance city, California,1,2013,147485,35.6,79.5,16.3,70830,76655,77587,3201,50149,625,72,125231,22254
6,80238,680238,Tracy city, California,1,2013,84683,43.5,68.1,6.3,44424,40259,48804,5132,11146,55,1227,51438,33245
6,80812,680812,Turlock city, California,1,2013,70358,44.7,73.2,12.4,33771,36587,59619,1734,3608,405,93,44660,25698
6,80854,680854,Tustin city, California,1,2013,78326,43.6,74.9,9.6,37725,40601,31780,2069,19166,992,104,47350,30976
6,81204,681204,Union City city, California,1,2013,72540,42.5,78.3,13.7,35897,36643,14454,3504,38905,807,1390,57792,14748
6,81344,681344,Upland city, California,1,2013,75420,40.7,77,13.7,36275,39145,46002,3932,9430,215,93,48444,26976
6,81554,681554,Vacaville city, California,1,2013,94272,40.6,76.8,13.2,50078,44194,62668,9301,6153,496,148,75951,18321
6,81666,681666,Vallejo city, California,1,2013,118855,39.5,80.6,14.2,58073,60782,53917,24482,28420,601,712,88981,29874
6,82590,682590,Victorville city, California,1,2013,121080,43.8,68.3,8.4,56286,64794,74986,23316,3859,1188,1151,56202,64878
6,82954,682954,Visalia city, California,1,2013,127758,41.9,70.7,11.4,61123,66635,105139,4080,6857,1746,51,71219,56539
6,82996,682996,Vista city, California,1,2013,96919,48.8,81.9,10.5,47915,49004,82048,3644,4196,344,460,53767,43152
6,83346,683346,Walnut Creek city, California,0,2013,66890,33.6,83.5,26.6,30998,35892,53256,715,8944,33,466,62107,4783
6,84200,684200,West Covina city, California,1,2013,107741,41.1,77.6,12.3,53072,54669,42095,5818,28993,423,125,50374,57367
6,84550,684550,Westminster city, California,1,2013,91750,40,76.9,16.6,44156,47594,37247,370,46930,849,42,69380,22370
6,85292,685292,Whittier city, California,1,2013,86618,41.9,74.8,13,40960,45658,51180,1484,4939,408,34,29763,56855
6,86832,686832,Yorba Linda city, California,0,2013,67042,32.2,75.8,16.7,34123,32919,48931,358,13224,288,251,55580,11462
6,86972,686972,Yuba City city, California,0,2013,65410,40.9,73.1,12.3,31590,33820,44500,2188,11995,460,124,47681,17729
8,3455,803455,Arvada city, Colorado,1,2013,112028,39.8,76.4,13.3,54410,57618,103428,712,1652,1095,31,95633,16395
8,4000,804000,Aurora city, Colorado,1,2013,345814,43.9,73.4,9.6,165357,180457,214760,55731,17868,1619,1197,245311,100503
8,7850,807850,Boulder city, Colorado,1,2013,103163,59,85.8,10,53194,49969,92788,959,5003,406,42,96432,6731
8,12815,812815,Centennial city, Colorado,1,2013,106101,38.6,75.9,13.7,54168,51933,92861,1489,5382,356,0,98991,7110
8,16000,816000,Colorado Springs city, Colorado,1,2013,439858,42.8,75.6,11.6,216483,223375,346461,25014,13750,2786,756,364465,75393
8,20000,820000,Denver city, Colorado,1,2013,649495,49,79,10.7,324648,324847,504146,64113,21095,5214,897,448690,200805
8,27425,827425,Fort Collins city, Colorado,1,2013,152056,52.4,81.4,10.7,76812,75244,135911,1743,4202,927,183,136395,15661
8,32155,832155,Greeley city, Colorado,1,2013,96549,46.9,74.8,11,48302,48247,66659,2822,1114,786,93,62731,33818
8,36410,836410,Highlands Ranch CDP, Colorado,0,2013,106264,40,67.7,8.2,54098,52166,92910,954,8032,78,0,95332,10932
8,43000,843000,Lakewood city, Colorado,1,2013,147220,40.7,81,15.9,74997,72223,130283,1790,3852,1487,234,114020,33200
8,45970,845970,Longmont city, Colorado,1,2013,90075,39.2,74.5,11.2,44497,45578,70968,1215,3013,2148,437,64373,25702
8,46465,846465,Loveland city, Colorado,1,2013,71331,39.6,76.5,14.9,33769,37562,66156,348,359,115,22,63029,8302
8,62000,862000,Pueblo city, Colorado,1,2013,108247,40.1,76.7,15.6,53949,54298,73002,3994,763,4232,122,51520,56727
8,77290,877290,Thornton city, Colorado,1,2013,127352,44.5,71.1,8.5,64567,62785,102986,2823,7794,1282,0,85076,42276
8,83835,883835,Westminster city, Colorado,1,2013,110940,42.6,75.5,11.5,55602,55338,97182,1355,6181,1025,37,89895,21045
9,8000,908000,Bridgeport city, Connecticut,1,2013,147216,45.6,74.6,9.9,72307,74909,56541,53488,4026,1153,236,89585,57631
9,18430,918430,Danbury city, Connecticut,1,2013,83690,42.6,79.2,13.5,38152,45538,54693,4147,4714,110,0,56680,27010
9,37000,937000,Hartford city, Connecticut,1,2013,125035,45.7,74.1,11.1,60732,64303,36583,52781,2751,71,0,70721,54314
9,50370,950370,New Britain city, Connecticut,1,2013,72941,42.7,75.7,13.4,33930,39011,48401,8223,3014,100,0,41891,31050
9,52000,952000,New Haven city, Connecticut,1,2013,130654,50.2,78.4,11.7,60296,70358,53286,44982,6347,438,0,95505,35149
9,55990,955990,Norwalk city, Connecticut,1,2013,87775,42.4,78.3,11.9,42590,45185,64930,14124,3939,89,0,65101,22674
9,73000,973000,Stamford city, Connecticut,1,2013,126455,43.7,81.2,14,62277,64178,77047,17831,9640,83,0,93885,32570
9,80000,980000,Waterbury city, Connecticut,1,2013,109687,42.8,74.4,12.6,53731,55956,74229,22577,3021,18,101,68278,41409
10,77580,1077580,Wilmington city, Delaware,1,2013,71520,45.9,76,12.1,33349,38171,25492,39241,1501,133,0,61932,9588
11,50000,1150000,Washington city, District of Columbia,1,2013,646449,51.3,82.7,11.4,306147,340302,264080,315504,22963,1272,104,580889,65560
12,410,1200410,Alafaya CDP, Florida,0,2013,76821,49.1,75.5,8.7,36673,40148,58481,6657,4930,0,0,54749,22072
12,7300,1207300,Boca Raton city, Florida,1,2013,89409,33.8,82.1,23.9,44966,44443,78705,3710,1218,145,0,79312,10097
12,7875,1207875,Boynton Beach city, Florida,1,2013,71103,36.8,84.4,20.5,33142,37961,-998,-998,-998,-998,-998,62596,8507
12,8150,1208150,Brandon CDP, Florida,0,2013,115318,43.7,74.4,9.3,54007,61311,84599,19321,3867,546,0,81643,33675
12,10275,1210275,Cape Coral city, Florida,1,2013,165849,32.6,78,20.6,78751,87098,151324,3677,2210,725,37,131896,33953
12,12875,1212875,Clearwater city, Florida,1,2013,109705,36.1,81.2,20.8,52267,57438,89479,11053,2873,864,246,95963,13742
12,14400,1214400,Coral Springs city, Florida,1,2013,126595,41.8,73.6,10.1,60631,65964,85499,28214,5114,528,120,94594,32001
12,16475,1216475,Davie town, Florida,1,2013,96818,43.1,80.1,14.1,48398,48420,73780,9329,4971,543,63,62078,34740
12,16725,1216725,Deerfield Beach city, Florida,1,2013,78045,35.2,81,23.8,39268,38777,51941,19949,2185,411,0,63175,14870
12,17200,1217200,Deltona city, Florida,1,2013,86300,35.4,75.3,15.9,40601,45699,67226,9773,471,561,0,57715,28585
12,24000,1224000,Fort Lauderdale city, Florida,1,2013,172374,39.1,83.7,16.4,91550,80824,112789,50947,2489,368,0,142707,29667
12,24125,1224125,Fort Myers city, Florida,0,2013,68184,41.2,79.2,16.4,36097,32087,40875,21812,1065,133,0,52984,15200
12,25175,1225175,Gainesville city, Florida,1,2013,127493,63.7,88.3,8.5,63026,64467,83163,30483,6892,222,1379,114253,13240
12,30000,1230000,Hialeah city, Florida,1,2013,233394,38.1,82,20.7,110935,122459,222377,4505,119,139,0,7554,225840
12,32000,1232000,Hollywood city, Florida,1,2013,146522,37.7,79.6,15.9,73161,73361,106834,24400,3077,32,179,101766,44756
12,35000,1235000,Jacksonville city, Florida,1,2013,842588,42.1,76.8,12.2,408223,434365,508387,258404,37511,2675,892,773861,68727
12,36100,1236100,Kendall CDP, Florida,0,2013,71373,37.2,78.5,17,33513,37860,60916,4090,3330,0,0,29263,42110
12,36950,1236950,Kissimmee city, Florida,0,2013,65186,42.5,75.9,13,32528,32658,52144,5459,1979,0,0,22981,42205
12,38250,1238250,Lakeland city, Florida,1,2013,100697,37.5,79.1,19.9,47549,53148,77699,18234,1417,0,0,87957,12740
12,39425,1239425,Largo city, Florida,1,2013,78415,33.6,85.1,24.3,39314,39101,66870,5674,1267,46,0,67612,10803
12,39550,1239550,Lauderhill city, Florida,1,2013,69793,41.9,71.3,12.4,30362,39431,-998,-998,-998,-998,-998,62966,6827
12,39925,1239925,Lehigh Acres CDP, Florida,0,2013,118806,43,70.6,10.2,58118,60688,72020,26787,1634,59,131,72665,46141
12,43975,1243975,Melbourne city, Florida,1,2013,77490,34.8,85.6,24.6,37685,39805,65193,6910,2444,330,0,71741,5749
12,45000,1245000,Miami city, Florida,1,2013,417670,42.8,81.2,15.7,212832,204838,315219,84724,3142,449,0,120744,296926
12,45025,1245025,Miami Beach city, Florida,1,2013,91019,44.4,85,16.4,49059,41960,76310,3063,1153,184,0,43971,47048
12,45060,1245060,Miami Gardens city, Florida,1,2013,111381,43.4,76.8,11.3,53806,57575,33034,75280,1340,43,0,74698,36683
12,45975,1245975,Miramar city, Florida,1,2013,130281,45,73.7,7.5,62242,68039,45373,69133,4545,138,46,81761,48520
12,53000,1253000,Orlando city, Florida,1,2013,255479,47.9,77.9,10.4,125911,129568,152592,68191,9644,1177,12,185774,69705
12,54000,1254000,Palm Bay city, Florida,1,2013,104894,34.7,77.8,15,48476,56418,74403,24405,919,723,0,91047,13847
12,54200,1254200,Palm Coast city, Florida,1,2013,79378,32.7,79.9,27.1,37148,42230,64275,8306,2671,179,0,70867,8511
12,55775,1255775,Pembroke Pines city, Florida,1,2013,162333,39.4,78.6,15.4,74735,87598,104082,30420,12419,540,0,97888,64445
12,56825,1256825,Pine Hills CDP, Florida,0,2013,67295,44.1,72.3,11,33335,33960,11875,47838,1365,0,0,56173,11122
12,57425,1257425,Plantation city, Florida,1,2013,90280,39.3,79.3,12.1,45470,44810,67866,15290,4128,0,58,67612,22668
12,58050,1258050,Pompano Beach city, Florida,1,2013,104406,39.8,82.2,20.4,54364,50042,72156,28843,1064,0,0,83968,20438
12,58715,1258715,Port St. Lucie city, Florida,1,2013,170999,37,75,16.5,83806,87193,126801,30176,4120,0,0,137082,33917
12,60950,1260950,Riverview CDP, Florida,0,2013,75934,43.6,71.7,8.6,37416,38518,49494,15468,3546,174,0,63488,12446
12,63000,1263000,St. Petersburg city, Florida,1,2013,249702,37.1,81.6,17,116653,133049,172547,58681,8151,514,201,231675,18027
12,68350,1268350,Spring Hill CDP, Florida,0,2013,101349,33.3,77,22.3,48197,53152,87704,7143,1640,321,0,86253,15096
12,69700,1269700,Sunrise city, Florida,1,2013,90133,38.5,78.7,15.9,39614,50519,49936,32071,2944,0,0,68035,22098
12,70600,1270600,Tallahassee city, Florida,1,2013,186408,58,82.6,9.4,88071,98337,104567,68652,7341,427,0,174304,12104
12,71000,1271000,Tampa city, Florida,1,2013,352981,44.4,78.9,12.1,170578,182403,229892,85472,14629,664,50,269304,83677
12,72145,1272145,Town 'n' Country CDP, Florida,0,2013,77829,42.9,80.7,14.1,35883,41946,66717,5187,2474,230,0,42015,35814
12,76582,1276582,Weston city, Florida,0,2013,68386,34,68.5,9.3,34533,33853,59099,3344,2913,106,0,37906,30480
12,76600,1276600,West Palm Beach city, Florida,1,2013,102433,39.8,81.2,17.5,49347,53086,61692,34976,1788,0,0,78098,24335
13,1052,1301052,Albany city, Georgia,1,2013,76151,43.3,73,11.9,34866,41285,19950,53445,662,68,39,74271,1880
13,3440,1303440,Athens-Clarke County unified government (balance), Georgia,1,2013,120212,58.7,82.6,8.8,57379,62833,78215,31906,5118,78,0,107257,12955
13,4000,1304000,Atlanta city, Georgia,1,2013,447848,51.5,81,10.7,224933,222915,181595,233662,18809,701,77,423844,24004
13,4204,1304204,Augusta-Richmond County consolidated government (balance), Georgia,1,2013,196711,42.5,76,11.9,94979,101732,75931,108310,3042,309,499,187733,8978
13,19000,1319000,Columbus city, Georgia,1,2013,202824,44.2,75.4,11.7,99399,103425,93310,92316,4360,398,0,187985,14839
13,42425,1342425,Johns Creek city, Georgia,1,2013,82761,37.8,71.2,8.3,39751,43010,50996,8228,19366,434,0,78799,3962
13,49000,1349000,Macon city, Georgia,1,2013,90107,41.3,74.5,11.2,41055,49052,23917,63595,490,31,0,87568,2539
13,67284,1367284,Roswell city, Georgia,1,2013,94029,43.6,75.8,11.4,43973,50056,69863,14938,4440,532,0,81612,12417
13,68516,1368516,Sandy Springs city, Georgia,1,2013,99769,43.5,78,11.9,46639,53130,65568,25282,3954,375,0,85484,14285
13,69000,1369000,Savannah city, Georgia,1,2013,142772,46.2,77,12.6,67518,75254,58739,78078,2026,394,48,134295,8477
13,80508,1380508,Warner Robins city, Georgia,1,2013,72321,46.3,70.3,9.1,35146,37175,37194,29358,3705,135,0,69483,2838
15,71550,1571550,Urban Honolulu CDP, Hawaii,0,2013,347907,40.7,82.3,18.6,171644,176263,65619,6846,186103,63,26625,323005,24902
16,8830,1608830,Boise City city, Idaho,1,2013,214235,44.1,77.1,11.4,106240,107995,189324,2922,8388,2554,775,197592,16643
16,52120,1652120,Meridian city, Idaho,1,2013,83594,35.7,70.2,10.8,40680,42914,-998,-998,-998,-998,-998,78262,5332
16,56260,1656260,Nampa city, Idaho,1,2013,86514,41,67.2,11.7,43738,42776,76180,1140,254,408,29,63696,22818
17,2154,1702154,Arlington Heights village, Illinois,1,2013,76069,38.1,80.1,16.6,36379,39690,61977,949,9801,0,0,71564,4505
17,3012,1703012,Aurora city, Illinois,1,2013,202665,44.9,69.5,7.7,97727,104938,114029,19537,17441,257,145,115544,87121
17,6613,1706613,Bloomington city, Illinois,1,2013,78911,44.9,77.5,11.3,37299,41612,60613,9625,5859,34,0,74866,4045
17,7133,1707133,Bolingbrook village, Illinois,1,2013,74969,45.4,70.8,8.5,36600,38369,36333,14141,8129,142,0,55016,19953
17,12385,1712385,Champaign city, Illinois,1,2013,83421,59.8,81.3,7.6,43807,39614,54129,15373,9551,14,0,77626,5795
17,14000,1714000,Chicago city, Illinois,1,2013,2718789,47.9,78,10.7,1325677,1393112,1326635,863542,163321,6205,1127,1936172,782617
17,14351,1714351,Cicero town, Illinois,1,2013,84107,45.3,66.5,5.8,41126,42981,49808,2560,439,1302,0,9273,74834
17,18823,1718823,Decatur city, Illinois,1,2013,72842,38.4,78.3,17.8,34003,38839,52248,13782,979,315,0,71357,1485
17,23074,1723074,Elgin city, Illinois,1,2013,108694,43.8,71.6,10.3,56687,52007,66628,7902,7154,144,0,64566,44128
17,24582,1724582,Evanston city, Illinois,1,2013,75579,45.1,78.9,14.5,35051,40528,49237,13549,8077,376,0,66938,8641
17,38570,1738570,Joliet city, Illinois,1,2013,148411,45.3,72.3,8.6,73688,74723,98775,25095,2644,191,0,103837,44574
17,51622,1751622,Naperville city, Illinois,1,2013,144736,38.1,73.4,11.1,70489,74247,112634,4601,22523,203,0,133654,11082
17,57225,1757225,Palatine village, Illinois,1,2013,69304,43.8,75.9,10.8,33805,35499,44623,2168,8639,87,0,53159,16145
17,59000,1759000,Peoria city, Illinois,1,2013,116575,42.7,74.8,12.8,55002,61573,72456,30348,6129,216,0,110009,6566
17,65000,1765000,Rockford city, Illinois,1,2013,152618,40,73.4,14.4,73981,78637,102919,31033,4080,297,0,126094,26524
17,68003,1768003,Schaumburg village, Illinois,1,2013,75850,42.7,81.5,14.1,36712,39138,49393,2028,19461,0,0,70106,5744
17,70122,1770122,Skokie village, Illinois,0,2013,65183,35.3,75.5,19.1,30744,34439,43064,2197,15565,412,0,56409,8774
17,72000,1772000,Springfield city, Illinois,1,2013,116858,39.3,76.9,14.5,56263,60595,87968,21375,3232,0,87,113553,3305
17,79293,1779293,Waukegan city, Illinois,1,2013,90252,46.2,71.2,6.5,45714,44538,57914,15091,4382,503,0,41522,48730
18,5860,1805860,Bloomington city, Indiana,1,2013,80693,68.1,89.5,9.3,38912,41781,66466,3408,7880,79,81,76950,3743
18,10342,1810342,Carmel city, Indiana,1,2013,84542,35.2,70.9,12.8,41570,42972,70514,3074,6845,188,0,82557,1985
18,22000,1822000,Evansville city, Indiana,1,2013,117439,39.1,78.7,16.4,56672,60767,96340,16163,639,660,183,114122,3317
18,23278,1823278,Fishers town, Indiana,1,2013,85588,42.6,65.9,5.6,41428,44160,71156,4991,7560,0,0,81437,4151
18,25000,1825000,Fort Wayne city, Indiana,1,2013,251340,40.9,74.4,12.8,120983,130357,183670,40317,7519,374,75,230276,21064
18,27000,1827000,Gary city, Indiana,1,2013,75375,35,73.2,17,33122,42253,11315,60039,318,209,821,70794,4581
18,31000,1831000,Hammond city, Indiana,1,2013,78958,43,73.2,10,38307,40651,37209,19772,1070,523,0,49640,29318
18,36003,1836003,Indianapolis city (balance), Indiana,1,2013,838425,43.4,75.3,10.7,407301,431124,509372,235416,20418,1741,0,754998,83427
18,40788,1840788,Lafayette city, Indiana,1,2013,69720,48.3,76.6,11.3,34036,35684,61946,4398,1505,149,0,62558,7162
18,51876,1851876,Muncie city, Indiana,1,2013,70107,51.4,85.2,15,32038,38069,58449,7541,987,33,0,68402,1705
18,71000,1871000,South Bend city, Indiana,1,2013,101975,42,73.8,12.4,49918,52057,65662,26755,1329,465,105,89133,12842
19,12000,1912000,Cedar Rapids city, Iowa,1,2013,128422,42.4,77.5,13.6,60570,67852,110589,9972,1932,41,0,122847,5575
19,19000,1919000,Davenport city, Iowa,1,2013,102165,39.7,76.4,13.6,51565,50600,82705,12715,2019,123,48,93485,8680
19,21000,1921000,Des Moines city, Iowa,1,2013,207293,44.5,75,10.8,104548,102745,161270,22822,9136,638,48,179746,27547
19,38595,1938595,Iowa City city, Iowa,1,2013,71598,63.4,85.6,8.7,35333,36265,58245,4368,6598,81,243,68345,3253
19,73335,1973335,Sioux City city, Iowa,1,2013,81325,43,74.2,13.1,39975,41350,68654,3091,2077,815,0,66483,14842
19,82425,1982425,Waterloo city, Iowa,1,2013,68366,41.1,77.8,16,33471,34895,54166,12001,576,121,0,65193,3173
20,36000,2036000,Kansas City city, Kansas,1,2013,148112,41.4,71.7,10.8,73434,74678,89101,38935,5152,915,65,105919,42193
20,38900,2038900,Lawrence city, Kansas,1,2013,92730,57.6,83.1,9,45201,47529,75666,4363,4606,2225,0,86853,5877
20,52575,2052575,Olathe city, Kansas,1,2013,131903,43.2,70.6,8.8,66138,65765,110985,6703,6474,205,46,116078,15825
20,53775,2053775,Overland Park city, Kansas,1,2013,181273,39.1,75.6,13.5,87412,93861,152985,10383,12011,757,108,170340,10933
20,71000,2071000,Topeka city, Kansas,1,2013,127702,38.7,77.5,16.1,60814,66888,102351,12417,1637,1034,47,110789,16913
20,79000,2079000,Wichita city, Kansas,1,2013,386558,40.4,73.5,12.6,192002,194556,298594,45158,19233,3347,0,322874,63684
21,46027,2146027,Lexington-Fayette urban county, Kentucky,1,2013,308428,46.4,78.9,11.4,150932,157496,232749,46201,11551,933,115,287226,21202
21,48006,2148006,Louisville/Jefferson County metro government (balance), Kentucky,1,2013,609908,40.2,77.1,13.5,294423,315485,435907,139241,13357,500,350,580168,29740
22,5000,2205000,Baton Rouge city, Louisiana,1,2013,229405,47.3,79.3,13.1,107862,121543,86004,127266,9512,502,0,223175,6230
22,8920,2208920,Bossier City city, Louisiana,0,2013,66334,47,73.7,11.1,31154,35180,42904,17507,1498,1055,0,59808,6526
22,39475,2239475,Kenner city, Louisiana,1,2013,66975,38.6,78.6,15.9,31528,35447,45890,14611,3102,131,0,55222,11753
22,40735,2240735,Lafayette city, Louisiana,1,2013,124282,44.8,78.7,11.2,60245,64037,76983,40629,2664,552,0,118646,5636
22,41155,2241155,Lake Charles city, Louisiana,1,2013,74032,42.6,76,12.7,37216,36816,31329,38587,1098,0,0,71938,2094
22,50115,2250115,Metairie CDP, Louisiana,0,2013,143630,39.4,79.6,17.2,72258,71372,121554,11729,4838,640,25,119928,23702
22,55000,2255000,New Orleans city, Louisiana,1,2013,378715,44.6,79.4,11.8,181823,196892,130880,224787,11508,681,69,357866,20849
22,70000,2270000,Shreveport city, Louisiana,1,2013,200191,41,74.8,13.5,94091,106100,79332,112011,2771,1122,235,194949,5242
23,60545,2360545,Portland city, Maine,1,2013,66316,46.3,82,12.4,33313,33003,55848,4885,2561,71,0,63711,2605
24,4000,2404000,Baltimore city, Maryland,1,2013,622104,44.3,78.9,12,292760,329344,187993,391451,14728,2668,356,593664,28440
24,7125,2407125,Bethesda CDP, Maryland,0,2013,66364,35.3,77.6,18.8,30405,35959,53016,1483,7575,109,0,61565,4799
24,19125,2419125,Columbia CDP, Maryland,0,2013,102907,39.2,77.7,12.1,51545,51362,55539,30745,11951,698,0,96033,6874
24,26000,2426000,Ellicott City CDP, Maryland,0,2013,69535,35.7,74,14.3,33794,35741,45385,4858,16160,0,0,65323,4212
24,30325,2430325,Frederick city, Maryland,0,2013,66910,42.6,77.1,14.5,31973,34937,47065,9265,5534,333,68,56912,9998
24,31175,2431175,Gaithersburg city, Maryland,0,2013,65689,41.4,73.2,12.4,31437,34252,32715,12158,9202,160,0,48601,17088
24,32025,2432025,Germantown CDP, Maryland,0,2013,94958,46.1,72.2,5.5,48170,46788,39336,21075,22032,0,0,72883,22075
24,32650,2432650,Glen Burnie CDP, Maryland,0,2013,66760,40.1,76.3,15.1,32270,34490,39317,19150,2877,67,390,62773,3987
24,72450,2472450,Silver Spring CDP, Maryland,0,2013,76563,46,76.7,8.2,37384,39179,32448,18298,5409,137,0,51767,24796
24,81175,2481175,Waldorf CDP, Maryland,0,2013,69685,45.2,72.8,7.7,32061,37624,23796,39863,2725,445,0,66307,3378
25,7000,2507000,Boston city, Massachusetts,1,2013,644710,54.5,83.4,10.6,308191,336519,341007,155619,57743,3161,0,523214,121496
25,9000,2509000,Brockton city, Massachusetts,1,2013,94101,41.7,74.2,12.5,44164,49937,45220,38046,1908,395,0,86759,7342
25,11000,2511000,Cambridge city, Massachusetts,1,2013,107276,62.6,88,10,51084,56192,71166,11936,16141,280,78,97412,9864
25,23000,2523000,Fall River city, Massachusetts,1,2013,88686,40.8,78.7,17.7,41161,47525,75638,3954,1770,0,221,81636,7050
25,24960,2524960,Framingham CDP, Massachusetts,0,2013,70448,43.3,78.4,13,31632,38816,52142,5823,4248,143,0,58411,12037
25,34550,2534550,Lawrence city, Massachusetts,1,2013,77665,46.6,74.2,9.9,36387,41278,36041,7887,2328,90,0,19738,57927
25,37000,2537000,Lowell city, Massachusetts,1,2013,108868,47.2,76.3,10.7,55965,52903,60912,7124,22296,175,0,86223,22645
25,37490,2537490,Lynn city, Massachusetts,1,2013,91595,39.1,73.5,11.9,44387,47208,46199,12519,6333,0,335,59378,32217
25,45000,2545000,New Bedford city, Massachusetts,1,2013,95079,42,78,15.9,45059,50020,68959,3364,1214,361,0,73966,21113
25,45560,2545560,Newton city, Massachusetts,1,2013,87977,38.7,78.2,15.2,42877,45100,68877,3048,11979,71,0,83273,4704
25,55745,2555745,Quincy city, Massachusetts,1,2013,93490,43.2,84.1,15.3,44615,48875,63629,4686,22330,0,0,90810,2680
25,62535,2562535,Somerville city, Massachusetts,1,2013,78814,58.4,88.1,12.5,39185,39629,64233,3853,5483,201,42,73356,5458
25,67000,2567000,Springfield city, Massachusetts,1,2013,153694,42.7,73.5,11.4,72298,81396,80788,36120,3518,1266,52,91489,62205
25,82000,2582000,Worcester city, Massachusetts,1,2013,182538,47.3,77.8,11,90259,92279,129201,25562,11456,501,213,142094,40444
26,3000,2603000,Ann Arbor city, Michigan,1,2013,117034,58.7,85.5,9.9,57828,59206,85137,11131,14840,231,0,111836,5198
26,21000,2621000,Dearborn city, Michigan,1,2013,95888,39.4,68.6,12.4,46014,49874,86788,3922,2154,0,0,93180,2708
26,22000,2622000,Detroit city, Michigan,1,2013,688740,41.4,75.1,12.6,326379,362361,88347,553258,9072,2436,116,635440,53300
26,27440,2627440,Farmington Hills city, Michigan,1,2013,81293,35.4,80.9,19.5,38753,42540,55308,16453,7272,62,0,78126,3167
26,29000,2629000,Flint city, Michigan,1,2013,99758,38.6,74.5,12.3,48371,51387,39170,54234,352,341,23,96530,3228
26,34000,2634000,Grand Rapids city, Michigan,1,2013,192285,46.2,75.8,10.9,92190,100095,134449,39821,2740,794,49,163688,28597
26,42160,2642160,Kalamazoo city, Michigan,1,2013,75542,56.5,79.6,9.7,38561,36981,48603,17435,2186,388,0,68146,7396
26,46000,2646000,Lansing city, Michigan,1,2013,114113,44.1,75.5,10.6,54675,59438,71643,22961,4503,516,70,99981,14132
26,49000,2649000,Livonia city, Michigan,1,2013,95212,33.5,78.9,17.7,46585,48627,86390,3489,3372,305,0,92216,2996
26,69035,2669035,Rochester Hills city, Michigan,1,2013,72957,35.1,78.2,15.5,35939,37018,61440,2302,7178,207,0,69039,3918
26,74900,2674900,Southfield city, Michigan,1,2013,73012,35.6,78,18.9,34625,38387,17783,52461,406,30,0,72517,495
26,76460,2676460,Sterling Heights city, Michigan,1,2013,131204,38.2,79.7,17,67987,63217,112832,5499,8300,0,301,128100,3104
26,80700,2680700,Troy city, Michigan,1,2013,82822,36.4,76.2,15.4,40763,42059,60413,2613,18030,27,0,80022,2800
26,84000,2684000,Warren city, Michigan,1,2013,134875,38.6,78.6,16.2,65085,69790,99806,20694,9960,657,0,132198,2677
26,86000,2686000,Westland city, Michigan,1,2013,82586,42.9,82.5,14.6,37772,44814,65526,12514,1989,188,0,80890,1696
26,88940,2688940,Wyoming city, Michigan,1,2013,74114,47.8,75.3,8.8,37512,36602,62486,2991,2103,230,0,57606,16508
27,6616,2706616,Bloomington city, Minnesota,1,2013,86321,36.9,79.7,19.4,42567,43754,68804,8739,3568,189,0,80318,6003
27,7966,2707966,Brooklyn Park city, Minnesota,1,2013,78373,42.9,72.9,8.7,39396,38977,40382,21184,12445,357,126,74281,4092
27,17000,2717000,Duluth city, Minnesota,1,2013,86125,46.1,82,14.1,41874,44251,77172,2855,1517,2017,16,84144,1981
27,17288,2717288,Eagan city, Minnesota,0,2013,65453,40.6,74.3,11.2,32042,33411,51203,6500,4524,613,0,62929,2524
27,40166,2740166,Maple Grove city, Minnesota,0,2013,65406,37.1,72.3,11.4,31054,34352,56878,1611,5390,0,0,63112,2294
27,43000,2743000,Minneapolis city, Minnesota,1,2013,400079,51.5,80.4,8.8,201059,199020,256874,72382,24860,4097,104,361455,38624
27,51730,2751730,Plymouth city, Minnesota,1,2013,73987,39.7,76,14.4,35613,38374,59808,5131,7128,95,0,71609,2378
27,54880,2754880,Rochester city, Minnesota,1,2013,110731,40.3,75.2,13.3,52083,58648,90673,7429,7508,129,0,104494,6237
27,56896,2756896,St. Cloud city, Minnesota,0,2013,67754,54.2,78.3,9,35234,32520,57224,5951,1982,759,128,65639,2115
27,58000,2758000,St. Paul city, Minnesota,1,2013,294873,46.7,74.3,8.7,145710,149163,173335,47597,49270,3727,58,266644,28229
27,71428,2771428,Woodbury city, Minnesota,0,2013,65659,39.3,72.7,8.8,32024,33635,53479,2863,5977,145,189,63266,2393
28,29700,2829700,Gulfport city, Mississippi,1,2013,71022,43.4,78,13.9,33692,37330,41865,25250,1225,288,0,66836,4186
28,36000,2836000,Jackson city, Mississippi,1,2013,172585,43.7,73.6,11,79641,92944,-998,-998,-998,-998,-998,170542,2043
29,15670,2915670,Columbia city, Missouri,1,2013,115287,55.8,83.1,9.6,55102,60185,93564,8062,7159,557,77,111399,3888
29,35000,2935000,Independence city, Missouri,1,2013,117246,36.9,77.4,16.9,54908,62338,96025,12532,1070,539,340,108269,8977
29,38000,2938000,Kansas City city, Missouri,1,2013,467082,42.7,77,12,231475,235607,278765,131562,12142,2137,1440,418520,48562
29,41348,2941348,Lee's Summit city, Missouri,1,2013,93669,38,71.2,13.2,44375,49294,81633,6959,2268,459,352,90629,3040
29,54074,2954074,O'Fallon city, Missouri,1,2013,82802,41.3,72.2,9.1,41728,41074,74227,2269,4081,103,0,81022,1780
29,64082,2964082,St. Charles city, Missouri,0,2013,67566,43.7,77.8,12.9,33256,34310,58581,5353,947,38,0,63444,4122
29,64550,2964550,St. Joseph city, Missouri,1,2013,77845,40.5,76,13,38893,38952,-998,-998,-998,-998,-998,73006,4839
29,65000,2965000,St. Louis city, Missouri,1,2013,318416,45.9,79.6,11.1,154551,163865,147036,152570,9272,830,90,306515,11901
29,70000,2970000,Springfield city, Missouri,1,2013,164133,48.9,81.6,14.6,78009,86124,143982,7227,3180,1092,177,156570,7563
30,6550,3006550,Billings city, Montana,1,2013,109062,40.4,77.5,16,52823,56239,96902,779,954,5940,88,102290,6772
30,50200,3050200,Missoula city, Montana,1,2013,69116,51.2,83.3,13.1,34035,35081,62876,75,1152,1823,0,66661,2455
31,28000,3128000,Lincoln city, Nebraska,1,2013,268743,45.9,77.2,12,134460,134283,228457,12271,11326,1930,63,250041,18702
31,37000,3137000,Omaha city, Nebraska,1,2013,434353,42.5,75.1,11.8,214685,219668,343081,54315,10674,1409,215,376188,58165
32,23770,3223770,Enterprise CDP, Nevada,0,2013,121164,44.2,76.8,10.5,63132,58032,66439,8923,31409,430,2408,101581,19583
32,31900,3231900,Henderson city, Nevada,1,2013,270798,37,78.4,17.4,130792,140006,212627,15885,23842,974,1369,238271,32527
32,40000,3240000,Las Vegas city, Nevada,1,2013,603525,41.7,75.4,13.2,303074,300451,376135,73355,41993,3003,3056,415470,188055
32,51800,3251800,North Las Vegas city, Nevada,1,2013,226872,46.9,69.1,7.9,114747,112125,107447,40916,12206,1749,3013,130685,96187
32,54600,3254600,Paradise CDP, Nevada,0,2013,225861,44,77.5,11.2,116658,109203,154353,21683,15933,871,1081,150304,75557
32,60600,3260600,Reno city, Nevada,1,2013,233306,43.4,76.7,12,118707,114599,188632,5792,15389,2199,1851,171053,62253
32,68400,3268400,Sparks city, Nevada,1,2013,93281,39.8,75.5,14.4,44169,49112,74331,3229,4821,1471,125,73471,19810
32,68585,3268585,Spring Valley CDP, Nevada,0,2013,188025,45.5,80.5,13.4,90194,97831,108212,21887,35258,1613,1895,146014,42011
32,71400,3271400,Sunrise Manor CDP, Nevada,0,2013,181454,41.2,74.5,11.1,90511,90943,102938,22208,9590,711,1257,87549,93905
33,45140,3345140,Manchester city, New Hampshire,1,2013,110369,45.5,80,13.5,55156,55213,94904,4420,5583,74,0,100814,9555
33,50260,3350260,Nashua city, New Hampshire,1,2013,87138,39.3,77.4,14.3,41141,45997,71471,2414,7277,85,0,76644,10494
34,3580,3403580,Bayonne city, New Jersey,0,2013,65024,44.3,79.7,13.9,32539,32485,45606,6327,6438,423,0,49831,15193
34,10000,3410000,Camden city, New Jersey,1,2013,76903,42.3,66.4,7.7,36756,40147,9927,42232,2875,0,0,41780,35123
34,13690,3413690,Clifton city, New Jersey,1,2013,85379,41.4,78.7,13.4,42474,42905,63554,3903,8540,192,0,54341,31038
34,19390,3419390,East Orange city, New Jersey,0,2013,64543,42.3,75.9,11.7,29026,35517,2127,59132,679,275,0,61739,2804
34,21000,3421000,Elizabeth city, New Jersey,1,2013,127552,44.4,73,10,60997,66555,63344,22864,1328,583,0,43996,83556
34,36000,3436000,Jersey City city, New Jersey,1,2013,257345,50.2,78.8,9.5,125879,131466,95797,64138,62433,349,0,183819,73526
34,51000,3451000,Newark city, New Jersey,1,2013,278436,46.2,74.9,8.6,140692,137744,62772,142789,2631,1688,43,175854,102582
34,56550,3456550,Passaic city, New Jersey,1,2013,70876,46.8,65.4,6.9,35231,35645,41508,9800,2201,1619,126,19231,51645
34,57000,3457000,Paterson city, New Jersey,1,2013,145952,43.4,75,10.6,69586,76366,47426,48455,7770,182,0,62859,83093
34,73110,3473110,Toms River CDP, New Jersey,0,2013,89957,33.6,79.1,17.9,43820,46137,80641,2654,4691,335,0,85304,4653
34,74000,3474000,Trenton city, New Jersey,1,2013,84344,48.7,76.2,7.2,43813,40531,19730,46257,1693,148,0,58370,25974
34,74630,3474630,Union City city, New Jersey,1,2013,68248,45.5,77.6,10.3,35816,32432,43541,4532,1558,984,0,7998,60250
35,2000,3502000,Albuquerque city, New Mexico,1,2013,556489,41.9,76.6,13.3,271156,285333,434500,19847,15513,21926,642,293293,263196
35,39380,3539380,Las Cruces city, New Mexico,1,2013,101317,44.6,75.3,14.1,49630,51687,87633,2195,961,1904,0,46000,55317
35,63460,3563460,Rio Rancho city, New Mexico,1,2013,91928,39,73.2,14,44400,47528,75931,2121,1698,1493,44,56090,35838
35,70500,3570500,Santa Fe city, New Mexico,1,2013,69969,35.1,81.5,20.9,32245,37724,57433,438,1112,1570,155,36202,33767
36,1000,3601000,Albany city, New York,1,2013,98441,52.6,83.3,13.2,47064,51377,57073,27932,7270,63,281,89358,9083
36,11000,3611000,Buffalo city, New York,1,2013,258945,44.8,77.1,12,126110,132835,123198,96248,10830,829,17,230086,28859
36,15000,3615000,Cheektowaga CDP, New York,0,2013,74338,38.5,81.8,19.2,34085,40253,62765,8312,1313,96,0,72724,1614
36,49121,3649121,Mount Vernon city, New York,1,2013,68218,40.8,76.7,12.2,32530,35688,16862,44129,1462,193,0,59845,8373
36,50617,3650617,New Rochelle city, New York,1,2013,79453,38.1,79.6,16.7,39521,39932,52248,14293,3755,0,0,55272,24181
36,51000,3651000,New York city, New York,1,2013,8405837,44.8,78.8,12.8,4010741,4395096,3659632,2070401,1133042,30380,5908,5977081,2428756
36,63000,3663000,Rochester city, New York,1,2013,210345,46,75.6,10.2,103067,107278,95512,86081,5119,1720,325,172398,37947
36,65508,3665508,Schenectady city, New York,1,2013,65915,44.3,78,12.5,31426,34489,40144,15653,3764,542,0,59624,6291
36,73000,3673000,Syracuse city, New York,1,2013,144675,47.2,78.6,12,67528,77147,79566,42312,9046,1861,30,132103,12572
36,84000,3684000,Yonkers city, New York,1,2013,199764,40.5,77.5,16.9,90485,109279,119741,32231,11286,28,0,129155,70609
37,2140,3702140,Asheville city, North Carolina,1,2013,87251,41.9,80,17.4,42147,45104,72333,11097,1136,134,0,81545,5706
37,10740,3710740,Cary town, North Carolina,1,2013,151560,41.6,73.9,9.1,74119,77441,110441,11618,21610,695,41,136974,14586
37,12000,3712000,Charlotte city, North Carolina,1,2013,792849,46.7,74.8,9,378742,414107,394713,284328,43223,3098,73,682798,110051
37,14100,3714100,Concord city, North Carolina,1,2013,83507,44.7,72,9.9,40269,43238,59023,15774,3033,204,44,73419,10088
37,19000,3719000,Durham city, North Carolina,1,2013,245466,48.5,77.4,9.3,114919,130547,118676,98160,11527,471,0,209953,35513
37,22920,3722920,Fayetteville city, North Carolina,1,2013,204401,47.4,75.4,10.4,101203,103198,96999,85379,5148,952,358,181663,22738
37,25580,3725580,Gastonia city, North Carolina,1,2013,73205,40.4,74.8,13.6,34544,38661,44100,19960,934,202,0,65907,7298
37,28000,3728000,Greensboro city, North Carolina,1,2013,279651,44.8,78.1,12.6,132489,147162,140880,114751,9431,910,410,259620,20031
37,28080,3728080,Greenville city, North Carolina,1,2013,89142,57.7,81.6,8.7,39892,49250,49884,33517,2809,78,53,85766,3376
37,31400,3731400,High Point city, North Carolina,1,2013,107229,43.7,76.9,12.6,51926,55303,53325,35504,10942,740,47,97444,9785
37,34200,3734200,Jacksonville city, North Carolina,1,2013,69075,53.2,74.1,7.8,38924,30151,45195,15402,2812,231,403,59319,9756
37,55000,3755000,Raleigh city, North Carolina,1,2013,431897,49.7,77.1,9.1,208659,223238,255147,126279,20173,1644,500,385510,46387
37,74440,3774440,Wilmington city, North Carolina,1,2013,112072,46.2,84.1,15,51720,60352,85947,20637,1922,563,0,105215,6857
37,75000,3775000,Winston-Salem city, North Carolina,1,2013,236457,42.2,75.8,13.2,110760,125697,134141,81199,2873,981,884,198133,38324
38,7200,3807200,Bismarck city, North Dakota,0,2013,66063,41.2,78.6,15.4,32603,33460,60831,565,637,2454,0,64791,1272
38,25700,3825700,Fargo city, North Dakota,1,2013,112510,51.3,81.4,11.2,57372,55138,100838,4457,3339,1287,28,109247,3263
39,1000,3901000,Akron city, Ohio,1,2013,198095,42.4,78.9,13.8,95758,102337,118338,63736,5252,952,146,192805,5290
39,12000,3912000,Canton city, Ohio,1,2013,72551,36.4,74.1,16.8,32986,39565,-998,-998,-998,-998,-998,69579,2972
39,15000,3915000,Cincinnati city, Ohio,1,2013,297498,45.9,78.4,11.3,145142,152356,155675,123578,5499,517,347,287574,9924
39,16000,3916000,Cleveland city, Ohio,1,2013,390106,41.5,76.7,12.4,187433,202673,156131,202393,5531,2080,0,348130,41976
39,18000,3918000,Columbus city, Ohio,1,2013,822762,48.4,76.9,9.2,401455,421307,508169,224394,37879,1585,349,772911,49851
39,21000,3921000,Dayton city, Ohio,1,2013,143355,45.3,79.6,13.4,70099,73256,78149,57086,2100,339,58,136929,6426
39,44856,3944856,Lorain city, Ohio,0,2013,63706,40.1,73.7,15.9,29599,34107,46427,9286,618,196,37,47287,16419
39,61000,3961000,Parma city, Ohio,1,2013,80427,36.8,80.1,18.2,38284,42143,75034,2833,808,44,0,76078,4349
39,77000,3977000,Toledo city, Ohio,1,2013,282313,41.1,77.6,13.7,138903,143410,181978,74982,3496,1000,33,260229,22084
39,88000,3988000,Youngstown city, Ohio,1,2013,65174,38.3,78.9,16.5,31052,34122,32036,27488,232,328,0,57958,7216
40,9050,4009050,Broken Arrow city, Oklahoma,1,2013,105013,39.6,73.4,11.4,51332,53681,82787,4484,2764,3130,68,96322,8691
40,23200,4023200,Edmond city, Oklahoma,1,2013,87002,40.4,75.2,13.4,43145,43857,73376,5486,2257,1727,412,83242,3760
40,41850,4041850,Lawton city, Oklahoma,1,2013,97142,47.2,75.4,9.5,51171,45971,58982,20510,2224,4031,607,82613,14529
40,52500,4052500,Norman city, Oklahoma,1,2013,118200,51.4,78.2,11.9,58788,59412,92309,5097,7239,5087,358,111306,6894
40,55000,4055000,Oklahoma City city, Oklahoma,1,2013,610617,42.8,75.1,11.7,300775,309842,419802,86352,25328,17516,0,494494,116123
40,75000,4075000,Tulsa city, Oklahoma,1,2013,398724,41.8,75.7,12.6,194834,203890,261172,60285,10598,15455,277,339531,59193
41,5350,4105350,Beaverton city, Oregon,1,2013,93525,45,79.8,11.6,47485,46040,69847,2014,11443,1439,712,77549,15976
41,5800,4105800,Bend city, Oregon,1,2013,81236,42.8,76.6,13.4,39248,41988,74156,456,1931,558,185,72877,8359
41,23850,4123850,Eugene city, Oregon,1,2013,159161,47.2,82.3,13.4,79449,79712,132965,2938,7242,1738,1067,145483,13678
41,31250,4131250,Gresham city, Oregon,1,2013,109410,41,73.6,12.1,55848,53562,85340,5075,3448,876,1800,90430,18980
41,34100,4134100,Hillsboro city, Oregon,1,2013,97371,44.9,74.1,10.5,46494,50877,79797,546,8607,96,547,74176,23195
41,47000,4147000,Medford city, Oregon,1,2013,77680,39.5,74.2,15.7,39535,38145,70335,859,1034,261,0,65651,12029
41,59000,4159000,Portland city, Oregon,1,2013,611134,48.1,81.6,11.3,302285,308849,474549,35745,45933,5639,2386,550160,60974
41,64900,4164900,Salem city, Oregon,1,2013,160618,43.2,75.6,12,78896,81722,132125,1833,5592,829,728,129452,31166
42,2000,4202000,Allentown city, Pennsylvania,1,2013,118577,45,73.8,12,56574,62003,68390,16274,2427,338,0,62415,56162
42,6088,4206088,Bethlehem city, Pennsylvania,1,2013,74241,43.7,83.3,16.3,37326,36915,56823,4314,2265,450,0,55049,19192
42,24000,4224000,Erie city, Pennsylvania,1,2013,100676,44.5,78.6,13.3,50022,50654,76294,15993,2407,208,40,93685,6991
42,60000,4260000,Philadelphia city, Pennsylvania,1,2013,1553165,45.2,77.8,12.4,734249,818916,646435,670482,106286,3322,375,1347132,206033
42,61000,4261000,Pittsburgh city, Pennsylvania,1,2013,305838,49.2,83.7,14.3,147786,158052,207899,72398,14628,560,0,297622,8216
42,63624,4263624,Reading city, Pennsylvania,1,2013,87894,43.1,68.9,8.8,44414,43480,46494,9617,301,2405,417,33593,54301
42,69000,4269000,Scranton city, Pennsylvania,1,2013,75814,41.8,77.9,16.3,36019,39795,65569,5135,2768,184,0,67054,8760
44,19180,4419180,Cranston city, Rhode Island,1,2013,80575,39,78.7,15.4,41509,39066,68746,2967,1734,65,0,70530,10045
44,54640,4454640,Pawtucket city, Rhode Island,1,2013,71178,42.1,76.4,11.2,35006,36172,42453,13769,286,273,264,54231,16947
44,59000,4459000,Providence city, Rhode Island,1,2013,177995,52,76.7,8.6,87505,90490,89225,28410,12653,1699,31,107119,70876
44,74300,4474300,Warwick city, Rhode Island,1,2013,81983,36.8,80.6,17.4,38656,43327,74942,619,2474,17,0,76908,5075
45,13330,4513330,Charleston city, South Carolina,1,2013,130428,45.9,81.2,14.4,60391,70037,96793,29593,1251,226,35,126841,3587
45,16000,4516000,Columbia city, South Carolina,1,2013,133377,57.5,82.5,9.5,69643,63734,67338,55072,3275,317,80,124373,9004
45,48535,4548535,Mount Pleasant town, South Carolina,1,2013,74876,41.6,75.2,12.1,36728,38148,-998,-998,-998,-998,-998,73535,1341
45,50875,4550875,North Charleston city, South Carolina,1,2013,101838,46.1,77.7,8.9,50649,51189,44550,49555,1479,140,94,91576,10262
45,61405,4561405,Rock Hill city, South Carolina,1,2013,69104,44,76.4,12.8,33541,35563,36980,27015,2566,64,0,66366,2738
46,52980,4652980,Rapid City city, South Dakota,1,2013,70810,39.3,76.9,15.7,35348,35462,55323,802,770,8446,0,66759,4051
46,59020,4659020,Sioux Falls city, South Dakota,1,2013,163629,43,76.3,11.7,82343,81286,141676,6710,2739,4261,267,155833,7796
47,15160,4715160,Clarksville city, Tennessee,1,2013,142355,50.4,72.2,6.8,71579,70776,95372,30729,2957,953,87,128122,14233
47,27740,4727740,Franklin city, Tennessee,0,2013,68872,39,74.5,11.5,33039,35833,58920,3730,3068,208,0,66645,2227
47,37640,4737640,Jackson city, Tennessee,0,2013,67685,40.3,76.9,15.4,31353,36332,-998,-998,-998,-998,-998,67311,374
47,38320,4738320,Johnson City city, Tennessee,0,2013,65796,43.8,82.9,17.3,32544,33252,57714,4502,1918,0,0,63614,2182
47,40000,4740000,Knoxville city, Tennessee,1,2013,183261,49.1,82,13,86650,96611,142222,29541,4401,514,247,173878,9383
47,48000,4748000,Memphis city, Tennessee,1,2013,653450,43.7,74.9,10.5,311131,342319,197962,411962,10959,1057,0,610077,43373
47,51560,4751560,Murfreesboro city, Tennessee,1,2013,117039,52.3,78.1,8.9,58963,58076,89151,19225,3906,484,0,110663,6376
47,52006,4752006,Nashville-Davidson metropolitan government (balance), Tennessee,1,2013,634465,46.8,78.4,10.6,307078,327387,391895,176670,21073,2279,350,569533,64932
48,1000,4801000,Abilene city, Texas,1,2013,119036,47.4,77,12,61966,57070,93231,11453,2248,493,123,86652,32384
48,1924,4801924,Allen city, Texas,1,2013,92025,42.7,70.1,7.4,43530,48495,70743,6221,10496,183,280,77529,14496
48,3000,4803000,Amarillo city, Texas,1,2013,196691,41.5,72.6,12.1,96308,100383,164749,12391,7385,1428,79,137159,59532
48,4000,4804000,Arlington city, Texas,1,2013,379565,43.6,72.5,9.3,185091,194474,258264,66741,27701,1815,0,267265,112300
48,4462,4804462,Atascocita CDP, Texas,0,2013,65166,41.6,70,8.4,33796,31370,43931,10928,3263,0,595,49365,15801
48,5000,4805000,Austin city, Texas,1,2013,885415,51.8,78.1,7.6,444955,440460,688286,65314,54535,2560,666,584066,301349
48,6128,4806128,Baytown city, Texas,1,2013,76327,38.8,71.8,11.7,38001,38326,52870,11440,431,505,142,44021,32306
48,7000,4807000,Beaumont city, Texas,1,2013,117808,41.3,77,14.5,56216,61592,53857,56669,4450,73,0,104708,13100
48,10768,4810768,Brownsville city, Texas,1,2013,181850,42,66.8,9.7,86287,95563,170101,361,2972,228,0,12967,168883
48,10912,4810912,Bryan city, Texas,1,2013,78718,49.9,74.2,9.6,41502,37216,47484,10675,3531,453,101,49015,29703
48,13024,4813024,Carrollton city, Texas,1,2013,126695,43.2,75.5,9.7,62326,64369,80188,10501,21624,397,0,86187,40508
48,15976,4815976,College Station city, Texas,1,2013,100036,69.7,84.8,5.1,49613,50423,79275,7605,7885,146,50,85642,14394
48,17000,4817000,Corpus Christi city, Texas,1,2013,316389,41.6,74.7,12.6,154688,161701,264567,13646,5923,1546,402,125544,190845
48,19000,4819000,Dallas city, Texas,1,2013,1257676,46.4,73.9,9.1,627752,629924,747660,305645,43327,2272,467,737940,519736
48,19972,4819972,Denton city, Texas,1,2013,123105,56.1,80.6,8.4,58775,64330,94701,15151,4903,495,135,96625,26480
48,22660,4822660,Edinburg city, Texas,1,2013,80830,49.6,70,7.4,39475,41355,67557,2006,3421,189,0,12309,68521
48,24000,4824000,El Paso city, Texas,1,2013,674438,42.7,71.8,11.7,327441,346997,570340,24351,7822,3202,1148,134987,539451
48,26232,4826232,Flower Mound town, Texas,0,2013,68397,35.4,71.2,7,33881,34516,57879,2404,5723,404,0,61602,6795
48,27000,4827000,Fort Worth city, Texas,1,2013,794189,44.9,71.2,8.6,389743,404446,492980,146387,26809,4767,1188,519244,274945
48,27684,4827684,Frisco city, Texas,1,2013,136783,42.4,67.2,7.4,68935,67848,103493,10160,16144,138,125,115999,20784
48,29000,4829000,Garland city, Texas,1,2013,234694,40.5,71.1,9.7,112430,122264,100582,31486,19632,1827,92,137358,97336
48,30464,4830464,Grand Prairie city, Texas,1,2013,183324,44.6,70.1,7.6,86486,96838,111205,47438,9179,262,0,106946,76378
48,32372,4832372,Harlingen city, Texas,0,2013,65677,39,71,14.2,33258,32419,-998,-998,-998,-998,-998,13688,51989
48,35000,4835000,Houston city, Texas,1,2013,2197374,46,74.9,9.5,1101445,1095929,1289328,508643,138809,8801,752,1236816,960558
48,37000,4837000,Irving city, Texas,1,2013,228652,49.1,73.1,7.5,115507,113145,133190,29180,38709,454,286,136376,92276
48,39148,4839148,Killeen city, Texas,1,2013,137160,49.3,69.8,6.2,68075,69085,63674,47082,5931,1782,1462,97679,39481
48,41464,4841464,Laredo city, Texas,1,2013,249085,43.6,65.7,8.5,121967,127118,237387,1317,1098,977,0,12067,237018
48,41980,4841980,League City city, Texas,1,2013,92163,41,73.6,9.1,45368,46795,73623,5908,7347,91,0,78865,13298
48,42508,4842508,Lewisville city, Texas,1,2013,101154,48.4,72,6.4,49511,51643,75244,10470,7720,71,0,69701,31453
48,43888,4843888,Longview city, Texas,1,2013,81683,41.9,73.4,13.9,40804,40879,58218,19020,899,280,0,64778,16905
48,45000,4845000,Lubbock city, Texas,1,2013,239544,48.5,76,11,116543,123001,183737,20194,5647,1770,16,157123,82421
48,45384,4845384,McAllen city, Texas,1,2013,136631,44.2,70.1,10.8,68527,68104,120782,802,3464,536,0,18916,117715
48,45744,4845744,McKinney city, Texas,1,2013,148544,43.3,67.7,9,76625,71919,120430,17442,5768,378,51,118941,29603
48,47892,4847892,Mesquite city, Texas,1,2013,143341,44.7,71.5,8,69340,74001,92594,37272,4032,924,0,94124,49217
48,48072,4848072,Midland city, Texas,1,2013,123935,42,73.1,10.4,61099,62836,89865,8031,1616,487,864,75571,48364
48,48768,4848768,Mission city, Texas,1,2013,81047,41.3,64.2,11.6,38529,42518,-998,-998,-998,-998,-998,11560,69487
48,48804,4848804,Missouri City city, Texas,1,2013,69521,40.7,77.7,11.5,34658,34863,23107,32563,10377,0,0,59578,9943
48,52356,4852356,North Richland Hills city, Texas,0,2013,67319,40,76.4,13.2,32257,35062,55999,2152,4035,491,388,55885,11434
48,53388,4853388,Odessa city, Texas,1,2013,110406,44.3,70.5,9,55743,54663,90079,6142,1399,881,0,51412,58994
48,56000,4856000,Pasadena city, Texas,1,2013,152734,43.5,68.7,8.3,75949,76785,126078,3361,3052,2338,0,51687,101047
48,56348,4856348,Pearland city, Texas,1,2013,102491,39.6,71.7,10.4,50328,52163,60242,21561,15633,219,0,82124,20367
48,57200,4857200,Pharr city, Texas,1,2013,73785,43.1,64.8,8.6,34264,39521,-998,-998,-998,-998,-998,3453,70332
48,58016,4858016,Plano city, Texas,1,2013,273519,41.2,74.9,10.3,132139,141380,188898,21946,50081,1822,24,237142,36377
48,61796,4861796,Richardson city, Texas,1,2013,104477,41,77.8,14.6,51360,53117,68811,10089,17651,65,0,86505,17972
48,63500,4863500,Round Rock city, Texas,1,2013,109835,45.2,68.8,6.5,54683,55152,82855,11064,6235,198,0,79583,30252
48,64472,4864472,San Angelo city, Texas,1,2013,100111,44.4,76.6,14.7,49094,51017,81385,5256,1308,272,0,60126,39985
48,65000,4865000,San Antonio city, Texas,1,2013,1409000,44.4,74.4,11.3,692077,716923,1115376,100363,37803,7593,1137,520958,888042
48,70808,4870808,Sugar Land city, Texas,1,2013,83851,32.8,77.2,12.9,41965,41886,40489,7844,30890,0,0,75328,8523
48,72176,4872176,Temple city, Texas,0,2013,70182,39.9,73.6,13.1,35049,35133,50209,13850,2001,136,266,54525,15657
48,72656,4872656,The Woodlands CDP, Texas,0,2013,100843,35.4,71.4,11,50126,50717,88379,2482,7153,0,60,85788,15055
48,74144,4874144,Tyler city, Texas,1,2013,100217,41.5,77,16,44948,55269,71637,23255,1673,103,0,74835,25382
48,75428,4875428,Victoria city, Texas,0,2013,65097,38.1,73.9,14.3,31867,33230,55568,5095,819,94,0,31896,33201
48,76000,4876000,Waco city, Texas,1,2013,129031,48.6,75.6,11.5,61893,67138,83488,25576,3321,442,34,87702,41329
48,79000,4879000,Wichita Falls city, Texas,1,2013,104900,45.8,77.5,12.2,55746,49154,81388,13437,2701,749,0,84572,20328
49,43660,4943660,Layton city, Utah,1,2013,70798,44.8,68.5,6.3,35122,35676,62459,654,1534,312,482,62777,8021
49,55980,4955980,Ogden city, Utah,1,2013,84239,45.8,73.5,9.7,43021,41218,74874,1694,939,1421,233,59749,24490
49,57300,4957300,Orem city, Utah,1,2013,91650,49.1,71.1,8.9,44296,47354,79586,497,2866,794,1661,77289,14361
49,62470,4962470,Provo city, Utah,1,2013,116289,64,75.8,5.9,57127,59162,100000,1293,2874,1020,1554,95984,20305
49,65330,4965330,St. George city, Utah,1,2013,76824,35,71.1,21.1,37282,39542,69773,476,151,239,868,66261,10563
49,67000,4967000,Salt Lake City city, Utah,1,2013,191160,49.3,77.8,11,98142,93018,139809,5637,9855,2093,5388,151750,39410
49,67440,4967440,Sandy city, Utah,1,2013,90215,40.8,72.4,12.8,45622,44593,78346,946,3539,161,558,81208,9007
49,82950,4982950,West Jordan city, Utah,1,2013,110064,47.5,67,6.5,55835,54229,93782,773,3472,2024,1829,90384,19680
49,83470,4983470,West Valley City city, Utah,1,2013,133597,46,68.5,7.4,65050,68547,77798,4143,4450,1596,8286,86085,47512
51,1000,5101000,Alexandria city, Virginia,1,2013,148892,50,82.3,9.5,71874,77018,96307,33626,9913,237,0,123680,25212
51,3000,5103000,Arlington CDP, Virginia,0,2013,224906,54.4,83.4,9.4,111593,113313,160325,19607,21316,1858,146,189856,35050
51,14440,5114440,Centreville CDP, Virginia,0,2013,72622,44.8,73.5,5.7,34042,38580,42228,5449,18039,299,43,63622,9000
51,16000,5116000,Chesapeake city, Virginia,1,2013,230571,40.9,75.4,11.6,113137,117434,144713,68899,7393,375,163,218951,11620
51,21088,5121088,Dale City CDP, Virginia,0,2013,66259,44.8,72,8.1,33391,32868,37647,18483,5841,356,65,49759,16500
51,35000,5135000,Hampton city, Virginia,1,2013,136699,42.7,78.2,12.9,66193,70506,58817,69903,2494,39,24,129667,7032
51,47672,5147672,Lynchburg city, Virginia,1,2013,78014,49.4,79.7,13.9,36475,41539,50278,21916,2166,0,60,75405,2609
51,56000,5156000,Newport News city, Virginia,1,2013,182020,45.5,76.3,11.5,88530,93490,93041,73712,6320,465,362,167005,15015
51,57000,5157000,Norfolk city, Virginia,1,2013,246139,51.3,79.6,9.7,129237,116902,119451,102683,8565,1322,36,228225,17914
51,64000,5164000,Portsmouth city, Virginia,1,2013,96205,41.1,76.5,13.6,47371,48834,39532,50229,1312,282,0,92732,3473
51,67000,5167000,Richmond city, Virginia,1,2013,214114,48.4,81.5,11.2,102030,112084,94420,102491,4329,905,64,200516,13598
51,68000,5168000,Roanoke city, Virginia,1,2013,98465,40.6,77.9,14.4,47211,51254,64840,26127,2042,378,511,92745,5720
51,76432,5176432,Suffolk city, Virginia,1,2013,85728,39.3,74.8,12.4,41098,44630,44893,35914,612,58,102,82697,3031
51,82000,5182000,Virginia Beach city, Virginia,1,2013,448479,43.7,76.9,11.8,220447,228032,306569,84836,29786,1415,747,415021,33458
53,3180,5303180,Auburn city, Washington,1,2013,73882,40.8,75.3,11.9,35342,38540,51513,3421,7990,1846,2120,69762,4120
53,5210,5305210,Bellevue city, Washington,1,2013,133990,41.4,78.4,14.5,68617,65373,78855,3949,41754,344,75,124632,9358
53,5280,5305280,Bellingham city, Washington,1,2013,82635,52.8,83.6,13.1,40445,42190,69177,988,4947,1446,86,77040,5595
53,22640,5322640,Everett city, Washington,1,2013,105355,44.8,77.5,10.9,54768,50587,83349,3876,8716,552,2041,91696,13659
53,23515,5323515,Federal Way city, Washington,1,2013,92717,40.7,74.8,13.5,45170,47547,58043,8618,15545,981,929,75723,16994
53,35275,5335275,Kennewick city, Washington,1,2013,76760,41.6,71.6,11.5,36570,40190,54186,1814,1619,582,21,57339,19421
53,35415,5335415,Kent city, Washington,1,2013,124410,44.3,76.3,9.7,62995,61415,74881,12418,23208,951,5129,107063,17347
53,35940,5335940,Kirkland city, Washington,0,2013,84434,41.1,76.3,10.8,40898,43536,65812,439,11213,524,0,78534,5900
53,53545,5353545,Pasco city, Washington,0,2013,70345,43.1,64.9,8.4,36473,33872,53100,1417,1852,371,0,31573,38772
53,57745,5357745,Renton city, Washington,1,2013,96987,47.4,76.7,9.5,48234,48753,57196,8403,19475,1256,227,83408,13579
53,63000,5363000,Seattle city, Washington,1,2013,652429,51.5,84.6,11.4,325929,326500,459360,46431,87331,3177,2904,610439,41990
53,67000,5367000,Spokane city, Washington,1,2013,210722,42,78.6,14.3,104398,106324,183945,6141,6433,2398,963,198934,11788
53,67167,5367167,Spokane Valley city, Washington,1,2013,91111,39.2,78,15.5,47103,44008,82801,1184,1901,889,544,86341,4770
53,70000,5370000,Tacoma city, Washington,1,2013,203451,43.7,78.9,13.1,99297,104154,139048,16976,18767,1680,4038,180467,22984
53,74060,5374060,Vancouver city, Washington,1,2013,167410,42.3,75.7,13.4,80972,86438,133065,5745,7969,1124,1548,147364,20046
53,80010,5380010,Yakima city, Washington,1,2013,93260,42.1,72.1,13,45253,48007,62853,1361,731,1612,130,50741,42519
55,2375,5502375,Appleton city, Wisconsin,1,2013,74124,42.6,75.1,12.7,36227,37897,62205,1017,6390,697,0,69473,4651
55,22300,5522300,Eau Claire city, Wisconsin,0,2013,67155,49.7,79.4,12.8,32001,35154,61802,466,2830,254,0,65208,1947
55,31000,5531000,Green Bay city, Wisconsin,1,2013,104773,42,76.8,11.7,52817,51956,82682,4288,4354,3498,61,91657,13116
55,39225,5539225,Kenosha city, Wisconsin,1,2013,99887,41.9,74.9,11.8,49013,50874,82478,10295,1199,554,52,82508,17379
55,48000,5548000,Madison city, Wisconsin,1,2013,243337,54,83.2,10.3,120435,122902,194764,17257,19169,782,0,226108,17229
55,53000,5553000,Milwaukee city, Wisconsin,1,2013,599168,46.1,73.6,9.6,288604,310564,287529,233739,21205,3325,58,494541,104627
55,60500,5560500,Oshkosh city, Wisconsin,0,2013,66771,47.3,81.5,12.8,34431,32340,61457,2015,1845,111,0,64957,1814
55,66000,5566000,Racine city, Wisconsin,1,2013,78204,42.6,73.4,12.4,37044,41160,49253,17475,1062,717,0,60748,17456
55,84250,5584250,Waukesha city, Wisconsin,1,2013,71026,46.4,76.5,10.2,35956,35070,62030,1896,2420,40,0,60563,10463
72,10334,7210334,Caguas zona urbana, Puerto Rico,0,2013,82680,39.9,76.5,16.1,38322,44358,64021,6858,183,432,0,1304,81376
72,14290,7214290,Carolina zona urbana, Puerto Rico,0,2013,153245,40.5,78.2,17.8,70280,82965,89092,37859,1490,6168,0,1828,151417
72,32522,7232522,Guaynabo zona urbana, Puerto Rico,0,2013,72715,39,79.8,18.6,33181,39534,57975,3732,0,421,0,1751,70964
72,63820,7263820,Ponce zona urbana, Puerto Rico,0,2013,124904,38.2,76.8,17.9,58619,66285,109201,5303,307,449,0,1135,123769
72,76770,7276770,San Juan zona urbana, Puerto Rico,0,2013,363000,39.2,79.3,18.6,166032,196968,252956,46502,1624,2341,0,5671,357329
72,6593,7206593,Bayam√≥n zona urbana, Puerto Rico,0,2013,178894,40.2,79.3,18.1,84498,94396,112087,13096,408,2402,0,1599,177295
72,52431,7252431,Mayag√ºez zona urbana, Puerto Rico,0,2013,69454,42.4,80.4,20.4,32954,36500,41889,3848,0,199,0,418,69036
1,7000,107000,Birmingham city, Alabama,1,2014,212653,43.7,79.3,12.6,98257,114396,51751,154281,1617,413,23,205710,6943
1,21184,121184,Dothan city, Alabama,0,2014,69400,38.7,75.3,15.9,32542,36858,42496,24772,538,104,0,67315,2085
1,35896,135896,Hoover city, Alabama,1,2014,84352,38.6,78.5,17.9,40334,44018,64794,11914,3433,0,0,78577,5775
1,37000,137000,Huntsville city, Alabama,1,2014,187592,40.5,78.9,15.7,90041,97551,117137,58918,4196,461,170,177235,10357
1,50000,150000,Mobile city, Alabama,1,2014,194670,40.7,76.7,14.6,92585,102085,85101,101500,2823,458,0,188903,5767
1,51000,151000,Montgomery city, Alabama,1,2014,200486,42.6,75.6,13.2,94746,105740,69942,120378,5732,359,58,193790,6696
1,77256,177256,Tuscaloosa city, Alabama,1,2014,96116,51.1,80.5,12.1,44911,51205,49611,42277,2368,122,0,93773,2343
2,3000,203000,Anchorage municipality, Alaska,1,2014,301010,45.5,75.1,8.9,153176,147834,194958,17041,27805,21093,6629,274197,26813
4,4720,404720,Avondale city, Arizona,1,2014,79621,47.5,71.5,7.5,40906,38715,58729,8253,3691,758,0,42566,37055
4,10670,410670,Casas Adobes CDP, Arizona,0,2014,72867,39.1,76.7,17.8,34663,38204,58435,1328,992,724,41,49231,23636
4,12000,412000,Chandler city, Arizona,1,2014,254275,43.1,73.3,9.8,126999,127276,196801,12129,20254,5102,294,191054,63221
4,23620,423620,Flagstaff city, Arizona,0,2014,68786,55.6,81.8,9.7,33678,35108,52626,2053,2721,6566,0,55552,13234
4,27400,427400,Gilbert town, Arizona,1,2014,239282,42.1,66.6,7.1,118543,120739,194359,7108,17164,3730,356,200636,38646
4,27820,427820,Glendale city, Arizona,1,2014,237529,41.3,72.7,10.6,112405,125124,182397,13931,13440,2839,367,149417,88112
4,28380,428380,Goodyear city, Arizona,0,2014,75676,38.2,74.9,13.5,37150,38526,60436,7876,2609,952,174,55957,19719
4,46000,446000,Mesa city, Arizona,1,2014,464682,40.1,75,15.8,230440,234242,406265,15288,8467,7689,1569,326567,138115
4,54050,454050,Peoria city, Arizona,1,2014,166955,36.7,76.4,16.7,81937,85018,141299,6488,7416,583,57,135694,31261
4,55000,455000,Phoenix city, Arizona,1,2014,1537045,44.2,73.1,9.8,763915,773130,1122320,102038,57181,32233,4750,903946,633099
4,64210,464210,San Tan Valley CDP, Arizona,0,2014,94390,45.3,65.6,11.3,45883,48507,80498,3747,2009,3448,527,77753,16637
4,65000,465000,Scottsdale city, Arizona,1,2014,230502,35.5,84.2,22.1,110117,120385,203489,2873,9719,2946,0,207683,22819
4,71510,471510,Surprise city, Arizona,1,2014,126278,37.3,76,20.1,58527,67751,105253,7346,2278,1185,124,101375,24903
4,73000,473000,Tempe city, Arizona,1,2014,172836,59.7,86,10.7,94028,78808,122827,10474,12215,5447,824,137707,35129
4,77000,477000,Tucson city, Arizona,1,2014,527948,45.9,78.6,13.3,263671,264277,390699,24531,16829,14654,1608,305719,222229
4,85540,485540,Yuma city, Arizona,1,2014,93399,45.2,74.2,14.3,47677,45722,67779,2925,1480,416,0,40119,53280
5,23290,523290,Fayetteville city, Arkansas,1,2014,80614,58.8,81.8,8.4,39133,41481,66892,5151,1562,510,12,75008,5606
5,24550,524550,Fort Smith city, Arkansas,1,2014,87362,42.5,74.7,12.7,43069,44293,66198,9023,4808,702,0,71814,15548
5,35710,535710,Jonesboro city, Arkansas,1,2014,72214,44.8,76.9,13.5,34707,37507,53915,13322,1081,453,668,67740,4474
5,41000,541000,Little Rock city, Arkansas,1,2014,197701,42.1,76.7,13.2,90249,107452,104537,81462,4521,272,57,185476,12225
5,50450,550450,North Little Rock city, Arkansas,0,2014,66813,37.8,72.4,13.1,33195,33618,33691,29729,847,355,0,63804,3009
5,66080,566080,Springdale city, Arkansas,1,2014,78122,43.9,68.3,9.5,40599,37523,54629,541,2398,239,4424,49386,28736
6,562,600562,Alameda city, California,1,2014,77661,41.1,79.5,12.4,37527,40134,39547,4175,23967,90,719,68790,8871
6,884,600884,Alhambra city, California,1,2014,85585,40.6,82,14.3,41586,43999,18449,1587,43917,374,262,55577,30008
6,2000,602000,Anaheim city, California,1,2014,346961,44.9,75,10,171140,175821,240418,6943,62641,549,794,166309,180652
6,2252,602252,Antioch city, California,1,2014,108953,41.7,74.8,11,54821,54132,51135,23209,11208,747,1437,74608,34345
6,2364,602364,Apple Valley town, California,1,2014,71586,38.2,74.9,16.8,34208,37378,60526,3545,3148,310,41,49330,22256
6,2553,602553,Arden-Arcade CDP, California,0,2014,99903,37.9,76.4,14.4,47170,52733,66654,7812,7467,275,90,77948,21955
6,3526,603526,Bakersfield city, California,1,2014,368748,44,69.3,9.2,180907,187841,259615,26666,22915,6158,596,187850,180898
6,3666,603666,Baldwin Park city, California,1,2014,77134,44.4,75,10.5,38062,39072,20465,2462,16304,212,327,22162,54972
6,4982,604982,Bellflower city, California,1,2014,78246,41.4,74.1,10.8,38296,39950,26514,9640,11311,251,159,36564,41682
6,6000,606000,Berkeley city, California,1,2014,118851,58.3,87.2,12.6,57321,61530,72378,10058,21796,536,82,105704,13147
6,8786,608786,Buena Park city, California,1,2014,83114,43.6,76.3,10.9,41571,41543,49863,2280,24612,726,0,50159,32955
6,8954,608954,Burbank city, California,1,2014,105366,43.5,80.4,14.5,51046,54320,74271,1149,10489,776,0,76994,28372
6,10046,610046,Camarillo city, California,0,2014,66932,35.1,75.1,18.6,32824,34108,53249,1408,6484,164,0,50595,16337
6,11194,611194,Carlsbad city, California,1,2014,112310,33.9,76.8,15,55806,56504,96417,343,8469,131,0,94132,18178
6,11390,611390,Carmichael CDP, California,0,2014,66493,34.9,80,20.8,30625,35868,54942,3418,2820,449,258,56693,9800
6,11530,611530,Carson city, California,1,2014,93272,42.7,76.8,13.5,47027,46245,27836,20520,23732,99,2274,55317,37955
6,13014,613014,Chico city, California,1,2014,89187,52.3,81.5,11.7,45207,43980,74917,1711,2709,482,187,74079,15108
6,13210,613210,Chino city, California,1,2014,84743,46.3,79,8.2,51588,33155,37633,6203,7497,651,385,35951,48792
6,13214,613214,Chino Hills city, California,1,2014,77005,41.8,75.7,7.9,38447,38558,32640,4225,25789,164,0,54849,22156
6,13392,613392,Chula Vista city, California,1,2014,260977,43.1,73.8,12.9,129689,131288,176481,10652,39570,199,1242,111360,149617
6,13588,613588,Citrus Heights city, California,1,2014,86147,39.7,79,16.3,40533,45614,73036,3097,2500,160,97,71107,15040
6,14218,614218,Clovis city, California,1,2014,102190,41,69.9,10.4,51226,50964,68887,4462,12094,1748,532,72124,30066
6,15044,615044,Compton city, California,1,2014,98596,48.9,71.3,6.6,47144,51452,43354,31877,804,254,460,33922,64674
6,16000,616000,Concord city, California,1,2014,127511,41.5,79,13.2,63749,63762,93582,4491,12592,758,106,88755,38756
6,16350,616350,Corona city, California,1,2014,161498,42.8,74.3,9.7,78773,82725,108631,10263,21221,227,820,94299,67199
6,16532,616532,Costa Mesa city, California,1,2014,112793,48.3,78.4,9.3,56625,56168,67025,2462,10330,123,664,68516,44277
6,17918,617918,Daly City city, California,1,2014,106099,44.3,81,16.9,51276,54823,21455,3113,60677,0,722,78154,27945
6,18100,618100,Davis city, California,0,2014,66733,59.9,85.2,9.6,32242,34491,38895,2249,17268,0,117,57992,8741
6,19766,619766,Downey city, California,1,2014,114168,42.8,77.5,11.1,55667,58501,59116,3687,10765,263,1133,32898,81270
6,20802,620802,East Los Angeles CDP, California,0,2014,117267,45.6,75.2,11.5,55598,61669,55657,761,1711,734,39,4891,112376
6,21712,621712,El Cajon city, California,1,2014,103075,44.3,74.1,12.1,54094,48981,73709,7354,4523,355,1638,70566,32509
6,22020,622020,Elk Grove city, California,1,2014,163560,41.7,72.2,10.8,78798,84762,79022,17451,45696,3345,625,137057,26503
6,22230,622230,El Monte city, California,1,2014,116617,43.1,75.3,12.3,58628,57989,66916,785,34597,692,387,42316,74301
6,22804,622804,Escondido city, California,1,2014,150252,45.4,73.4,11.4,74189,76063,119782,4380,10064,913,152,71793,78459
6,23182,623182,Fairfield city, California,1,2014,111139,40.4,74.5,11.9,54342,56797,53687,14203,19094,651,1374,77296,33843
6,24638,624638,Folsom city, California,1,2014,75366,36.8,77.9,14.1,40367,34999,50413,4966,12453,164,695,65841,9525
6,24680,624680,Fontana city, California,1,2014,204953,46.7,71.7,8,101464,103489,81353,15249,15230,1805,1216,72006,132947
6,26000,626000,Fremont city, California,1,2014,228760,42.2,75.8,11,114098,114662,58799,7888,126464,1354,2172,195628,33132
6,27000,627000,Fresno city, California,1,2014,515985,43.8,71.2,10.8,254170,261815,267332,40245,67486,4356,385,265996,249989
6,28000,628000,Fullerton city, California,1,2014,139663,45.1,75,11.5,69620,70043,75857,3469,33352,551,768,85747,53916
6,29000,629000,Garden Grove city, California,1,2014,175085,41.1,77.2,12.8,87177,87908,73705,1160,69512,926,95,108900,66185
6,30000,630000,Glendale city, California,1,2014,200161,40.6,83.2,16.5,92906,107255,139421,2101,32543,875,0,162116,38045
6,32548,632548,Hawthorne city, California,1,2014,87591,46.3,74.2,9.6,42673,44918,29553,19618,5238,475,0,40278,47313
6,33000,633000,Hayward city, California,1,2014,154633,45.7,78.9,11.2,77664,76969,70988,19394,39747,787,2255,92829,61804
6,33182,633182,Hemet city, California,1,2014,83040,36,75.8,23.6,37486,45554,60734,10817,3102,1046,0,52056,30984
6,33434,633434,Hesperia city, California,1,2014,92744,40.5,68.6,9.1,43377,49367,76059,7796,2035,1116,0,40220,52524
6,36000,636000,Huntington Beach city, California,1,2014,200814,42.5,81.1,15.6,100899,99915,151238,2261,23707,1563,366,162884,37930
6,36448,636448,Indio city, California,1,2014,85639,40.8,70.8,14.1,41734,43905,39606,1200,2489,810,33,24571,61068
6,36546,636546,Inglewood city, California,1,2014,111901,43.6,74.6,10.3,51171,60730,29382,48988,1496,964,379,57178,54723
6,36770,636770,Irvine city, California,1,2014,248521,48,76,10.2,121361,127160,120744,6816,94616,420,89,223556,24965
6,37692,637692,Jurupa Valley city, California,0,2014,98843,43.2,68.9,8.7,51346,47497,52346,2865,3029,1803,165,31174,67669
6,39248,639248,Laguna Niguel city, California,0,2014,65435,31.2,80.6,15.5,32673,32762,50110,1684,6978,446,154,56374,9061
6,39496,639496,Lake Forest city, California,1,2014,80125,41.8,76.7,10.7,39142,40983,56964,1450,9860,1015,117,58990,21135
6,39892,639892,Lakewood city, California,1,2014,81641,42.6,79.2,12.7,39582,42059,38864,5522,12818,600,958,48829,32812
6,40130,640130,Lancaster city, California,1,2014,161036,42.9,70.4,10.4,78543,82493,96978,38908,6809,1068,748,107774,53262
6,41992,641992,Livermore city, California,1,2014,86856,38.3,77,12.8,42458,44398,69338,1504,8448,171,193,67253,19603
6,43000,643000,Long Beach city, California,1,2014,473605,45.6,75.6,10,234805,238800,257998,59993,68620,2428,4891,273427,200178
6,44000,644000,Los Angeles city, California,1,2014,3928827,46.4,78.2,11.6,1952196,1976631,2101883,350773,456847,32059,8781,2017837,1910990
6,44574,644574,Lynwood city, California,1,2014,71846,46.6,72.2,7.3,35037,36809,36863,7440,177,374,34,8661,63185
6,45484,645484,Manteca city, California,1,2014,73477,41.2,73.9,12.6,35453,38024,47219,1519,8488,854,28,46526,26951
6,46842,646842,Menifee city, California,1,2014,85201,38.5,76.4,19.2,38317,46884,57741,5329,4991,759,442,55708,29493
6,46898,646898,Merced city, California,1,2014,81739,45.1,70.8,11.3,40614,41125,39143,5510,11036,248,91,44017,37722
6,47766,647766,Milpitas city, California,1,2014,73679,43.6,77.4,10.2,35215,38464,14487,1570,45908,242,399,59343,14336
6,48256,648256,Mission Viejo city, California,1,2014,97231,36.6,79.9,16.3,48567,48664,75620,666,8490,274,0,76836,20395
6,48354,648354,Modesto city, California,1,2014,209308,40.3,75.8,13.7,101265,108043,157995,7099,15262,1813,1666,133980,75328
6,49270,649270,Moreno Valley city, California,1,2014,202978,46.2,70.5,8.6,98854,104124,81239,34318,16389,1441,1113,87834,115144
6,49670,649670,Mountain View city, California,1,2014,79374,45.7,79.3,10.5,42578,36796,46016,2314,24891,44,61,65475,13899
6,50076,650076,Murrieta city, California,1,2014,108371,43,70.5,9.8,54572,53799,74588,10562,4706,916,485,79215,29156
6,50258,650258,Napa city, California,1,2014,80009,40,77.3,13.9,40222,39787,60725,984,2337,462,0,47513,32496
6,51182,651182,Newport Beach city, California,1,2014,87242,31.7,81.5,21.2,43085,44157,72550,105,8108,454,124,80042,7200
6,52526,652526,Norwalk city, California,1,2014,107111,45,79.6,10.8,54627,52484,61646,3933,17246,597,298,32442,74669
6,53000,653000,Oakland city, California,1,2014,413782,45.3,78.9,11.9,198623,215159,155910,100601,63484,5166,3456,300568,113214
6,53322,653322,Oceanside city, California,1,2014,174552,42.1,78.2,15.9,85340,89212,136101,8423,10364,921,1619,122320,52232
6,53896,653896,Ontario city, California,1,2014,169085,47.4,72.8,7.9,83145,85940,78675,9450,8449,1819,1368,48320,120765
6,53980,653980,Orange city, California,1,2014,139826,46.6,75.9,10.5,70646,69180,96705,1983,17408,626,0,85125,54701
6,54652,654652,Oxnard city, California,1,2014,205434,45.2,72.1,9.3,105699,99735,157195,3661,16563,3933,273,50618,154816
6,55156,655156,Palmdale city, California,1,2014,158274,42.7,70.1,7.9,79488,78786,62018,19408,7596,635,176,64650,93624
6,55282,655282,Palo Alto city, California,0,2014,66968,37.5,77.7,17.8,34371,32597,39273,860,23519,9,303,63438,3530
6,56000,656000,Pasadena city, California,1,2014,140860,45.9,80.6,13.6,70848,70012,72395,13692,24929,237,168,93928,46932
6,56700,656700,Perris city, California,1,2014,73751,48.3,69.8,6.2,37530,36221,19993,5743,2679,331,0,14824,58927
6,57456,657456,Pittsburg city, California,0,2014,68122,43.3,75.3,11,31773,36349,23628,11429,10204,300,1136,42184,25938
6,57792,657792,Pleasanton city, California,1,2014,77676,35.2,73.3,13.3,38910,38766,47454,1353,24241,98,432,72160,5516
6,58072,658072,Pomona city, California,1,2014,153381,45.6,72,9.2,75322,78059,96332,9334,13332,838,128,44677,108704
6,59444,659444,Rancho Cordova city, California,0,2014,69727,44,76.1,11.9,32737,36990,44655,5425,8088,204,482,54904,14823
6,59451,659451,Rancho Cucamonga city, California,1,2014,174302,43.3,76.8,10,85895,88407,108124,14551,22543,2909,0,113264,61038
6,59920,659920,Redding city, California,1,2014,91588,39.2,77.2,18.3,43789,47799,78324,1434,3178,783,0,83015,8573
6,59962,659962,Redlands city, California,1,2014,70618,45,74,12.6,34051,36567,51452,5057,6106,551,1352,51197,19421
6,60018,660018,Redondo Beach city, California,1,2014,68146,44.9,78.8,10.8,35112,33034,51220,1167,7840,0,56,52161,15985
6,60102,660102,Redwood City city, California,1,2014,82868,42.4,76.6,12.6,41346,41522,48245,1729,9756,753,426,50381,32487
6,60466,660466,Rialto city, California,1,2014,102740,47.6,70.6,8.4,51107,51633,60732,12805,1913,980,324,27177,75563
6,60620,660620,Richmond city, California,1,2014,108562,41.9,76.8,11.4,52501,56061,32448,23452,17022,727,1427,65678,42884
6,62000,662000,Riverside city, California,1,2014,319519,46.6,74.7,9.5,157133,162386,215584,17937,25919,3660,1327,155214,164305
6,62938,662938,Roseville city, California,1,2014,128593,37.2,75.2,16.9,61615,66978,101770,1810,13808,211,443,110907,17686
6,64000,664000,Sacramento city, California,1,2014,485193,44.9,75.6,11.6,238864,246329,234625,69249,90255,3151,8600,341692,143501
6,64224,664224,Salinas city, California,1,2014,156678,45.4,69.9,8,77450,79228,123642,1854,11261,1061,0,40708,115970
6,65000,665000,San Bernardino city, California,1,2014,215227,45.2,67.9,8.4,105530,109697,125109,30580,10270,1701,369,76788,138439
6,65042,665042,San Buenaventura (Ventura) city, California,1,2014,109478,37.6,79.6,15.9,52067,57411,93981,1845,3117,1047,166,72677,36801
6,65084,665084,San Clemente city, California,0,2014,65342,36.3,78.7,18.6,32055,33287,51265,341,3074,127,1967,55161,10181
6,66000,666000,San Diego city, California,1,2014,1381083,47.3,79.6,11.4,690091,690992,889280,89431,228372,5347,4525,962648,418435
6,67000,667000,San Francisco city, California,1,2014,852469,48.3,86.6,14.4,433882,418587,403610,45986,289650,2382,3665,722194,130275
6,68000,668000,San Jose city, California,1,2014,1015796,43.3,76.9,11.7,507542,508254,438911,29970,349632,4929,4493,682845,332951
6,68084,668084,San Leandro city, California,1,2014,89347,41.8,80.4,14.3,44035,45312,38286,12174,24185,1411,1477,63066,26281
6,68196,668196,San Marcos city, California,1,2014,92910,43.9,74.5,12,47687,45223,56080,2425,9899,281,1257,59414,33496
6,68252,668252,San Mateo city, California,1,2014,102885,39.5,79.4,15.9,50821,52064,67681,1731,21896,241,679,77674,25211
6,68378,668378,San Ramon city, California,1,2014,75319,39.6,69,10.4,37609,37710,31885,2145,34938,39,798,70033,5286
6,69000,669000,Santa Ana city, California,1,2014,334924,46.6,72.1,8.3,170381,164543,167781,2555,35172,2487,1394,71185,263739
6,69070,669070,Santa Barbara city, California,1,2014,91208,43,81.2,17,46890,44318,71822,338,3085,776,278,56770,34438
6,69084,669084,Santa Clara city, California,1,2014,122198,49.1,81,12.2,64128,58070,58345,3314,47647,415,922,102708,19490
6,69088,669088,Santa Clarita city, California,1,2014,181559,39.1,72.1,11.4,87585,93974,129839,7063,19273,915,170,123934,57625
6,69196,669196,Santa Maria city, California,1,2014,103414,45.9,67.8,9,52031,51383,82363,3022,3791,659,205,26405,77009
6,70000,670000,Santa Monica city, California,1,2014,92989,44.4,86.8,17.4,44044,48945,75667,2882,7017,1068,0,76899,16090
6,70098,670098,Santa Rosa city, California,1,2014,174166,40.3,76.4,14.5,83824,90342,123008,1797,10570,3621,904,119479,54687
6,72016,672016,Simi Valley city, California,1,2014,126873,40,77.9,13.8,61967,64906,102150,1351,13572,911,170,93381,33492
6,73080,673080,South Gate city, California,1,2014,96299,45.8,73,8.7,45042,51257,55677,1065,591,183,98,5567,90732
6,73262,673262,South San Francisco city, California,0,2014,67011,44.4,85.7,14.4,32460,34551,26050,2171,27320,190,1482,44990,22021
6,75000,675000,Stockton city, California,1,2014,302405,41.9,72.1,11.3,149291,153114,138630,41846,61559,1927,3571,179071,123334
6,77000,677000,Sunnyvale city, California,1,2014,149984,46.6,74.2,11.1,73339,76645,75207,2448,62966,348,311,122504,27480
6,78120,678120,Temecula city, California,1,2014,109446,40.9,73,11.4,53871,55575,84170,3451,12960,317,376,82404,27042
6,78582,678582,Thousand Oaks city, California,1,2014,129344,36,77.8,17.1,62715,66629,106424,1873,10462,312,191,111398,17946
6,80000,680000,Torrance city, California,1,2014,148483,36.5,78.3,16.9,74595,73888,79909,3283,48414,1295,589,124632,23851
6,80238,680238,Tracy city, California,1,2014,85835,45.2,68.1,6.8,43847,41988,52258,3059,13582,229,167,50971,34864
6,80812,680812,Turlock city, California,1,2014,71246,43.6,74,13.1,35136,36110,56043,1497,4363,63,583,45049,26197
6,80854,680854,Tustin city, California,1,2014,80617,47.8,77.7,9.5,39303,41314,35234,2256,15809,737,606,43264,37353
6,81204,681204,Union City city, California,1,2014,73608,41.4,79.8,16.1,36832,36776,13375,4218,40474,68,666,57658,15950
6,81344,681344,Upland city, California,1,2014,76039,40.4,76.7,15,36703,39336,45968,5446,5438,313,0,45803,30236
6,81554,681554,Vacaville city, California,1,2014,95863,41.1,76.8,11.2,50438,45425,62369,8782,8329,708,45,70716,25147
6,81666,681666,Vallejo city, California,1,2014,120210,40.5,78.4,14.1,57333,62877,50444,26352,31015,627,244,91991,28219
6,82590,682590,Victorville city, California,1,2014,121911,45,65.7,8.3,61941,59970,74162,21298,5250,1408,519,52403,69508
6,82954,682954,Visalia city, California,1,2014,129280,40.5,68.9,12.6,65719,63561,103599,3777,5317,1075,0,65236,64044
6,82996,682996,Vista city, California,1,2014,98086,49.3,75.2,8.1,48632,49454,72080,1643,4738,423,162,51387,46699
6,83346,683346,Walnut Creek city, California,0,2014,67664,31.1,84,29.2,31240,36424,52265,1114,9875,135,64,60249,7415
6,84200,684200,West Covina city, California,1,2014,108445,40.3,76.8,14.2,52771,55674,36506,5140,32130,730,0,50667,57778
6,84550,684550,Westminster city, California,1,2014,92062,39.4,82.9,17.8,46867,45195,39397,226,44784,710,168,73627,18435
6,85292,685292,Whittier city, California,1,2014,87348,44.4,75.3,12.6,42023,45325,50894,943,3572,157,186,27733,59615
6,86832,686832,Yorba Linda city, California,0,2014,67824,34.9,74.7,15,34267,33557,50544,1181,9650,141,0,54278,13546
6,86972,686972,Yuba City city, California,0,2014,65775,44.6,74.9,13.1,32501,33274,44523,2236,11367,759,624,47738,18037
8,3455,803455,Arvada city, Colorado,1,2014,113775,38.2,78.6,14.2,55421,58354,105457,788,2668,994,0,95646,18129
8,4000,804000,Aurora city, Colorado,1,2014,353381,43.7,73.8,10.4,172051,181330,222225,50629,18068,4671,693,249175,104206
8,7850,807850,Boulder city, Colorado,1,2014,105101,59.1,86.7,10.2,56566,48535,93080,1099,4550,351,89,94782,10319
8,12815,812815,Centennial city, Colorado,1,2014,107193,35.7,77,15,53106,54087,93347,2381,5839,262,400,98729,8464
8,16000,816000,Colorado Springs city, Colorado,1,2014,445820,44.1,76.8,12.5,223286,222534,350458,20843,15377,1820,705,365374,80446
8,20000,820000,Denver city, Colorado,1,2014,663862,48.8,79.1,10.9,332182,331680,520398,62757,24784,7326,174,459487,204375
8,27425,827425,Fort Collins city, Colorado,1,2014,156473,55.7,80.8,9.2,79016,77457,139809,2721,4549,1085,451,136391,20082
8,32155,832155,Greeley city, Colorado,1,2014,98593,45.4,73.5,12.8,47171,51422,85289,2287,509,855,48,59083,39510
8,36410,836410,Highlands Ranch CDP, Colorado,0,2014,100192,37.8,70.9,9.8,49363,50829,89874,643,5807,185,30,92298,7894
8,43000,843000,Lakewood city, Colorado,1,2014,149650,40.4,79.6,15.5,74749,74901,135026,2634,2544,1875,107,117939,31711
8,45970,845970,Longmont city, Colorado,1,2014,90189,40.3,74.3,13.1,43188,47001,75498,1551,3841,1661,0,67533,22656
8,46465,846465,Loveland city, Colorado,1,2014,72647,34.9,79.2,19.9,34270,38377,67489,166,787,756,967,67869,4778
8,62000,862000,Pueblo city, Colorado,1,2014,108439,39.7,76,16.7,52417,56022,78493,3138,955,2077,0,51809,56630
8,77290,877290,Thornton city, Colorado,1,2014,130309,44.5,69.8,8.5,65151,65158,114844,2723,5100,1085,136,87077,43232
8,83835,883835,Westminster city, Colorado,1,2014,112099,42.6,78.8,13,56161,55938,94151,2886,7522,2202,45,86766,25333
9,8000,908000,Bridgeport city, Connecticut,1,2014,147608,46.1,75.1,9.9,72305,75303,55760,52367,4045,774,0,88008,59600
9,18430,918430,Danbury city, Connecticut,1,2014,83795,42.8,77.7,12.7,41499,42296,54030,6312,3955,210,0,60086,23709
9,37000,937000,Hartford city, Connecticut,1,2014,124721,47.4,74.7,8.9,60232,64489,45701,46063,4392,518,16,71325,53396
9,50370,950370,New Britain city, Connecticut,1,2014,72889,47.3,76.1,10.8,35545,37344,52870,6789,2415,166,281,39940,32949
9,52000,952000,New Haven city, Connecticut,1,2014,130285,51.2,77.3,10.2,60372,69913,55948,45210,6409,418,76,94936,35349
9,55990,955990,Norwalk city, Connecticut,1,2014,88144,43.5,79.9,14.7,42841,45303,61782,15160,5466,526,100,67093,21051
9,73000,973000,Stamford city, Connecticut,1,2014,128283,43.1,79.6,12.9,64716,63567,75547,17081,12426,175,103,95389,32894
9,80000,980000,Waterbury city, Connecticut,1,2014,109311,42.2,74.9,11.9,56617,52694,63630,21262,2306,15,0,69115,40196
10,77580,1077580,Wilmington city, Delaware,1,2014,71808,42.6,77.4,12.8,33064,38744,25207,38949,1203,54,142,63577,8231
11,50000,1150000,Washington city, District of Columbia,1,2014,658893,51.5,82.5,11.3,312633,346260,265077,321346,24910,1859,172,590537,68356
12,410,1200410,Alafaya CDP, Florida,0,2014,84594,51.8,73.5,5.3,41289,43305,59191,8539,6993,0,0,57019,27575
12,7300,1207300,Boca Raton city, Florida,1,2014,91321,37.8,85.1,19.5,43639,47682,76186,4575,4151,100,0,80523,10798
12,7875,1207875,Boynton Beach city, Florida,1,2014,73121,38.4,81.8,20.4,35541,37580,46096,23558,1412,62,310,62170,10951
12,8150,1208150,Brandon CDP, Florida,0,2014,105125,41.2,79.7,13.4,50231,54894,74502,15262,5530,99,254,82360,22765
12,10275,1210275,Cape Coral city, Florida,1,2014,169855,31.1,79.9,22.5,82335,87520,151511,12082,2248,193,0,139817,30038
12,12875,1212875,Clearwater city, Florida,1,2014,110709,36.5,82.1,21,53840,56869,89704,13512,2984,238,0,95103,15606
12,14400,1214400,Coral Springs city, Florida,1,2014,127963,42.6,78.3,10.5,64355,63608,83957,24524,8207,1095,0,97605,30358
12,16475,1216475,Davie town, Florida,1,2014,98905,44.1,77.6,11.1,46461,52444,78648,8025,5261,499,416,62295,36610
12,16725,1216725,Deerfield Beach city, Florida,1,2014,78898,38.2,79.5,20.1,40224,38674,53889,18785,1495,566,0,63587,15311
12,17100,1217100,Delray Beach city, Florida,0,2014,65054,38.6,83.1,24.8,33880,31174,37237,22824,1552,67,0,58859,6195
12,17200,1217200,Deltona city, Florida,1,2014,86907,38,75.8,13.9,40913,45994,71540,10851,1478,1031,0,64486,22421
12,24000,1224000,Fort Lauderdale city, Florida,1,2014,176018,35.7,81.6,18,91239,84779,115219,52714,2524,151,228,148937,27081
12,24125,1224125,Fort Myers city, Florida,0,2014,70916,39.3,79.4,16.7,34397,36519,46198,19087,1337,59,72,56203,14713
12,25175,1225175,Gainesville city, Florida,1,2014,128474,63,87.7,10.2,61234,67240,84169,27889,8928,316,206,117424,11050
12,30000,1230000,Hialeah city, Florida,1,2014,235566,38.2,83.1,18.2,113813,121753,222473,7059,189,114,0,7566,228000
12,32000,1232000,Hollywood city, Florida,1,2014,148040,40.4,81.3,16.2,72357,75683,106466,25510,4450,93,0,98245,49795
12,32275,1232275,Homestead city, Florida,0,2014,65514,46.3,69.2,8.5,33544,31970,48289,12621,1390,0,0,25273,40241
12,35000,1235000,Jacksonville city, Florida,1,2014,853376,42.1,76.8,12.6,411582,441794,508647,267080,39525,2047,288,777590,75786
12,36100,1236100,Kendall CDP, Florida,0,2014,79143,36.4,81,20.2,39092,40051,69430,3044,4315,0,0,29603,49540
12,36950,1236950,Kissimmee city, Florida,0,2014,66729,47.5,75.4,10,34860,31869,44302,8607,1775,0,0,22159,44570
12,38250,1238250,Lakeland city, Florida,1,2014,102335,37.3,78.3,20.5,48884,53451,73705,22623,1482,481,0,85764,16571
12,39425,1239425,Largo city, Florida,1,2014,79028,32.3,84.7,26,36638,42390,68353,5141,1538,179,64,67665,11363
12,39550,1239550,Lauderhill city, Florida,1,2014,70636,41,79.3,16.7,31006,39630,16063,49551,1810,224,0,60892,9744
12,39925,1239925,Lehigh Acres CDP, Florida,0,2014,111416,43,70.2,11.5,56578,54838,77443,24924,2034,170,660,70947,40469
12,43975,1243975,Melbourne city, Florida,1,2014,78486,37.4,82.8,22.3,37604,40882,63745,9822,1327,635,0,68023,10463
12,45000,1245000,Miami city, Florida,1,2014,430341,43.2,82.3,15.9,209516,220825,315691,87384,3829,419,38,126522,303819
12,45025,1245025,Miami Beach city, Florida,1,2014,91721,40.2,83.1,16.6,47749,43972,73268,2839,1075,288,185,42554,49167
12,45060,1245060,Miami Gardens city, Florida,1,2014,112270,43.8,77.5,13,52212,60058,23368,83203,1289,602,366,82069,30201
12,45975,1245975,Miramar city, Florida,1,2014,134991,42.6,74.2,10.2,63236,71755,58241,59679,9912,0,0,83319,51672
12,53000,1253000,Orlando city, Florida,1,2014,262396,50.7,78.7,10,128229,134167,162828,72050,10579,566,186,192561,69835
12,54000,1254000,Palm Bay city, Florida,1,2014,105845,37.5,78.8,16.7,51135,54710,76043,22675,2287,303,0,89190,16655
12,54200,1254200,Palm Coast city, Florida,1,2014,82388,30.7,81.1,28.4,38697,43691,67091,10320,2499,77,65,72573,9815
12,55775,1255775,Pembroke Pines city, Florida,1,2014,164625,37.3,77.1,16.2,74253,90372,105626,41538,7620,240,0,91516,73109
12,56825,1256825,Pine Hills CDP, Florida,0,2014,76021,41.8,72.4,8.6,35610,40411,8939,58325,1861,37,0,66228,9793
12,57425,1257425,Plantation city, Florida,1,2014,91454,40.5,80,13.4,44484,46970,65570,17348,4375,3,392,68725,22729
12,58050,1258050,Pompano Beach city, Florida,1,2014,106115,37.5,81.9,21,55934,50181,66950,32714,1685,213,0,88244,17871
12,58715,1258715,Port St. Lucie city, Florida,1,2014,174093,34.8,78.8,20.5,87806,86287,129836,30765,3679,293,0,140595,33498
12,60950,1260950,Riverview CDP, Florida,0,2014,81226,42.6,72.1,8.8,39355,41871,51260,13295,3215,345,491,55680,25546
12,63000,1263000,St. Petersburg city, Florida,1,2014,253682,38.3,81,17,123768,129914,172432,58321,10078,753,345,237517,16165
12,68350,1268350,Spring Hill CDP, Florida,0,2014,98950,31.6,81.2,24.3,47439,51511,87883,5187,1860,143,0,84158,14792
12,69700,1269700,Sunrise city, Florida,1,2014,91256,41,78.6,14.6,42104,49152,50278,33701,2651,89,0,67154,24102
12,70600,1270600,Tallahassee city, Florida,1,2014,188106,59.1,82.8,9,90019,98087,108478,68156,7398,277,211,175260,12846
12,71000,1271000,Tampa city, Florida,1,2014,358684,44.6,78,12.3,174566,184118,231131,88164,14094,1168,340,273321,85363
12,71625,1271625,The Villages CDP, Florida,0,2014,-998,-999999999,-999999999,-999999999,-998,-998,-998,-998,-998,-998,-998,66122,2752
12,72145,1272145,Town 'n' Country CDP, Florida,0,2014,87874,44.7,79.4,12.7,43025,44849,72504,6299,4421,133,0,48856,39018
12,76582,1276582,Weston city, Florida,0,2014,69091,35.9,70.4,10.2,35600,33491,57471,5089,2574,969,0,35214,33877
12,76600,1276600,West Palm Beach city, Florida,1,2014,104017,41.7,80.2,17.2,49350,54667,58348,34889,4533,0,198,80375,23642
13,1052,1301052,Albany city, Georgia,1,2014,73016,43.3,74.9,13,32389,40627,-998,-998,-998,-998,-998,71532,1484
13,3440,1303440,Athens-Clarke County unified government (balance), Georgia,1,2014,119841,59.6,82.4,9.8,57618,62223,75599,33041,5565,52,0,106887,12954
13,4000,1304000,Atlanta city, Georgia,1,2014,456012,50.2,81.3,11.4,220350,235662,188315,234394,17133,638,81,434627,21385
13,4204,1304204,Augusta-Richmond County consolidated government (balance), Georgia,1,2014,197465,43.3,76.2,12.5,94648,102817,76062,111432,3681,405,0,188441,9024
13,19000,1319000,Columbus city, Georgia,1,2014,200887,44.3,75.8,11.9,98634,102253,91379,89440,4689,843,322,185869,15018
13,42425,1342425,Johns Creek city, Georgia,1,2014,83108,38.3,71.7,7.3,40602,42506,50622,8616,21177,81,0,77471,5637
13,49008,1349008,Macon-Bibb County, Georgia,0,2014,153633,40,74.8,14,72268,81365,66160,81483,3060,0,37,148752,4881
13,67284,1367284,Roswell city, Georgia,1,2014,94073,41.2,74.5,11.4,47572,46501,72875,12074,6322,356,132,80618,13455
13,68516,1368516,Sandy Springs city, Georgia,1,2014,101914,44.4,78.8,13.5,48621,53293,67771,22990,7409,208,112,91410,10504
13,69000,1369000,Savannah city, Georgia,1,2014,144355,46.8,79.6,13.4,66576,77779,56434,79829,2915,184,299,140181,4174
13,80508,1380508,Warner Robins city, Georgia,1,2014,73060,46,74.6,9.9,33578,39482,37604,27923,2303,1033,0,67943,5117
15,71550,1571550,Urban Honolulu CDP, Hawaii,0,2014,350403,41,82.9,18.8,175998,174405,59358,6229,188187,504,34203,330743,19660
16,8830,1608830,Boise City city, Idaho,1,2014,216280,43.1,76.5,12.5,109906,106374,189444,5660,8529,2096,0,195976,20304
16,52120,1652120,Meridian city, Idaho,1,2014,87739,40.5,72.2,11.5,42290,45449,-998,-998,-998,-998,-998,80450,7289
16,56260,1656260,Nampa city, Idaho,1,2014,88208,42.1,69.2,11.4,42289,45919,77022,502,1421,1441,223,68589,19619
17,2154,1702154,Arlington Heights village, Illinois,1,2014,74445,35.4,78.1,18.6,35308,39137,63594,1591,5684,215,0,70133,4312
17,3012,1703012,Aurora city, Illinois,1,2014,200708,45.9,70.5,7.7,99376,101332,108563,24226,13694,1114,0,116014,84694
17,6613,1706613,Bloomington city, Illinois,1,2014,78743,45.6,77.3,11.5,39132,39611,62291,7196,5734,31,0,72876,5867
17,7133,1707133,Bolingbrook village, Illinois,1,2014,73414,43.4,70.7,7.7,36036,37378,31390,17310,6442,0,0,52336,21078
17,12385,1712385,Champaign city, Illinois,1,2014,84520,56.8,82.1,9.1,42590,41930,58095,14631,9262,96,0,80263,4257
17,14000,1714000,Chicago city, Illinois,1,2014,2722407,47.2,78,11.4,1314074,1408333,1317969,852756,164633,7567,1012,1920162,802245
17,14351,1714351,Cicero town, Illinois,1,2014,84359,45.8,68.7,6.3,43220,41139,38660,4333,392,302,38,9722,74637
17,18823,1718823,Decatur city, Illinois,1,2014,73081,39.2,77.8,16.9,34329,38752,52791,14645,1012,360,0,70984,2097
17,23074,1723074,Elgin city, Illinois,1,2014,116548,43.3,75.2,12.2,59007,57541,77318,7982,7382,1315,0,67497,49051
17,24582,1724582,Evanston city, Illinois,1,2014,75657,46.1,79.9,13.3,35339,40318,53053,13875,4641,97,36,68144,7513
17,38570,1738570,Joliet city, Illinois,1,2014,146578,43.6,71.5,8.8,71078,75500,91846,27243,4390,848,0,108383,38195
17,51622,1751622,Naperville city, Illinois,1,2014,145396,38.6,74.5,10,71550,73846,105858,6869,26893,271,0,137500,7896
17,57225,1757225,Palatine village, Illinois,1,2014,69357,39.2,74.8,12.9,33434,35923,49525,1850,9186,0,0,56636,12721
17,59000,1759000,Peoria city, Illinois,1,2014,117288,42.2,75.4,13.5,56813,60475,72749,29175,6125,505,36,110560,6728
17,65000,1765000,Rockford city, Illinois,1,2014,148996,38.2,75.3,15,72805,76191,100083,31647,4837,752,0,124965,24031
17,68003,1768003,Schaumburg village, Illinois,1,2014,75287,43.4,79.3,14.6,35679,39608,51747,3063,14270,85,50,67915,7372
17,70122,1770122,Skokie village, Illinois,0,2014,65128,38.8,78.1,15.9,30154,34974,38619,5624,17626,0,0,59696,5432
17,72000,1772000,Springfield city, Illinois,1,2014,116649,38.8,77.2,16.2,54351,62298,84056,24449,2655,285,93,113031,3618
17,79293,1779293,Waukegan city, Illinois,1,2014,88998,45.8,72.5,9.5,43420,45578,61329,14983,6141,242,196,42694,46304
18,5860,1805860,Bloomington city, Indiana,1,2014,83423,68.4,87,7,40627,42796,67845,4127,7956,465,0,79857,3566
18,10342,1810342,Carmel city, Indiana,1,2014,87015,32.7,72.9,15.4,41250,45765,75200,892,9233,0,0,82943,4072
18,22000,1822000,Evansville city, Indiana,1,2014,121299,41,78.4,15.5,57080,64219,98832,15483,1063,125,193,117054,4245
18,23278,1823278,Fishers town, Indiana,1,2014,84967,44.5,68.1,6.5,40947,44020,71598,5601,4820,0,0,84099,868
18,25000,1825000,Fort Wayne city, Indiana,1,2014,256023,42,74.5,12.5,124040,131983,188136,37046,11591,374,23,234791,21232
18,27000,1827000,Gary city, Indiana,1,2014,71180,32.7,72.5,16.7,32072,39108,9198,58451,70,35,0,66748,4432
18,31000,1831000,Hammond city, Indiana,1,2014,78383,42.4,73.9,10.4,39572,38811,39842,15713,357,254,0,48615,29768
18,36003,1836003,Indianapolis city (balance), Indiana,1,2014,851353,43.2,75.2,11.1,412711,438642,538499,234712,22865,1642,1197,764742,86611
18,40788,1840788,Lafayette city, Indiana,1,2014,67012,46.7,76.1,13.4,30165,36847,55778,6416,1801,0,0,59388,7624
18,51876,1851876,Muncie city, Indiana,1,2014,70580,50.3,83.9,15.3,34314,36266,58502,8491,1521,0,16,68331,2249
18,71000,1871000,South Bend city, Indiana,1,2014,103019,40.2,72.1,12.6,48792,54227,66836,26037,1879,402,61,90824,12195
19,12000,1912000,Cedar Rapids city, Iowa,1,2014,129183,42.2,76.8,13.3,63155,66028,113288,7185,4856,180,0,125625,3558
19,19000,1919000,Davenport city, Iowa,1,2014,102431,43.1,76.2,12.4,49422,53009,82549,12011,2901,559,0,94057,8374
19,21000,1921000,Des Moines city, Iowa,1,2014,209064,43.1,73.6,11.3,100715,108349,162648,24954,12270,651,381,182479,26585
19,38595,1938595,Iowa City city, Iowa,1,2014,73424,61.3,84.6,8.4,37328,36096,61104,3657,5244,376,0,69446,3978
19,73335,1973335,Sioux City city, Iowa,1,2014,81392,41.2,74.6,13.8,39366,42026,68647,2873,2845,2288,0,66832,14560
19,82425,1982425,Waterloo city, Iowa,1,2014,68365,40.4,76.3,14.4,32821,35544,51181,10865,1802,168,0,64086,4279
20,36000,2036000,Kansas City city, Kansas,1,2014,148323,40.8,72.1,11.3,73034,75289,89758,36749,5739,1133,1048,105274,43049
20,38900,2038900,Lawrence city, Kansas,1,2014,91282,57.7,83.5,9.4,44817,46465,74304,4048,5467,2630,0,85422,5860
20,52575,2052575,Olathe city, Kansas,1,2014,133059,43.2,70.7,9,65913,67146,115210,5316,6467,240,0,119958,13101
20,53775,2053775,Overland Park city, Kansas,1,2014,184524,40.3,77.2,14.6,91117,93407,158289,8210,11133,290,205,172476,12048
20,71000,2071000,Topeka city, Kansas,1,2014,127223,40.8,75.3,14.6,61402,65821,101516,13814,1091,1156,0,110450,16773
20,79000,2079000,Wichita city, Kansas,1,2014,388413,41.1,73.5,12.8,192770,195643,291746,45961,18450,4132,0,326216,62197
21,46027,2146027,Lexington-Fayette urban county, Kentucky,1,2014,310797,46.4,79,11.6,152721,158076,235076,44857,11115,1816,364,289482,21315
21,48006,2148006,Louisville/Jefferson County metro government (balance), Kentucky,1,2014,612775,40.7,76.8,13.4,295925,316850,433942,141930,14568,1455,491,583626,29149
22,5000,2205000,Baton Rouge city, Louisiana,1,2014,228909,47.8,79.2,12.9,107970,120939,88292,128973,6305,545,63,219646,9263
22,8920,2208920,Bossier City city, Louisiana,0,2014,67453,45,71.9,13.1,35166,32287,44248,17473,1219,211,1357,61744,5709
22,39475,2239475,Kenner city, Louisiana,1,2014,67058,38.9,82,18.1,34296,32762,43967,14145,4168,353,0,49565,17493
22,40735,2240735,Lafayette city, Louisiana,1,2014,126068,43.6,78.8,11.5,60114,65954,85031,36362,2367,149,0,119226,6842
22,41155,2241155,Lake Charles city, Louisiana,1,2014,74875,40.2,76.8,17,34435,40440,34284,36649,1900,116,0,71461,3414
22,50115,2250115,Metairie CDP, Louisiana,0,2014,144239,39.2,79.9,16,68536,75703,119055,14604,6248,266,0,118711,25528
22,55000,2255000,New Orleans city, Louisiana,1,2014,384320,44.5,79.6,12.1,183107,201213,133630,227369,11598,442,393,363020,21300
22,70000,2270000,Shreveport city, Louisiana,1,2014,197979,40.8,76.1,15.2,92529,105450,75071,115368,2451,724,183,193205,4774
23,60545,2360545,Portland city, Maine,1,2014,66669,48,83.3,11.9,32717,33952,56753,6095,1191,0,0,64259,2410
24,4000,2404000,Baltimore city, Maryland,1,2014,622793,44.6,78.8,12.3,294080,328713,188819,390044,16984,1565,108,593345,29448
24,7125,2407125,Bethesda CDP, Maryland,0,2014,62097,31.6,75.4,19.3,29109,32988,49100,2064,8576,0,0,59180,2917
24,19125,2419125,Columbia CDP, Maryland,0,2014,97728,41.7,79,12.6,48459,49269,53899,26729,11230,42,0,87955,9773
24,26000,2426000,Ellicott City CDP, Maryland,0,2014,72295,35.4,73.5,14.2,35012,37283,44942,6319,18914,345,0,70317,1978
24,30325,2430325,Frederick city, Maryland,0,2014,68404,44.5,77,11.4,32259,36145,44726,14017,4553,268,171,60297,8107
24,31175,2431175,Gaithersburg city, Maryland,0,2014,66807,42.7,75.1,11.7,34190,32617,28701,10523,13015,290,0,47301,19506
24,32025,2432025,Germantown CDP, Maryland,0,2014,85021,41.2,73,6.5,41829,43192,44751,15018,16485,1077,0,65944,19077
24,32650,2432650,Glen Burnie CDP, Maryland,0,2014,69906,45.6,77.3,12.9,30951,38955,43934,16527,4915,259,0,63365,6541
24,67675,2467675,Rockville city, Maryland,0,2014,65941,42,79.4,16.1,30331,35610,39811,6334,12574,29,0,54258,11683
24,72450,2472450,Silver Spring CDP, Maryland,0,2014,77726,46.7,75.7,9.6,35956,41770,36489,22689,5231,388,47,57765,19961
24,81175,2481175,Waldorf CDP, Maryland,0,2014,72048,45,72.5,8.3,34331,37717,24656,38932,2489,113,100,67165,4883
25,7000,2507000,Boston city, Massachusetts,1,2014,656051,54.5,83.5,10.3,316075,339976,347662,160952,64034,2337,59,533709,122342
25,9000,2509000,Brockton city, Massachusetts,1,2014,94780,37.7,74.1,12.5,45695,49085,46817,37951,1144,78,176,83590,11190
25,11000,2511000,Cambridge city, Massachusetts,1,2014,109699,61,86.5,9.8,51371,58328,75441,11756,15569,119,41,100656,9043
25,23000,2523000,Fall River city, Massachusetts,1,2014,88705,40.7,80.7,16.2,41896,46809,70903,4835,2460,390,0,79981,8724
25,24960,2524960,Framingham CDP, Massachusetts,0,2014,70744,41.8,77.5,13.9,33797,36947,51521,4042,6464,0,39,60340,10404
25,34550,2534550,Lawrence city, Massachusetts,1,2014,78192,47.1,72.1,8.5,38785,39407,28376,2488,3282,409,0,18101,60091
25,37000,2537000,Lowell city, Massachusetts,1,2014,109931,47.9,79.1,10.5,56340,53591,66372,7234,20392,400,90,85412,24519
25,37490,2537490,Lynn city, Massachusetts,1,2014,92137,43.4,75.6,11.2,45364,46773,42525,10920,8613,692,0,57068,35069
25,45000,2545000,New Bedford city, Massachusetts,1,2014,94855,40,77.1,12.9,44533,50322,64226,7997,1553,675,0,76125,18730
25,45560,2545560,Newton city, Massachusetts,1,2014,88298,37.2,78,18.7,42068,46230,67118,4292,12648,49,0,83104,5194
25,55745,2555745,Quincy city, Massachusetts,1,2014,93391,43.2,83.2,15.3,46636,46755,61080,6627,23087,71,52,90792,2599
25,62535,2562535,Somerville city, Massachusetts,1,2014,78903,62.1,88.2,9.9,40234,38669,59704,6773,7053,128,47,73439,5464
25,67000,2567000,Springfield city, Massachusetts,1,2014,153994,44,73.2,10.9,70676,83318,89178,31162,3018,979,207,88511,65483
25,82000,2582000,Worcester city, Massachusetts,1,2014,183033,46,77.7,10.7,90790,92243,127637,23382,12608,701,64,142159,40874
26,3000,2603000,Ann Arbor city, Michigan,1,2014,117759,58.8,84.8,10.4,57940,59819,84224,8320,20215,321,69,112570,5189
26,21000,2621000,Dearborn city, Michigan,1,2014,95546,40.5,71,13.2,46803,48743,84605,4626,1766,293,77,91794,3752
26,22000,2622000,Detroit city, Michigan,1,2014,680281,41.1,75.2,12.5,320196,360085,98650,539810,8478,3157,0,631268,49013
26,27440,2627440,Farmington Hills city, Michigan,1,2014,81440,35.2,82.7,21.7,38755,42685,54472,14175,10427,150,0,78268,3172
26,29000,2629000,Flint city, Michigan,1,2014,98990,42.5,74.3,11.7,47223,51767,41403,51099,89,949,103,95085,3905
26,34000,2634000,Grand Rapids city, Michigan,1,2014,193793,48.2,76.2,11.5,96404,97389,129315,41785,3309,1235,182,165512,28281
26,42160,2642160,Kalamazoo city, Michigan,1,2014,75909,57.2,80.5,9.8,37859,38050,50761,17349,1487,369,256,72092,3817
26,46000,2646000,Lansing city, Michigan,1,2014,113659,45.2,75.8,11.6,55114,58545,71402,26253,3446,358,0,101071,12588
26,49000,2649000,Livonia city, Michigan,1,2014,94959,35.1,81.1,18.2,46392,48567,87142,3663,3032,115,0,93487,1472
26,69035,2669035,Rochester Hills city, Michigan,1,2014,73120,36.1,75.3,16.5,36394,36726,56741,4257,9189,120,0,71310,1810
26,74900,2674900,Southfield city, Michigan,1,2014,73001,36.8,82.7,18.6,31235,41766,17612,51281,1398,157,0,72470,531
26,76460,2676460,Sterling Heights city, Michigan,1,2014,131729,39.8,80.7,16.6,64721,67008,110735,8829,7911,0,0,127934,3795
26,80700,2680700,Troy city, Michigan,1,2014,83120,36.5,78.5,15.8,41290,41830,56799,4574,19053,128,151,81758,1362
26,84000,2684000,Warren city, Michigan,1,2014,135099,37.8,76.5,14.5,65255,69844,98314,24664,8262,390,0,132835,2264
26,86000,2686000,Westland city, Michigan,1,2014,82318,40,81.8,17.5,39191,43127,56769,19550,3093,741,84,80239,2079
26,88940,2688940,Wyoming city, Michigan,1,2014,74820,42.1,74.5,10.3,36066,38754,57562,3987,1854,1381,0,57551,17269
27,6616,2706616,Bloomington city, Minnesota,1,2014,86319,37.5,83.6,19.6,43282,43037,67923,6534,6444,134,78,79898,6421
27,7966,2707966,Brooklyn Park city, Minnesota,1,2014,78741,43.8,70.2,9.8,35686,43055,43609,20194,10561,0,0,71154,7587
27,17000,2717000,Duluth city, Minnesota,1,2014,86242,47.2,82.7,15.1,43333,42909,77008,2539,1601,1633,0,84095,2147
27,17288,2717288,Eagan city, Minnesota,0,2014,66087,40.5,77.2,11.7,32739,33348,51982,4306,6979,198,0,63459,2628
27,40166,2740166,Maple Grove city, Minnesota,0,2014,66949,37.1,75.2,11.3,32292,34657,-998,-998,-998,-998,-998,66271,678
27,43000,2743000,Minneapolis city, Minnesota,1,2014,407181,52.4,79.7,8.3,205891,201290,265873,79484,22768,5483,138,367727,39454
27,51730,2751730,Plymouth city, Minnesota,1,2014,75065,38.2,74.7,15.4,34760,40305,57747,4959,7600,495,0,72357,2708
27,54880,2754880,Rochester city, Minnesota,1,2014,111398,40,76.7,14.5,54456,56942,91434,8325,9073,203,0,105179,6219
27,56896,2756896,St. Cloud city, Minnesota,0,2014,64221,50.9,83.7,11.9,34536,29685,53791,6438,1500,617,0,62546,1675
27,58000,2758000,St. Paul city, Minnesota,1,2014,297644,46.2,74.1,8.9,145625,152019,168906,47793,53863,3274,0,267855,29789
27,71428,2771428,Woodbury city, Minnesota,0,2014,66799,39.8,74.6,11.2,31178,35621,56628,2362,5082,0,97,62714,4085
28,29700,2829700,Gulfport city, Mississippi,1,2014,71747,39.9,76.8,14,33872,37875,43523,25345,465,52,10,69367,2380
28,36000,2836000,Jackson city, Mississippi,1,2014,171146,44.4,74.5,11.6,79557,91589,35402,132824,1398,142,0,169213,1933
29,15670,2915670,Columbia city, Missouri,1,2014,116892,56.7,81.4,9.3,55220,61672,91000,13105,6179,57,4,113272,3620
29,35000,2935000,Independence city, Missouri,1,2014,117503,36.8,79,17.5,56671,60832,97936,6539,1949,923,482,106218,11285
29,38000,2938000,Kansas City city, Missouri,1,2014,470816,43.2,76.5,12,229038,241778,275205,139981,11402,1886,486,423703,47113
29,41348,2941348,Lee's Summit city, Missouri,1,2014,94627,34,72.8,14,45476,49151,79132,6740,2229,327,233,90431,4196
29,54074,2954074,O'Fallon city, Missouri,1,2014,83999,41.1,72.1,10.2,40841,43158,75050,4185,3168,123,0,82545,1454
29,64082,2964082,St. Charles city, Missouri,0,2014,68087,42.8,82.2,14.9,33584,34503,59340,5406,1404,98,32,65714,2373
29,64550,2964550,St. Joseph city, Missouri,1,2014,76529,41.6,76.6,13.8,37501,39028,66825,5806,682,206,42,71312,5217
29,65000,2965000,St. Louis city, Missouri,1,2014,317419,45.8,79.8,11.4,153044,164375,145959,148875,9411,663,194,305372,12047
29,70000,2970000,Springfield city, Missouri,1,2014,165399,47.4,81.7,15.5,79999,85400,149326,8030,2582,424,59,159111,6288
30,6550,3006550,Billings city, Montana,1,2014,108870,40.9,75.5,14.7,53550,55320,99538,848,208,5368,88,102056,6814
30,50200,3050200,Missoula city, Montana,1,2014,69824,49.4,82.8,12.1,33700,36124,64035,311,921,2850,45,68250,1574
31,28000,3128000,Lincoln city, Nebraska,1,2014,273002,46.6,77.1,11.8,134320,138682,235709,12411,12825,703,47,253590,19412
31,37000,3137000,Omaha city, Nebraska,1,2014,446618,42.8,75,12,221341,225277,348582,55457,14377,4185,548,384413,62205
32,23770,3223770,Enterprise CDP, Nevada,0,2014,126438,48.9,71.9,6.8,59466,66972,69143,10622,30508,983,574,104626,21812
32,31900,3231900,Henderson city, Nevada,1,2014,277458,37.9,79.5,17.9,136868,140590,207343,14746,21263,756,405,233522,43936
32,40000,3240000,Las Vegas city, Nevada,1,2014,613590,41.9,75.3,13,310765,302825,385047,76956,38539,4058,3992,410974,202616
32,51800,3251800,North Las Vegas city, Nevada,1,2014,230793,43.1,73.4,10.7,112013,118780,138073,42971,15439,418,1036,134209,96584
32,54600,3254600,Paradise CDP, Nevada,0,2014,237477,43.8,79.6,12.7,124181,113296,149829,21373,23228,2642,3325,162201,75276
32,60600,3260600,Reno city, Nevada,1,2014,236995,43.4,78.5,13.4,119011,117984,186747,6355,15877,2424,1553,181399,55596
32,68400,3268400,Sparks city, Nevada,1,2014,94704,39.5,75.7,14.8,46409,48295,76841,2638,4405,1458,281,69451,25253
32,68585,3268585,Spring Valley CDP, Nevada,0,2014,192113,41.8,80.3,14.2,97981,94132,103961,18290,37925,171,1261,146292,45821
32,71400,3271400,Sunrise Manor CDP, Nevada,0,2014,189229,43.5,70.2,10,91297,97932,101425,27442,11540,766,1439,95183,94046
33,45140,3345140,Manchester city, New Hampshire,1,2014,110451,42.3,79,12.7,55657,54794,94388,5330,6190,326,0,99831,10620
33,50260,3350260,Nashua city, New Hampshire,1,2014,87258,40,81.8,13.1,43167,44091,73785,3585,4162,197,117,77287,9971
34,3580,3403580,Bayonne city, New Jersey,0,2014,65984,41.9,76.4,12,32866,33118,48904,8906,5858,0,0,51191,14793
34,10000,3410000,Camden city, New Jersey,1,2014,77317,44.4,70.6,9.9,37453,39864,10052,37563,2457,280,0,40690,36627
34,13690,3413690,Clifton city, New Jersey,1,2014,85920,45.7,76.4,11,40947,44973,57322,5161,10486,465,0,54236,31684
34,19390,3419390,East Orange city, New Jersey,0,2014,65095,39.8,77.7,13.2,28944,36151,2457,57026,243,35,0,58250,6845
34,21000,3421000,Elizabeth city, New Jersey,1,2014,128695,46.1,73.8,9,66201,62494,63722,24932,3532,0,0,47653,81042
34,36000,3436000,Jersey City city, New Jersey,1,2014,262146,50.8,79.1,9.5,128065,134081,93409,68555,66351,477,245,189219,72927
34,51000,3451000,Newark city, New Jersey,1,2014,280577,47.2,74.2,8.4,138841,141736,61266,139409,7005,1831,107,179615,100962
34,56550,3456550,Passaic city, New Jersey,1,2014,71517,44,66.7,8.4,36960,34557,25325,6514,2177,2031,51,18594,52923
34,57000,3457000,Paterson city, New Jersey,1,2014,146746,42.9,73.3,11.1,70339,76407,37885,45539,1805,89,0,59584,87162
34,73110,3473110,Toms River CDP, New Jersey,0,2014,89490,36.5,78.1,17.5,44271,45219,78475,2720,4720,0,0,81647,7843
34,74000,3474000,Trenton city, New Jersey,1,2014,84047,46,74.8,10.4,42846,41201,32116,43825,393,119,0,54893,29154
34,74630,3474630,Union City city, New Jersey,1,2014,68673,44.5,77.9,11.1,33664,35009,53014,2553,3317,42,0,11708,56965
35,2000,3502000,Albuquerque city, New Mexico,1,2014,557172,42.2,76.8,13.4,270432,286740,398390,16453,14980,24818,182,288442,268730
35,39380,3539380,Las Cruces city, New Mexico,1,2014,101405,45.8,77.9,14.3,51368,50037,88627,2391,2258,2085,0,44903,56502
35,63460,3563460,Rio Rancho city, New Mexico,1,2014,93011,39.2,75.2,12.7,45853,47158,71527,2748,1854,1577,0,55072,37939
35,70500,3570500,Santa Fe city, New Mexico,1,2014,70291,36,82.2,20.4,33164,37127,58763,540,1120,2022,31,35552,34739
36,1000,3601000,Albany city, New York,1,2014,98566,51.5,85.1,12.5,45030,53536,53323,28610,7111,119,38,88460,10106
36,8026,3608026,Brentwood CDP, New York,0,2014,68580,46.3,70.1,7.5,35479,33101,40751,9816,1902,347,0,26019,42561
36,11000,3611000,Buffalo city, New York,1,2014,258699,45.2,76.9,12.8,122130,136569,122457,96258,14543,1387,85,230991,27708
36,15000,3615000,Cheektowaga CDP, New York,0,2014,73556,38.4,84.4,18.9,36105,37451,60113,7009,3126,232,242,70988,2568
36,49121,3649121,Mount Vernon city, New York,1,2014,68455,40.3,76.3,14,30024,38431,17362,42867,1192,411,0,55499,12956
36,50617,3650617,New Rochelle city, New York,1,2014,79630,39.8,79.3,13.9,40639,38991,49484,17528,3535,175,0,61724,17906
36,51000,3651000,New York city, New York,1,2014,8491079,44.6,78.8,12.9,4046394,4444685,3619690,2079129,1172114,33983,2946,6030181,2460898
36,63000,3663000,Rochester city, New York,1,2014,209974,46.6,76.3,10.8,101498,108476,94282,88062,7767,3122,0,173201,36773
36,65508,3665508,Schenectady city, New York,1,2014,65930,42.5,78.7,13.3,32852,33078,39525,13749,4662,33,0,58178,7752
36,73000,3673000,Syracuse city, New York,1,2014,144263,48.9,76.7,12.6,66701,77562,78337,42473,11315,893,0,131752,12511
36,84000,3684000,Yonkers city, New York,1,2014,200665,39.5,78.6,16.6,96562,104103,119897,32408,17238,986,0,134363,66302
37,2140,3702140,Asheville city, North Carolina,1,2014,87884,43.5,84.6,17.9,39294,48590,68074,13150,2877,682,0,83913,3971
37,10740,3710740,Cary town, North Carolina,1,2014,155724,39.9,75.3,11.8,76197,79527,110537,12152,26563,284,13,144928,10796
37,12000,3712000,Charlotte city, North Carolina,1,2014,809974,46.8,75.8,9.4,387737,422237,408296,282495,49863,1781,58,699534,110440
37,14100,3714100,Concord city, North Carolina,1,2014,85571,42,70.8,11.3,40623,44948,57214,18644,3481,509,0,75794,9777
37,19000,3719000,Durham city, North Carolina,1,2014,251872,47.1,77.8,10.7,118719,133153,118247,102246,12004,244,226,216760,35112
37,22920,3722920,Fayetteville city, North Carolina,1,2014,203939,47.5,76.3,11.7,98972,104967,96004,84540,6911,1476,468,180475,23464
37,25580,3725580,Gastonia city, North Carolina,1,2014,73696,35.8,76.1,15.9,35175,38521,46382,20271,1377,77,0,67064,6632
37,28000,3728000,Greensboro city, North Carolina,1,2014,282558,45.1,77.4,12.5,130369,152189,133640,118953,13264,1713,206,262355,20203
37,28080,3728080,Greenville city, North Carolina,1,2014,89850,57.6,82.4,10.3,42804,47046,47533,33889,2504,518,25,85968,3882
37,31400,3731400,High Point city, North Carolina,1,2014,107957,41.1,74.8,12.4,51790,56167,58616,36115,5925,246,0,96940,11017
37,34200,3734200,Jacksonville city, North Carolina,1,2014,69031,61.2,74.9,6,40694,28337,41263,18486,597,567,18,58881,10150
37,55000,3755000,Raleigh city, North Carolina,1,2014,439884,50,77.8,9.4,214254,225630,269502,119672,15736,2095,464,387268,52616
37,74440,3774440,Wilmington city, North Carolina,1,2014,113676,49.3,83,13.7,54078,59598,89124,20236,1339,89,0,106737,6939
37,75000,3775000,Winston-Salem city, North Carolina,1,2014,239273,42.7,76.1,13.4,112641,126632,132782,82167,4363,434,0,204660,34613
38,7200,3807200,Bismarck city, North Dakota,0,2014,67666,41.6,78.2,15.9,32762,34904,-998,-998,-998,-998,-998,66087,1579
38,25700,3825700,Fargo city, North Dakota,1,2014,116572,51.2,79,10.2,56318,60254,100939,5999,4518,1506,0,113392,3180
39,1000,3901000,Akron city, Ohio,1,2014,197846,41.6,78.8,13.3,95194,102652,122140,59236,7399,215,0,194568,3278
39,12000,3912000,Canton city, Ohio,1,2014,72274,41.6,74.8,13.1,33200,39074,-998,-998,-998,-998,-998,70504,1770
39,15000,3915000,Cincinnati city, Ohio,1,2014,298162,46.6,79.1,11.7,142163,155999,148742,129638,4737,448,86,289264,8898
39,16000,3916000,Cleveland city, Ohio,1,2014,389524,41.5,75.8,12.2,185881,203643,146208,208004,7221,1432,24,347779,41745
39,18000,3918000,Columbus city, Ohio,1,2014,836293,49.2,77.5,9.2,402972,433321,513069,231302,42795,1097,125,787445,48848
39,21000,3921000,Dayton city, Ohio,1,2014,140995,44.1,76.8,11.5,68133,72862,73337,60206,460,1105,0,136871,4124
39,44856,3944856,Lorain city, Ohio,0,2014,63774,37.9,75.6,15.4,29691,34083,48709,9150,547,504,0,44917,18857
39,61000,3961000,Parma city, Ohio,1,2014,80023,38.4,79,17.8,40463,39560,72681,2172,1436,679,0,76525,3498
39,77000,3977000,Toledo city, Ohio,1,2014,281014,42.3,76.7,13.5,136050,144964,180887,71542,3897,631,25,259534,21480
39,88000,3988000,Youngstown city, Ohio,1,2014,65051,38,76.9,16.7,31553,33498,31947,28618,482,156,0,58639,6412
40,9050,4009050,Broken Arrow city, Oklahoma,1,2014,106226,40.2,73.1,11,53042,53184,83827,4298,2998,4121,0,100524,5702
40,23200,4023200,Edmond city, Oklahoma,1,2014,88594,39.3,74.8,12.3,42907,45687,71199,4183,1595,2012,511,83670,4924
40,41850,4041850,Lawton city, Oklahoma,1,2014,97017,48.9,75.7,10.4,50719,46298,57575,20256,1639,5403,581,84240,12777
40,52500,4052500,Norman city, Oklahoma,1,2014,118046,52.8,82.9,11.7,59089,58957,95207,6469,4620,4037,30,107306,10740
40,55000,4055000,Oklahoma City city, Oklahoma,1,2014,620553,42.5,74.6,12.1,304143,316410,421536,90870,29854,18077,370,507192,113361
40,75000,4075000,Tulsa city, Oklahoma,1,2014,399274,41.1,75.6,13.4,192046,207228,255794,59949,11214,16250,813,336318,62956
41,5350,4105350,Beaverton city, Oregon,1,2014,95113,45.1,79.2,10.7,48459,46654,70563,1294,9998,584,1225,77246,17867
41,5800,4105800,Bend city, Oregon,1,2014,84075,41.9,79.1,14.5,41130,42945,77754,635,1995,285,0,78298,5777
41,23850,4123850,Eugene city, Oregon,1,2014,160552,48.3,81,13.7,77753,82799,135434,2451,6454,1337,301,144808,15744
41,31250,4131250,Gresham city, Oregon,1,2014,109877,42.4,75.4,13.6,55146,54731,84753,4797,6091,1690,330,91218,18659
41,34100,4134100,Hillsboro city, Oregon,1,2014,99374,46.2,74.7,10.5,48874,50500,75109,1043,9449,1582,548,77218,22156
41,47000,4147000,Medford city, Oregon,1,2014,78560,36.7,77.7,18.1,38187,40373,71608,539,1465,62,0,68123,10437
41,59000,4159000,Portland city, Oregon,1,2014,619445,47.5,81.5,11.5,304728,314717,476461,34381,42807,4680,4477,556251,63194
41,64900,4164900,Salem city, Oregon,1,2014,161648,42.3,76.4,13.9,82584,79064,125796,2330,4870,2779,1612,126699,34949
42,2000,4202000,Allentown city, Pennsylvania,1,2014,119105,44.5,73.3,12.1,57379,61726,63742,17406,2666,559,0,60987,58118
42,6088,4206088,Bethlehem city, Pennsylvania,1,2014,78759,46.1,82,14.9,38453,40306,61212,5988,1822,385,0,57475,21284
42,24000,4224000,Erie city, Pennsylvania,1,2014,99466,41.9,77.2,13.9,48855,50611,72897,16471,3147,406,149,92896,6570
42,60000,4260000,Philadelphia city, Pennsylvania,1,2014,1560297,45.1,77.8,12.5,737581,822716,664708,660704,109068,7367,897,1347594,212703
42,61000,4261000,Pittsburgh city, Pennsylvania,1,2014,305434,49.8,84.4,13.5,149146,156288,203801,72766,16972,562,0,296260,9174
42,63624,4263624,Reading city, Pennsylvania,1,2014,87809,45,70.2,10.6,43002,44807,41365,10675,311,2530,0,34362,53447
42,69000,4269000,Scranton city, Pennsylvania,1,2014,75278,41.5,79.3,18.3,36422,38856,64820,5937,2885,108,15,66674,8604
44,19180,4419180,Cranston city, Rhode Island,1,2014,81029,36.6,82.2,18,38431,42598,66488,4751,5752,201,0,73668,7361
44,54640,4454640,Pawtucket city, Rhode Island,1,2014,71490,44,73.9,10.7,34758,36732,46086,12605,1140,216,0,54793,16697
44,59000,4459000,Providence city, Rhode Island,1,2014,179142,53.7,78.4,9.2,85645,93497,89028,30684,12505,2595,385,103910,75232
44,74300,4474300,Warwick city, Rhode Island,1,2014,81964,34.7,82.8,19.3,40731,41233,75191,1190,2705,315,0,78466,3498
45,13330,4513330,Charleston city, South Carolina,1,2014,130750,50.7,82.4,13,63648,67102,97218,28229,2470,80,0,127235,3515
45,16000,4516000,Columbia city, South Carolina,1,2014,131758,58,83.3,9.2,66710,65048,72731,51665,2787,102,31,123265,8493
45,48535,4548535,Mount Pleasant town, South Carolina,1,2014,77787,36.4,76.2,14.4,36393,41394,-998,-998,-998,-998,-998,76385,1402
45,50875,4550875,North Charleston city, South Carolina,1,2014,107972,46.3,74.6,10.2,54036,53936,46163,52714,3246,190,0,96878,11094
45,61405,4561405,Rock Hill city, South Carolina,1,2014,69967,49.6,76.9,13.6,33081,36886,37827,27268,968,214,99,67930,2037
46,52980,4652980,Rapid City city, South Dakota,1,2014,72642,38.8,75.2,15.2,36009,36633,57259,1562,1082,7532,0,68446,4196
46,59020,4659020,Sioux Falls city, South Dakota,1,2014,168604,43.1,75.9,12.3,83296,85308,145443,8452,3482,5162,0,160991,7613
47,14000,4714000,Chattanooga city, Tennessee,1,2014,173778,42.1,80.6,15,82625,91153,105655,58595,3549,143,218,163088,10690
47,15160,4715160,Clarksville city, Tennessee,1,2014,146814,49.2,72.7,8.1,72887,73927,97395,35177,2979,656,0,130439,16375
47,27740,4727740,Franklin city, Tennessee,0,2014,70613,39.3,73,10.6,33413,37200,-998,-998,-998,-998,-998,65755,4858
47,37640,4737640,Jackson city, Tennessee,0,2014,67308,43.9,77.1,12.3,32099,35209,33075,31558,986,284,0,64120,3188
47,38320,4738320,Johnson City city, Tennessee,0,2014,65820,45.1,80.2,16.8,30602,35218,57325,4711,1273,167,0,61979,3841
47,40000,4740000,Knoxville city, Tennessee,1,2014,184292,48.9,79.9,13.6,88110,96182,133142,35999,3390,1679,0,172575,11717
47,48000,4748000,Memphis city, Tennessee,1,2014,656876,43.8,75,11.2,312021,344855,189255,420976,10640,1117,413,614969,41907
47,51560,4751560,Murfreesboro city, Tennessee,1,2014,120960,51.1,77.7,9.4,58576,62384,89251,21142,4798,59,0,112225,8735
47,52006,4752006,Nashville-Davidson metropolitan government (balance), Tennessee,1,2014,644008,46.9,78.5,10.9,309656,334352,399586,180752,21460,1541,380,578382,65626
48,1000,4801000,Abilene city, Texas,1,2014,120176,46.6,77.2,13,61653,58523,88346,11754,2187,1330,107,87912,32264
48,1924,4801924,Allen city, Texas,1,2014,94170,42,70.1,6,48287,45883,68325,5520,16120,789,0,83571,10599
48,3000,4803000,Amarillo city, Texas,1,2014,200246,42,72.9,12.7,97198,103048,167983,11618,7037,784,594,139789,60457
48,4000,4804000,Arlington city, Texas,1,2014,383202,43.7,73.1,9.7,189540,193662,253826,77883,25028,1194,406,268671,114531
48,4462,4804462,Atascocita CDP, Texas,0,2014,73017,42.4,72.1,8.8,34918,38099,52319,10997,1261,0,713,54773,18244
48,5000,4805000,Austin city, Texas,1,2014,912798,52.1,78.5,8,463088,449710,701658,72160,64974,2931,315,598438,314360
48,6128,4806128,Baytown city, Texas,1,2014,75670,40.6,71.3,13.7,39187,36483,53295,13249,1248,350,0,42416,33254
48,7000,4807000,Beaumont city, Texas,1,2014,117576,42.2,75.3,12.8,57560,60016,52210,58413,2940,0,0,102098,15478
48,10768,4810768,Brownsville city, Texas,1,2014,183016,42.7,69.3,11.2,89237,93779,175855,911,1119,177,0,10219,172797
48,10912,4810912,Bryan city, Texas,1,2014,80916,47,75.3,9.7,39436,41480,50743,14813,929,0,0,48322,32594
48,13024,4813024,Carrollton city, Texas,1,2014,128342,43,75.3,9.1,63091,65251,89953,10914,19247,570,313,85165,43177
48,15976,4815976,College Station city, Texas,1,2014,103486,68.3,83.4,5.9,53916,49570,80553,6340,10763,327,0,88421,15065
48,16432,4816432,Conroe city, Texas,0,2014,65873,44.4,73.7,11.1,35443,30430,57234,4880,1416,0,0,38648,27225
48,17000,4817000,Corpus Christi city, Texas,1,2014,320431,41.7,74.7,12.7,156694,163737,282633,14552,6784,1257,131,123939,196492
48,19000,4819000,Dallas city, Texas,1,2014,1281031,46.3,73.8,9.4,637627,643404,792715,310838,42209,4510,753,750233,530798
48,19972,4819972,Denton city, Texas,1,2014,128200,55.8,80.3,9.4,63524,64676,101919,13052,3749,827,0,99527,28673
48,22660,4822660,Edinburg city, Texas,1,2014,83017,47.6,65.9,7.7,37823,45194,-998,-998,-998,-998,-998,8452,74565
48,24000,4824000,El Paso city, Texas,1,2014,679024,42.9,72.9,12.2,333618,345406,568476,28863,8416,3965,319,139684,539340
48,26232,4826232,Flower Mound town, Texas,0,2014,69419,37,73,9.5,33428,35991,54706,2843,8542,367,0,63739,5680
48,27000,4827000,Fort Worth city, Texas,1,2014,812553,45.1,71.9,9,391912,420641,525181,162304,29732,3868,556,534664,277889
48,27684,4827684,Frisco city, Texas,1,2014,145038,42.7,67.1,7,72350,72688,102667,10727,22198,732,195,128957,16081
48,29000,4829000,Garland city, Texas,1,2014,235597,40.8,73.2,11.8,113647,121950,145171,28683,24547,711,64,135798,99799
48,30464,4830464,Grand Prairie city, Texas,1,2014,185415,46.9,71.6,7.4,93195,92220,113461,41940,10522,1255,128,106636,78779
48,32372,4832372,Harlingen city, Texas,0,2014,65914,40.3,67.5,13.8,33012,32902,60665,751,675,353,0,12551,53363
48,35000,4835000,Houston city, Texas,1,2014,2240796,46.5,75,9.8,1122825,1117971,1291693,524877,154325,10572,1499,1252572,988224
48,37000,4837000,Irving city, Texas,1,2014,232413,47.4,71.3,7.6,113101,119312,138178,29699,39597,829,137,131541,100872
48,39148,4839148,Killeen city, Texas,1,2014,138143,50.7,71.5,5.1,68140,70003,54492,48333,5225,2156,2243,104908,33235
48,41464,4841464,Laredo city, Texas,1,2014,253747,43.6,66.1,8.4,122936,130811,239531,1187,1558,498,0,12142,241605
48,41980,4841980,League City city, Texas,1,2014,94287,43.9,72.7,9.1,47547,46740,74579,5156,6127,143,0,72943,21344
48,42508,4842508,Lewisville city, Texas,1,2014,102283,45.5,75.4,9.2,49999,52284,72624,13752,6900,404,0,70141,32142
48,43888,4843888,Longview city, Texas,1,2014,84313,39.5,73,14.5,40687,43626,59794,20993,804,349,0,69668,14645
48,45000,4845000,Lubbock city, Texas,1,2014,243843,48.6,77,11.7,118620,125223,189866,19199,5685,1310,28,162707,81136
48,45384,4845384,McAllen city, Texas,1,2014,138584,44,70.3,10.1,67120,71464,127923,743,2280,113,199,18701,119883
48,45744,4845744,McKinney city, Texas,1,2014,156753,45.6,70,8.8,74082,82671,123936,16145,8200,410,139,130678,26075
48,47892,4847892,Mesquite city, Texas,1,2014,144289,42.1,73.4,9.6,72107,72182,93276,36215,5295,569,0,89283,55006
48,48072,4848072,Midland city, Texas,1,2014,128037,44.2,73.3,10,65000,63037,104524,9603,2072,632,0,71812,56225
48,48768,4848768,Mission city, Texas,1,2014,82429,41.7,65.4,11.3,39620,42809,-998,-998,-998,-998,-998,10007,72422
48,48804,4848804,Missouri City city, Texas,1,2014,75128,39.5,75.9,9.6,36542,38586,19740,32932,14534,0,171,63612,11516
48,50820,4850820,New Braunfels city, Texas,0,2014,65714,42.2,73.8,12.6,31941,33773,57397,1910,837,0,135,42335,23379
48,52356,4852356,North Richland Hills city, Texas,0,2014,68527,38.9,73.4,14,33502,35025,57446,2790,3766,108,465,56499,12028
48,53388,4853388,Odessa city, Texas,1,2014,116394,44.4,72,10.5,58403,57991,91188,6099,2141,785,0,53503,62891
48,56000,4856000,Pasadena city, Texas,1,2014,153914,41.2,71.7,9.5,76935,76979,125529,3005,1310,2204,295,56224,97690
48,56348,4856348,Pearland city, Texas,1,2014,104759,43.9,71.6,9.2,50311,54448,69187,15229,13984,102,0,81787,22972
48,57200,4857200,Pharr city, Texas,1,2014,75381,42.3,63.9,10.9,34522,40859,-998,-998,-998,-998,-998,5124,70257
48,58016,4858016,Plano city, Texas,1,2014,277910,39.9,76.1,12,138024,139886,184996,26473,48925,856,114,235559,42351
48,61796,4861796,Richardson city, Texas,1,2014,108609,39.9,78.3,13.9,54032,54577,77567,8570,16287,405,217,91305,17304
48,63500,4863500,Round Rock city, Texas,1,2014,112196,45.1,70.8,7.9,54830,57366,88946,9745,6786,333,39,78088,34108
48,64472,4864472,San Angelo city, Texas,1,2014,97207,45.2,76.1,14.8,49765,47442,79436,4085,1174,264,0,57695,39512
48,65000,4865000,San Antonio city, Texas,1,2014,1436723,44.4,74.3,11.6,707621,729102,1147399,101274,39025,9436,583,520183,916540
48,70808,4870808,Sugar Land city, Texas,1,2014,86775,36.9,76.3,13.6,44002,42773,44300,3648,36098,199,0,80257,6518
48,72176,4872176,Temple city, Texas,0,2014,70785,39.9,71.6,16.4,34995,35790,52306,12362,2219,432,75,54459,16326
48,72656,4872656,The Woodlands CDP, Texas,0,2014,102764,34.9,70.4,12.3,49862,52902,88786,5375,6243,127,235,92202,10562
48,74144,4874144,Tyler city, Texas,1,2014,101436,41.8,74.8,15.1,47766,53670,64210,29261,2512,94,941,82528,18908
48,75428,4875428,Victoria city, Texas,0,2014,66098,41.2,74,14.6,32111,33987,58130,4148,1277,192,0,32160,33938
48,76000,4876000,Waco city, Texas,1,2014,130191,48.9,75.5,11.6,64716,65475,90270,27528,1560,1089,0,89476,40715
48,79000,4879000,Wichita Falls city, Texas,1,2014,105107,44.5,76.3,11.9,55751,49356,77633,13350,2630,1388,0,82186,22921
49,43660,4943660,Layton city, Utah,1,2014,72223,45.2,68.8,8.9,38033,34190,63326,1255,1754,78,0,63665,8558
49,50150,4950150,Millcreek CDP, Utah,0,2014,65203,38.9,75.3,17.4,32294,32909,57519,1476,1881,1498,100,59156,6047
49,55980,4955980,Ogden city, Utah,1,2014,84325,46.7,71.7,10.7,43374,40951,69963,800,1348,680,79,55900,28425
49,57300,4957300,Orem city, Utah,1,2014,91781,50.8,69.4,7.9,46695,45086,80733,1317,2404,877,432,76211,15570
49,62470,4962470,Provo city, Utah,1,2014,114807,62.9,77.8,6.4,57890,56917,102375,820,2083,358,1461,98063,16744
49,65330,4965330,St. George city, Utah,1,2014,78509,37.5,74.7,21.6,36947,41562,71467,746,451,1545,1348,69393,9116
49,67000,4967000,Salt Lake City city, Utah,1,2014,190873,52.3,79.1,9.5,102744,88129,137726,3363,10684,3077,4296,151187,39686
49,67440,4967440,Sandy city, Utah,1,2014,91135,39,69.5,9.9,43110,48025,83886,731,1139,254,1436,81131,10004
49,82950,4982950,West Jordan city, Utah,1,2014,110917,45.7,65.8,5.7,52423,58494,93447,1753,2768,590,1526,87525,23392
49,83470,4983470,West Valley City city, Utah,1,2014,134492,47.1,67.1,6.8,67157,67335,78508,1361,8061,1112,5805,81177,53315
51,1000,5101000,Alexandria city, Virginia,1,2014,150575,49.7,82.1,10.2,71921,78654,96093,31128,10573,61,138,125518,25057
51,3000,5103000,Arlington CDP, Virginia,0,2014,226908,53.7,82.8,8.9,113432,113476,165090,18950,23472,156,374,191260,35648
51,14440,5114440,Centreville CDP, Virginia,0,2014,77618,44.7,73.9,6.5,38886,38732,42500,5878,23727,207,0,66490,11128
51,16000,5116000,Chesapeake city, Virginia,1,2014,233371,41.2,75.6,11.8,113592,119779,145126,69163,8037,219,859,220927,12444
51,21088,5121088,Dale City CDP, Virginia,0,2014,73809,44.8,72.8,8.6,37083,36726,36438,19252,7034,366,716,53172,20637
51,35000,5135000,Hampton city, Virginia,1,2014,136879,42.2,78.3,13.6,65790,71089,58451,68295,3595,954,0,129564,7315
51,47672,5147672,Lynchburg city, Virginia,1,2014,79047,48.9,80.3,14.4,37304,41743,51500,22915,2290,17,52,76400,2647
51,56000,5156000,Newport News city, Virginia,1,2014,182965,45,76.6,11.6,88434,94531,92495,73305,5250,385,362,167450,15515
51,57000,5157000,Norfolk city, Virginia,1,2014,245428,51.3,79.7,9.8,127888,117540,114315,104703,8984,1134,0,227139,18289
51,64000,5164000,Portsmouth city, Virginia,1,2014,96004,41.8,76.5,13.6,46106,49898,39566,49982,1214,681,288,92208,3796
51,67000,5167000,Richmond city, Virginia,1,2014,217853,48.8,81.7,11.4,104055,113798,97755,105349,5125,812,0,203507,14346
51,68000,5168000,Roanoke city, Virginia,1,2014,99428,40.4,78.5,15.3,47953,51475,62351,28553,2462,27,0,93548,5880
51,76432,5176432,Suffolk city, Virginia,1,2014,86806,38.7,75,13,41797,45009,44473,35933,1347,22,0,83574,3232
51,82000,5182000,Virginia Beach city, Virginia,1,2014,450980,43.6,77.2,12.3,221987,228993,303113,87511,29617,914,123,416110,34870
53,3180,5303180,Auburn city, Washington,1,2014,78769,42.3,73,11.1,38383,40386,53751,3799,8370,1529,1544,63718,15051
53,5210,5305210,Bellevue city, Washington,1,2014,136426,42.4,79.8,15,67644,68782,81323,2968,45508,474,60,124820,11606
53,5280,5305280,Bellingham city, Washington,1,2014,83363,52.9,85.4,13.6,41236,42127,67939,908,5781,1425,0,76695,6668
53,22640,5322640,Everett city, Washington,1,2014,106741,42.9,75.2,9,55110,51631,84546,4368,7882,1810,674,90170,16571
53,23515,5323515,Federal Way city, Washington,1,2014,93428,42.3,77.3,13.3,46718,46710,54704,10211,13248,341,3897,77526,15902
53,35275,5335275,Kennewick city, Washington,1,2014,77424,42.7,74.2,12.5,38883,38541,60281,2796,569,592,124,58072,19352
53,35415,5335415,Kent city, Washington,1,2014,125547,47.2,74.1,9.5,62696,62851,66037,15507,26072,2682,1450,110551,14996
53,35940,5335940,Kirkland city, Washington,0,2014,85778,42.4,81,13.1,42029,43749,65009,873,12607,157,62,79690,6088
53,43955,5343955,Marysville city, Washington,0,2014,65088,39.6,74.2,14.7,31187,33901,52105,801,6039,542,584,58973,6115
53,53545,5353545,Pasco city, Washington,0,2014,69807,44.2,65.2,6.1,36039,33768,50393,1497,2063,417,0,30862,38945
53,57745,5357745,Renton city, Washington,1,2014,98382,47.7,77.6,9.1,49656,48726,43702,9168,24165,358,1701,81669,16713
53,63000,5363000,Seattle city, Washington,1,2014,668337,50.8,85.1,12.2,338781,329556,464857,46638,93532,5155,4408,627058,41279
53,67000,5367000,Spokane city, Washington,1,2014,212067,42.3,77.9,14.1,103185,108882,183191,4682,5701,3902,1364,198510,13557
53,67167,5367167,Spokane Valley city, Washington,1,2014,91733,39.7,75.6,14.7,45929,45804,83989,801,1312,1603,409,87609,4124
53,70000,5370000,Tacoma city, Washington,1,2014,205153,43.4,78.4,12.5,103800,101353,130905,20946,17208,2986,4496,180437,24716
53,74060,5374060,Vancouver city, Washington,1,2014,169303,43.2,77.5,13.9,83855,85448,130751,4031,8427,985,3370,148952,20351
53,80010,5380010,Yakima city, Washington,1,2014,93355,40.1,73.6,13.9,46936,46419,72031,843,1136,2547,0,52399,40956
55,2375,5502375,Appleton city, Wisconsin,1,2014,72654,42.3,75.9,10.8,35914,36740,61004,1942,5106,191,0,68250,4404
55,22300,5522300,Eau Claire city, Wisconsin,0,2014,68207,50.7,80.5,12.5,33304,34903,61844,922,3852,494,211,66421,1786
55,31000,5531000,Green Bay city, Wisconsin,1,2014,104893,41.5,75.3,12.2,52705,52188,82850,3720,3222,3974,0,89393,15500
55,39225,5539225,Kenosha city, Wisconsin,1,2014,99898,41.8,75.4,12.5,48149,51749,81775,12493,1148,277,0,84198,15700
55,48000,5548000,Madison city, Wisconsin,1,2014,245674,52.8,82.4,11,119983,125691,190300,16596,21925,775,0,230234,15440
55,53000,5553000,Milwaukee city, Wisconsin,1,2014,599653,45.7,74.2,10.1,290147,309506,284178,233522,21848,3558,203,491495,108158
55,60500,5560500,Oshkosh city, Wisconsin,0,2014,66631,48.3,81.6,14,34756,31875,61095,2425,1488,272,98,65327,1304
55,66000,5566000,Racine city, Wisconsin,1,2014,78054,41.4,72.5,11.8,37436,40618,50751,18039,405,513,0,60209,17845
55,84250,5584250,Waukesha city, Wisconsin,1,2014,71482,44.8,76,10.6,34389,37093,61567,3260,2891,255,0,62771,8711
72,10334,7210334,Caguas zona urbana, Puerto Rico,0,2014,77624,39.1,80,20.2,34276,43348,59671,7997,436,0,0,665,76959
72,14290,7214290,Carolina zona urbana, Puerto Rico,0,2014,148712,39.4,79.4,19.5,68443,80269,82770,37911,406,3478,79,1652,147060
72,32522,7232522,Guaynabo zona urbana, Puerto Rico,0,2014,71460,37.7,81.8,19.6,33710,37750,56787,3615,200,191,0,1010,70450
72,63820,7263820,Ponce zona urbana, Puerto Rico,0,2014,124015,38.8,78.4,18.8,58175,65840,101016,6664,66,420,0,603,123412
72,76770,7276770,San Juan zona urbana, Puerto Rico,0,2014,351290,38.8,80.2,19.6,161413,189877,264669,39322,1896,960,69,6225,345065
72,52431,7252431,Mayag√ºez zona urbana, Puerto Rico,0,2014,64488,41.3,80.7,21.6,30699,33789,25184,2662,0,273,0,531,63957
72,6593,7206593,Bayam√≥n zona urbana, Puerto Rico,0,2014,175826,39.4,80.3,19.9,83664,92162,102110,9493,98,614,49,1411,174415